SaleDate,TransactionID,Balance_Before,Balance_After,ReceiveAmount,SalesPrice,Cost_Price,CommissionAmount,TransactionID2,DistributorRef1,TransactionStatusDescription,OperatorCountryName,DisplayName,AgentName,UserName,SkuCode
2022-02-12 22:10,72092677,"9,259.3910","9,249.5910",10.00 AED,10.00,9.8000,0.2000,563500345,1572408,Success,United Arab Emirates,DU UAE,Transguard Group LLC,API User,E6AEAE22430
2022-02-12 22:11,72092706,"9,249.5910","9,239.7910",10.00 AED,10.00,9.8000,0.2000,563500464,1572412,Success,United Arab Emirates,DU UAE,Transguard Group LLC,API User,E6AEAE22430
2022-02-12 22:12,72092769,"9,239.7910","9,234.8910",05.00 AED,5.00,4.9000,0.1000,563500664,1572417,Success,United Arab Emirates,DU UAE,Transguard Group LLC,API User,E6AEAE17361
2022-02-12 22:15,72092934,"9,234.8910","9,195.6910",40.00 AED,40.00,39.2000,0.8000,563501147,1572427,Success,United Arab Emirates,DU UAE,Transguard Group LLC,API User,E6AEAE64011
2022-02-12 22:17,72093019,"9,195.6910","9,176.0910",20.00 AED,20.00,19.6000,0.4000,563501441,1572432,Success,United Arab Emirates,DU UAE,Transguard Group LLC,API User,E6AEAE12938
2022-02-12 22:17,72093041,"9,176.0910","9,171.1910",05.00 AED,5.00,4.9000,0.1000,563501499,1572434,Success,United Arab Emirates,DU UAE,Transguard Group LLC,API User,E6AEAE17361
2022-02-12 22:18,72093084,"9,171.1910","9,166.2910",05.00 AED,5.00,4.9000,0.1000,563501646,1572437,Success,United Arab Emirates,DU UAE,Transguard Group LLC,API User,E6AEAE17361
2022-02-12 22:19,72093138,"9,166.2910","9,156.4910",10.00 AED,10.00,9.8000,0.2000,563501851,1572444,Success,United Arab Emirates,DU UAE,Transguard Group LLC,API User,E6AEAE22430
2022-02-12 22:19,72093139,"9,156.4910","9,151.5910",05.00 AED,5.00,4.9000,0.1000,563501852,1572445,Success,United Arab Emirates,DU UAE,Transguard Group LLC,API User,E6AEAE17361
2022-02-12 22:23,72093316,"9,151.5910","9,131.9910",20.00 AED,20.00,19.6000,0.4000,563502510,1572454,Success,United Arab Emirates,DU UAE,Transguard Group LLC,API User,E6AEAE12938
2022-02-12 22:37,72093956,"9,131.9910","9,122.1910",10.00 AED,10.00,9.8000,0.2000,563504779,1572463,Success,United Arab Emirates,DU UAE,Transguard Group LLC,API User,E6AEAE22430
2022-02-12 22:40,72094091,"9,122.1910","9,117.2910",05.00 AED,5.00,4.9000,0.1000,563505250,1572469,Success,United Arab Emirates,DU UAE,Transguard Group LLC,API User,E6AEAE17361
2022-02-12 22:44,72094230,"9,117.2910","9,097.6910",20.00 AED,20.00,19.6000,0.4000,563505900,1572474,Success,United Arab Emirates,DU UAE,Transguard Group LLC,API User,E6AEAE12938
2022-02-12 22:45,72094270,"9,097.6910","9,078.0910",20.00 AED,20.00,19.6000,0.4000,563506026,1572478,Success,United Arab Emirates,DU UAE,Transguard Group LLC,API User,E6AEAE12938
2022-02-12 22:46,72094324,"9,078.0910","9,068.2910",10.00 AED,10.00,9.8000,0.2000,563506206,1572482,Success,United Arab Emirates,DU UAE,Transguard Group LLC,API User,E6AEAE22430
2022-02-12 22:48,72094437,"9,068.2910","9,058.4910",10.00 AED,10.00,9.8000,0.2000,563506578,1572486,Success,United Arab Emirates,DU UAE,Transguard Group LLC,API User,E6AEAE22430
2022-02-12 22:52,72094592,"9,058.4910","9,048.6910",10.00 AED,10.00,9.8000,0.2000,563507208,1572500,Success,United Arab Emirates,DU UAE,Transguard Group LLC,API User,E6AEAE22430
2022-02-12 22:52,72094617,"9,048.6910","9,043.7910",05.00 AED,5.00,4.9000,0.1000,563507290,1572504,Success,United Arab Emirates,DU UAE,Transguard Group LLC,API User,E6AEAE17361
2022-02-12 23:03,72095011,"9,043.7910","9,038.8910",05.00 AED,5.00,4.9000,0.1000,563508722,1572513,Success,United Arab Emirates,DU UAE,Transguard Group LLC,API User,E6AEAE17361
2022-02-12 23:06,72095145,"9,038.8910","9,029.0910",10.00 AED,10.00,9.8000,0.2000,563509256,1572518,Success,United Arab Emirates,DU UAE,Transguard Group LLC,API User,E6AEAE22430
2022-02-12 23:11,72095307,"9,029.0910","8,989.8910",40.00 AED,40.00,39.2000,0.8000,563509873,1572521,Success,United Arab Emirates,DU UAE,Transguard Group LLC,API User,E6AEAE64011
2022-02-12 23:20,72095682,"8,989.8910","8,984.9910",05.00 AED,5.00,4.9000,0.1000,563511199,1572525,Success,United Arab Emirates,DU UAE,Transguard Group LLC,API User,E6AEAE17361
2022-02-12 23:31,72096058,"8,984.9910","8,960.4910",25.00 AED,25.00,24.5000,0.5000,563512675,1572536,Success,United Arab Emirates,DU UAE,Transguard Group LLC,API User,E6AEAE17343
2022-02-12 23:47,72096522,"8,960.4910","8,955.5910",05.00 AED,5.00,4.9000,0.1000,563514620,1572540,Success,United Arab Emirates,DU UAE,Transguard Group LLC,API User,E6AEAE17361
2022-02-12 23:52,72096701,"8,955.5910","8,951.8510",100.00 NPR,4.25,3.7400,0.5100,563515258,1572545,Success,Nepal,Nepal Telecom Nepal,Transguard Group LLC,API User,NP_NE_TopUp_100.00
2022-02-13 00:10,72097445,"8,951.8510","8,946.9510",05.00 AED,5.00,4.9000,0.1000,563517606,1572552,Success,United Arab Emirates,DU UAE,Transguard Group LLC,API User,E6AEAE17361
2022-02-13 00:10,72097450,"8,946.9510","8,938.8110",300.00 PKR,9.25,8.1400,1.1100,563517628,1572553,Success,Pakistan,Zong Pakistan,Transguard Group LLC,API User,ZNPKPK70504
2022-02-13 00:23,72098037,"8,938.8110","8,917.0310",800.00 PKR,24.75,21.7800,2.9700,563519471,1572561,Success,Pakistan,Zong Pakistan,Transguard Group LLC,API User,ZNPKPK8195
2022-02-13 00:24,72098079,"8,917.0310","8,912.8510",150.00 PKR,4.75,4.1800,0.5700,563519590,1572564,Success,Pakistan,Zong Pakistan,Transguard Group LLC,API User,ZNPKPK65621
2022-02-13 00:38,72098619,"8,912.8510","8,903.0510",10.00 AED,10.00,9.8000,0.2000,563521297,1572574,Success,United Arab Emirates,DU UAE,Transguard Group LLC,API User,E6AEAE22430
2022-02-13 00:41,72098739,"8,903.0510","8,898.1510",05.00 AED,5.00,4.9000,0.1000,563521655,1572577,Success,United Arab Emirates,DU UAE,Transguard Group LLC,API User,E6AEAE17361
2022-02-13 00:57,72099276,"8,898.1510","8,889.5710",315.00 PKR,9.75,8.5800,1.1700,563523511,1572580,Success,Pakistan,Zong Pakistan,Transguard Group LLC,API User,ZNPKPK29953
2022-02-13 01:00,72099389,"8,889.5710","8,880.7710",100.00 PHP,10.00,8.8000,1.2000,563523859,1572583,Success,Philippines,BS_Globe Philippines,Transguard Group LLC,API User,PH_GB_TopUp_100.00
2022-02-13 01:29,72100457,"8,880.7710","8,831.5210",50.00 AED,50.00,49.2500,0.7500,563527373,1572592,Success,United Arab Emirates,App Store & iTunes Gift Card UAE,Transguard Group LLC,API User,IASASA96606
2022-02-13 01:40,72100756,"8,831.5210","8,826.6210",05.00 AED,5.00,4.9000,0.1000,563528553,1572599,Success,United Arab Emirates,DU UAE,Transguard Group LLC,API User,E6AEAE17361
2022-02-13 01:42,72100821,"8,826.6210","8,821.7210",05.00 AED,5.00,4.9000,0.1000,563528829,1572602,Success,United Arab Emirates,DU UAE,Transguard Group LLC,API User,E6AEAE17361
2022-02-13 01:48,72101003,"8,821.7210","8,816.8210",05.00 AED,5.00,4.9000,0.1000,563529508,1572605,Success,United Arab Emirates,DU UAE,Transguard Group LLC,API User,E6AEAE17361
2022-02-13 01:55,72101207,"8,816.8210","8,811.9210",05.00 AED,5.00,4.9000,0.1000,563530383,1572608,Success,United Arab Emirates,DU UAE,Transguard Group LLC,API User,E6AEAE17361
2022-02-13 02:13,72101729,"8,811.9210","8,789.7010",800.00 PKR,25.25,22.2200,3.0300,563532479,1572617,Success,Pakistan,Jazz Pakistan,Transguard Group LLC,API User,MBPKPK58682
2022-02-13 02:24,72102043,"8,789.7010","8,779.9010",10.00 AED,10.00,9.8000,0.2000,563533799,1572622,Success,United Arab Emirates,DU UAE,Transguard Group LLC,API User,E6AEAE22430
2022-02-13 02:50,72102798,"8,779.9010","8,775.0010",05.00 AED,5.00,4.9000,0.1000,563536969,1572629,Success,United Arab Emirates,DU UAE,Transguard Group LLC,API User,E6AEAE17361
2022-02-13 03:02,72103161,"8,775.0010","8,765.2010",10.00 AED,10.00,9.8000,0.2000,563538441,1572632,Success,United Arab Emirates,DU UAE,Transguard Group LLC,API User,E6AEAE22430
2022-02-13 03:40,72104254,"8,765.2010","8,755.4010",10.00 AED,10.00,9.8000,0.2000,563542882,1572643,Success,United Arab Emirates,DU UAE,Transguard Group LLC,API User,E6AEAE22430
2022-02-13 03:40,72104287,"8,755.4010","8,740.8810",400.00 NPR,16.50,14.5200,1.9800,563542988,1572646,Success,Nepal,Nepal Telecom Nepal,Transguard Group LLC,API User,NENPNP18292
2022-02-13 03:45,72104405,"8,740.8810","8,735.9810",05.00 AED,5.00,4.9000,0.1000,563543511,1572652,Success,United Arab Emirates,DU UAE,Transguard Group LLC,API User,E6AEAE17361
2022-02-13 04:01,72104822,"8,735.9810","8,726.1810",10.00 AED,10.00,9.8000,0.2000,563545331,1572661,Success,United Arab Emirates,DU UAE,Transguard Group LLC,API User,E6AEAE22430
2022-02-13 04:02,72104843,"8,726.1810","8,722.4410",100.00 NPR,4.25,3.7400,0.5100,563545403,1572664,Success,Nepal,Ncell Nepal,Transguard Group LLC,API User,NP_NC_TopUp_100.00
2022-02-13 04:10,72105079,"8,722.4410","8,712.6410",10.00 AED,10.00,9.8000,0.2000,563546286,1572669,Success,United Arab Emirates,DU UAE,Transguard Group LLC,API User,E6AEAE22430
2022-02-13 04:30,72105585,"8,712.6410","8,707.7410",05.00 AED,5.00,4.9000,0.1000,563548411,1572676,Success,United Arab Emirates,DU UAE,Transguard Group LLC,API User,E6AEAE17361
2022-02-13 04:43,72105874,"8,707.7410","8,702.8410",05.00 AED,5.00,4.9000,0.1000,563549703,1572681,Success,United Arab Emirates,DU UAE,Transguard Group LLC,API User,E6AEAE17361
2022-02-13 04:47,72105985,"8,702.8410","8,693.0410",10.00 AED,10.00,9.8000,0.2000,563550112,1572686,Success,United Arab Emirates,DU UAE,Transguard Group LLC,API User,E6AEAE22430
2022-02-13 04:48,72106009,"8,693.0410","8,683.2410",10.00 AED,10.00,9.8000,0.2000,563550186,1572689,Success,United Arab Emirates,DU UAE,Transguard Group LLC,API User,E6AEAE22430
2022-02-13 05:03,72106361,"8,683.2410","8,678.3410",05.00 AED,5.00,4.9000,0.1000,563551580,1572697,Success,United Arab Emirates,DU UAE,Transguard Group LLC,API User,E6AEAE17361
2022-02-13 05:16,72106653,"8,678.3410","8,673.4410",05.00 AED,5.00,4.9000,0.1000,563552612,1572706,Success,United Arab Emirates,DU UAE,Transguard Group LLC,API User,E6AEAE17361
2022-02-13 05:17,72106663,"8,673.4410","8,668.5410",05.00 AED,5.00,4.9000,0.1000,563552672,1572709,Success,United Arab Emirates,DU UAE,Transguard Group LLC,API User,E6AEAE17361
2022-02-13 05:24,72106828,"8,668.5410","8,663.6410",05.00 AED,5.00,4.9000,0.1000,563553257,1572714,Success,United Arab Emirates,DU UAE,Transguard Group LLC,API User,E6AEAE17361
2022-02-13 05:44,72107260,"8,663.6410","8,653.8410",10.00 AED,10.00,9.8000,0.2000,563554876,1572722,Success,United Arab Emirates,DU UAE,Transguard Group LLC,API User,E6AEAE22430
2022-02-13 05:44,72107261,"8,653.8410","8,644.0410",10.00 AED,10.00,9.8000,0.2000,563554879,1572723,Success,United Arab Emirates,DU UAE,Transguard Group LLC,API User,E6AEAE22430
2022-02-13 05:46,72107319,"8,644.0410","8,614.6410",30.00 AED,30.00,29.4000,0.6000,563555076,1572726,Success,United Arab Emirates,DU UAE,Transguard Group LLC,API User,E6AEAE46146
2022-02-13 05:54,72107516,"8,614.6410","8,609.7410",05.00 AED,5.00,4.9000,0.1000,563555743,1572735,Success,United Arab Emirates,DU UAE,Transguard Group LLC,API User,E6AEAE17361
2022-02-13 05:55,72107527,"8,609.7410","8,604.8410",05.00 AED,5.00,4.9000,0.1000,563555781,1572744,Success,United Arab Emirates,DU UAE,Transguard Group LLC,API User,E6AEAE17361
2022-02-13 05:55,72107529,"8,604.8410","8,599.9410",05.00 AED,5.00,4.9000,0.1000,563555787,1572745,Success,United Arab Emirates,DU UAE,Transguard Group LLC,API User,E6AEAE17361
2022-02-13 06:09,72107853,"8,599.9410","8,560.7410",40.00 AED,40.00,39.2000,0.8000,563556832,1572752,Success,United Arab Emirates,DU UAE,Transguard Group LLC,API User,E6AEAE64011
2022-02-13 06:10,72107887,"8,560.7410","8,546.0410",15.00 AED,15.00,14.7000,0.3000,563556923,1572756,Success,United Arab Emirates,DU UAE,Transguard Group LLC,API User,E6AEAE8527
2022-02-13 06:13,72107998,"8,546.0410","8,541.1410",05.00 AED,5.00,4.9000,0.1000,563557190,1572760,Success,United Arab Emirates,DU UAE,Transguard Group LLC,API User,E6AEAE17361
2022-02-13 06:14,72108038,"8,541.1410","8,532.3410",315.00 PKR,10.00,8.8000,1.2000,563557293,1572765,Success,Pakistan,Telenor Pakistan,Transguard Group LLC,API User,TPPKPK75105
2022-02-13 06:15,72108053,"8,532.3410","8,527.4410",05.00 AED,5.00,4.9000,0.1000,563557334,1572768,Success,United Arab Emirates,DU UAE,Transguard Group LLC,API User,E6AEAE17361
2022-02-13 06:16,72108098,"8,527.4410","8,517.6410",10.00 AED,10.00,9.8000,0.2000,563557440,1572773,Success,United Arab Emirates,DU UAE,Transguard Group LLC,API User,E6AEAE22430
2022-02-13 06:19,72108195,"8,517.6410","8,498.0410",20.00 AED,20.00,19.6000,0.4000,563557697,1572782,Success,United Arab Emirates,DU UAE,Transguard Group LLC,API User,E6AEAE12938
2022-02-13 06:22,72108286,"8,498.0410","8,493.1410",05.00 AED,5.00,4.9000,0.1000,563557917,1572787,Success,United Arab Emirates,DU UAE,Transguard Group LLC,API User,E6AEAE17361
2022-02-13 06:27,72108444,"8,493.1410","8,488.2410",05.00 AED,5.00,4.9000,0.1000,563558310,1572792,Success,United Arab Emirates,DU UAE,Transguard Group LLC,API User,E6AEAE17361
2022-02-13 06:29,72108474,"8,488.2410","8,475.4810",350.00 NPR,14.50,12.7600,1.7400,563558421,1572797,Success,Nepal,Ncell Nepal,Transguard Group LLC,API User,NCNPNP22699
2022-02-13 06:31,72108540,"8,475.4810","8,469.5410",98.00 INR,6.75,5.9400,0.8100,563558579,1572809,Success,India,Vi India,Transguard Group LLC,API User,VFININ11348
2022-02-13 06:36,72108669,"8,469.5410","8,464.6410",05.00 AED,5.00,4.9000,0.1000,563558986,1572819,Success,United Arab Emirates,DU UAE,Transguard Group LLC,API User,E6AEAE17361
2022-02-13 06:36,72108683,"8,464.6410","8,454.8410",10.00 AED,10.00,9.8000,0.2000,563559033,1572822,Success,United Arab Emirates,DU UAE,Transguard Group LLC,API User,E6AEAE22430
2022-02-13 06:40,72108765,"8,454.8410","8,449.9410",05.00 AED,5.00,4.9000,0.1000,563559251,1572829,Success,United Arab Emirates,DU UAE,Transguard Group LLC,API User,E6AEAE17361
2022-02-13 06:41,72108813,"8,449.9410","8,445.0410",05.00 AED,5.00,4.9000,0.1000,563559383,1572833,Success,United Arab Emirates,DU UAE,Transguard Group LLC,API User,E6AEAE17361
2022-02-13 06:45,72108923,"8,445.0410","8,440.1410",05.00 AED,5.00,4.9000,0.1000,563559665,1572836,Success,United Arab Emirates,DU UAE,Transguard Group LLC,API User,E6AEAE17361
2022-02-13 06:47,72108969,"8,440.1410","8,435.2410",05.00 AED,5.00,4.9000,0.1000,563559800,1572840,Success,United Arab Emirates,DU UAE,Transguard Group LLC,API User,E6AEAE17361
2022-02-13 06:57,72109249,"8,435.2410","8,430.3410",05.00 AED,5.00,4.9000,0.1000,563560553,1572868,Success,United Arab Emirates,DU UAE,Transguard Group LLC,API User,E6AEAE17361
2022-02-13 06:58,72109267,"8,430.3410","8,400.9410",30.00 AED,30.00,29.4000,0.6000,563560610,1572871,Success,United Arab Emirates,DU UAE,Transguard Group LLC,API User,E6AEAE46146
2022-02-13 07:06,72109471,"8,400.9410","8,366.6410",35.00 AED,35.00,34.3000,0.7000,563561157,1572890,Success,United Arab Emirates,DU UAE,Transguard Group LLC,API User,E6AEAE73954
2022-02-13 07:08,72109548,"8,366.6410","8,356.8410",10.00 AED,10.00,9.8000,0.2000,563561345,1572895,Success,United Arab Emirates,DU UAE,Transguard Group LLC,API User,E6AEAE22430
2022-02-13 07:10,72109620,"8,356.8410","8,351.9410",05.00 AED,5.00,4.9000,0.1000,563561532,1572900,Success,United Arab Emirates,DU UAE,Transguard Group LLC,API User,E6AEAE17361
2022-02-13 07:18,72109894,"8,351.9410","8,347.0410",05.00 AED,5.00,4.9000,0.1000,563562225,1572911,Success,United Arab Emirates,DU UAE,Transguard Group LLC,API User,E6AEAE17361
2022-02-13 07:19,72109941,"8,347.0410","8,337.2410",10.00 AED,10.00,9.8000,0.2000,563562341,1572915,Success,United Arab Emirates,DU UAE,Transguard Group LLC,API User,E6AEAE22430
2022-02-13 07:20,72109982,"8,337.2410","8,332.3410",05.00 AED,5.00,4.9000,0.1000,563562431,1572920,Success,United Arab Emirates,DU UAE,Transguard Group LLC,API User,E6AEAE17361
2022-02-13 07:20,72109989,"8,332.3410","8,322.5410",10.00 AED,10.00,9.8000,0.2000,563562446,1572922,Success,United Arab Emirates,DU UAE,Transguard Group LLC,API User,E6AEAE22430
2022-02-13 07:21,72110027,"8,322.5410","8,312.7410",10.00 AED,10.00,9.8000,0.2000,563562518,1572929,Success,United Arab Emirates,DU UAE,Transguard Group LLC,API User,E6AEAE22430
2022-02-13 07:30,72110315,"8,312.7410","8,273.5410",40.00 AED,40.00,39.2000,0.8000,563563302,1572944,Success,United Arab Emirates,DU UAE,Transguard Group LLC,API User,E6AEAE64011
2022-02-13 07:33,72110432,"8,273.5410","8,268.6410",05.00 AED,5.00,4.9000,0.1000,563563658,1572956,Success,United Arab Emirates,DU UAE,Transguard Group LLC,API User,E6AEAE17361
2022-02-13 07:34,72110454,"8,268.6410","8,263.7410",05.00 AED,5.00,4.9000,0.1000,563563709,1572960,Success,United Arab Emirates,DU UAE,Transguard Group LLC,API User,E6AEAE17361
2022-02-13 07:34,72110465,"8,263.7410","8,258.8410",05.00 AED,5.00,4.9000,0.1000,563563742,1572962,Success,United Arab Emirates,DU UAE,Transguard Group LLC,API User,E6AEAE17361
2022-02-13 07:36,72110507,"8,258.8410","8,253.9410",05.00 AED,5.00,4.9000,0.1000,563563856,1572965,Success,United Arab Emirates,DU UAE,Transguard Group LLC,API User,E6AEAE17361
2022-02-13 07:38,72110570,"8,253.9410","8,219.6410",35.00 AED,35.00,34.3000,0.7000,563564038,1572968,Success,United Arab Emirates,DU UAE,Transguard Group LLC,API User,E6AEAE73954
2022-02-13 07:43,72110731,"8,219.6410","8,214.7410",05.00 AED,5.00,4.9000,0.1000,563564419,1572979,Success,United Arab Emirates,DU UAE,Transguard Group LLC,API User,E6AEAE17361
2022-02-13 07:43,72110736,"8,214.7410","8,195.1410",20.00 AED,20.00,19.6000,0.4000,563564434,1572981,Success,United Arab Emirates,DU UAE,Transguard Group LLC,API User,E6AEAE12938
2022-02-13 07:44,72110787,"8,195.1410","8,190.2410",05.00 AED,5.00,4.9000,0.1000,563564568,1572984,Success,United Arab Emirates,DU UAE,Transguard Group LLC,API User,E6AEAE17361
2022-02-13 07:49,72110937,"8,190.2410","8,180.4410",10.00 AED,10.00,9.8000,0.2000,563564931,1572990,Success,United Arab Emirates,DU UAE,Transguard Group LLC,API User,E6AEAE22430
2022-02-13 07:53,72111085,"8,180.4410","8,175.5410",05.00 AED,5.00,4.9000,0.1000,563565247,1572995,Success,United Arab Emirates,DU UAE,Transguard Group LLC,API User,E6AEAE17361
2022-02-13 07:59,72111322,"8,175.5410","8,155.9410",20.00 AED,20.00,19.6000,0.4000,563565813,1573008,Success,United Arab Emirates,DU UAE,Transguard Group LLC,API User,E6AEAE12938
2022-02-13 08:00,72111345,"8,155.9410","8,146.1410",10.00 AED,10.00,9.8000,0.2000,563565859,1573011,Success,United Arab Emirates,DU UAE,Transguard Group LLC,API User,E6AEAE22430
2022-02-13 08:04,72111493,"8,146.1410","8,141.2410",05.00 AED,5.00,4.9000,0.1000,563566236,1573016,Success,United Arab Emirates,DU UAE,Transguard Group LLC,API User,E6AEAE17361
2022-02-13 08:08,72111606,"8,141.2410","8,133.9810",200.00 NPR,8.25,7.2600,0.9900,563566492,1573024,Success,Nepal,Nepal Telecom Nepal,Transguard Group LLC,API User,NP_NE_TopUp_200.00
2022-02-13 08:13,72111805,"8,133.9810","8,119.2810",15.00 AED,15.00,14.7000,0.3000,563566953,1573032,Success,United Arab Emirates,DU UAE,Transguard Group LLC,API User,E6AEAE8527
2022-02-13 08:13,72111809,"8,119.2810","8,114.3810",05.00 AED,5.00,4.9000,0.1000,563566968,1573033,Success,United Arab Emirates,DU UAE,Transguard Group LLC,API User,E6AEAE17361
2022-02-13 08:16,72111897,"8,101.1810","8,096.2810",05.00 AED,5.00,4.9000,0.1000,563567189,1573038,Success,United Arab Emirates,DU UAE,Transguard Group LLC,API User,E6AEAE17361
2022-02-13 08:17,72111905,"8,114.3810","8,101.1810",234.00 INR,15.00,13.2000,1.8000,563567172,1573036,Success,India,d2h DTH India,Transguard Group LLC,API User,IN_1V_IN_TopUp
2022-02-13 08:22,72112116,"8,096.2810","8,086.4810",10.00 AED,10.00,9.8000,0.2000,563567732,1573051,Success,United Arab Emirates,DU UAE,Transguard Group LLC,API User,E6AEAE22430
2022-02-13 08:23,72112162,"8,086.4810","8,081.5810",05.00 AED,5.00,4.9000,0.1000,563567864,1573056,Success,United Arab Emirates,DU UAE,Transguard Group LLC,API User,E6AEAE17361
2022-02-13 08:25,72112216,"8,081.5810","8,076.6810",05.00 AED,5.00,4.9000,0.1000,563567987,1573062,Success,United Arab Emirates,DU UAE,Transguard Group LLC,API User,E6AEAE17361
2022-02-13 08:25,72112217,"8,076.6810","8,071.7810",05.00 AED,5.00,4.9000,0.1000,563567989,1573063,Success,United Arab Emirates,DU UAE,Transguard Group LLC,API User,E6AEAE17361
2022-02-13 08:27,72112305,"8,071.7810","8,052.1810",20.00 AED,20.00,19.6000,0.4000,563568191,1573066,Success,United Arab Emirates,DU UAE,Transguard Group LLC,API User,E6AEAE12938
2022-02-13 08:37,72112678,"8,052.1810","8,047.2810",05.00 AED,5.00,4.9000,0.1000,563569092,1573074,Success,United Arab Emirates,DU UAE,Transguard Group LLC,API User,E6AEAE17361
2022-02-13 08:39,72112753,"8,047.2810","8,042.3810",05.00 AED,5.00,4.9000,0.1000,563569280,1573079,Success,United Arab Emirates,DU UAE,Transguard Group LLC,API User,E6AEAE17361
2022-02-13 08:40,72112810,"8,042.3810","8,017.9610",300.00 PHP,27.75,24.4200,3.3300,563569414,1573089,Success,Philippines,Smart (SunCellular) Philippines,Transguard Group LLC,API User,PH_SM_TopUp_300.00
2022-02-13 08:41,72112847,"8,017.9610","8,013.7810",50.00 PHP,4.75,4.1800,0.5700,563569498,1573093,Success,Philippines,Smart (SunCellular) Philippines,Transguard Group LLC,API User,PH_SM_TopUp_50.00
2022-02-13 08:42,72112870,"8,013.7810","8,008.8810",05.00 AED,5.00,4.9000,0.1000,563569542,1573096,Success,United Arab Emirates,DU UAE,Transguard Group LLC,API User,E6AEAE17361
2022-02-13 08:42,72112900,"8,008.8810","8,003.9810",05.00 AED,5.00,4.9000,0.1000,563569606,1573099,Success,United Arab Emirates,DU UAE,Transguard Group LLC,API User,E6AEAE17361
2022-02-13 08:49,72113131,"8,003.9810","7,984.3810",20.00 AED,20.00,19.6000,0.4000,563570169,1573108,Success,United Arab Emirates,DU UAE,Transguard Group LLC,API User,E6AEAE12938
2022-02-13 08:49,72113155,"7,984.3810","7,974.5810",10.00 AED,10.00,9.8000,0.2000,563570210,1573112,Success,United Arab Emirates,DU UAE,Transguard Group LLC,API User,E6AEAE22430
2022-02-13 08:50,72113196,"7,974.5810","7,969.6810",05.00 AED,5.00,4.9000,0.1000,563570324,1573116,Success,United Arab Emirates,DU UAE,Transguard Group LLC,API User,E6AEAE17361
2022-02-13 08:52,72113277,"7,969.6810","7,963.7410",99.00 INR,6.75,5.9400,0.8100,563570495,1573123,Success,India,Airtel India,Transguard Group LLC,API User,AIININ6418
2022-02-13 08:54,72113337,"7,963.7410","7,958.8410",05.00 AED,5.00,4.9000,0.1000,563570608,1573134,Success,United Arab Emirates,DU UAE,Transguard Group LLC,API User,E6AEAE17361
2022-02-13 08:54,72113366,"7,958.8410","7,949.0410",10.00 AED,10.00,9.8000,0.2000,563570676,1573138,Success,United Arab Emirates,DU UAE,Transguard Group LLC,API User,E6AEAE22430
2022-02-13 08:55,72113406,"7,949.0410","7,944.1410",05.00 AED,5.00,4.9000,0.1000,563570769,1573141,Success,United Arab Emirates,DU UAE,Transguard Group LLC,API User,E6AEAE17361
2022-02-13 08:59,72113568,"7,944.1410","7,939.9610",50.00 PHP,4.75,4.1800,0.5700,563571122,1573154,Success,Philippines,Smart (SunCellular) Philippines,Transguard Group LLC,API User,PH_SM_TopUp_50.00
2022-02-13 08:59,72113578,"7,939.9610","7,935.0610",05.00 AED,5.00,4.9000,0.1000,563571137,1573156,Success,United Arab Emirates,DU UAE,Transguard Group LLC,API User,E6AEAE17361
2022-02-13 09:01,72113685,"7,935.0610","7,925.2610",10.00 AED,10.00,9.8000,0.2000,563571364,1573167,Success,United Arab Emirates,DU UAE,Transguard Group LLC,API User,E6AEAE22430
2022-02-13 09:02,72113691,"7,925.2610","7,920.3610",05.00 AED,5.00,4.9000,0.1000,563571378,1573168,Success,United Arab Emirates,DU UAE,Transguard Group LLC,API User,E6AEAE17361
2022-02-13 09:02,72113730,"7,920.3610","7,915.4610",05.00 AED,5.00,4.9000,0.1000,563571457,1573171,Success,United Arab Emirates,DU UAE,Transguard Group LLC,API User,E6AEAE17361
2022-02-13 09:05,72113832,"7,915.4610","7,910.5610",05.00 AED,5.00,4.9000,0.1000,563571684,1573180,Success,United Arab Emirates,DU UAE,Transguard Group LLC,API User,E6AEAE17361
2022-02-13 09:06,72113867,"7,910.5610","7,905.6610",05.00 AED,5.00,4.9000,0.1000,563571760,1573184,Success,United Arab Emirates,DU UAE,Transguard Group LLC,API User,E6AEAE17361
2022-02-13 09:06,72113876,"7,905.6610","7,900.7610",05.00 AED,5.00,4.9000,0.1000,563571779,1573186,Success,United Arab Emirates,DU UAE,Transguard Group LLC,API User,E6AEAE17361
2022-02-13 09:11,72114099,"7,900.7610","7,895.8610",05.00 AED,5.00,4.9000,0.1000,563572319,1573195,Success,United Arab Emirates,DU UAE,Transguard Group LLC,API User,E6AEAE17361
2022-02-13 09:13,72114173,"7,895.8610","7,890.9610",05.00 AED,5.00,4.9000,0.1000,563572476,1573201,Success,United Arab Emirates,DU UAE,Transguard Group LLC,API User,E6AEAE17361
2022-02-13 09:14,72114196,"7,890.9610","7,881.1610",10.00 AED,10.00,9.8000,0.2000,563572539,1573204,Success,United Arab Emirates,DU UAE,Transguard Group LLC,API User,E6AEAE22430
2022-02-13 09:23,72114584,"7,881.1610","7,876.2610",05.00 AED,5.00,4.9000,0.1000,563573438,1573216,Success,United Arab Emirates,DU UAE,Transguard Group LLC,API User,E6AEAE17361
2022-02-13 09:42,72115486,"7,876.2610","7,866.4610",10.00 AED,10.00,9.8000,0.2000,563575280,1573234,Success,United Arab Emirates,DU UAE,Transguard Group LLC,API User,E6AEAE22430
2022-02-13 09:43,72115591,"7,866.4610","7,856.6610",10.00 AED,10.00,9.8000,0.2000,563575492,1573239,Success,United Arab Emirates,DU UAE,Transguard Group LLC,API User,E6AEAE22430
2022-02-13 09:47,72115781,"7,856.6610","7,851.7610",05.00 AED,5.00,4.9000,0.1000,563575835,1573247,Success,United Arab Emirates,DU UAE,Transguard Group LLC,API User,E6AEAE17361
2022-02-13 09:47,72115792,"7,851.7610","7,846.8610",05.00 AED,5.00,4.9000,0.1000,563575851,1573248,Success,United Arab Emirates,DU UAE,Transguard Group LLC,API User,E6AEAE17361
2022-02-13 09:49,72115866,"7,846.8610","7,841.9610",05.00 AED,5.00,4.9000,0.1000,563576015,1573253,Success,United Arab Emirates,DU UAE,Transguard Group LLC,API User,E6AEAE17361
2022-02-13 09:56,72116164,"7,841.9610","7,832.1610",10.00 AED,10.00,9.8000,0.2000,563576635,1573267,Success,United Arab Emirates,DU UAE,Transguard Group LLC,API User,E6AEAE22430
2022-02-13 09:57,72116217,"7,832.1610","7,827.2610",05.00 AED,5.00,4.9000,0.1000,563576748,1573273,Success,United Arab Emirates,DU UAE,Transguard Group LLC,API User,E6AEAE17361
2022-02-13 10:02,72116459,"7,827.2610","7,822.3610",05.00 AED,5.00,4.9000,0.1000,563577254,1573287,Success,United Arab Emirates,DU UAE,Transguard Group LLC,API User,E6AEAE17361
2022-02-13 10:05,72116600,"7,822.3610","7,817.4610",05.00 AED,5.00,4.9000,0.1000,563577538,1573291,Success,United Arab Emirates,DU UAE,Transguard Group LLC,API User,E6AEAE17361
2022-02-13 10:08,72116736,"7,817.4610","7,812.5610",05.00 AED,5.00,4.9000,0.1000,563577825,1573298,Success,United Arab Emirates,DU UAE,Transguard Group LLC,API User,E6AEAE17361
2022-02-13 10:11,72116892,"7,812.5610","7,807.6610",05.00 AED,5.00,4.9000,0.1000,563578130,1573303,Success,United Arab Emirates,DU UAE,Transguard Group LLC,API User,E6AEAE17361
2022-02-13 10:11,72116909,"7,807.6610","7,802.7610",05.00 AED,5.00,4.9000,0.1000,563578166,1573308,Success,United Arab Emirates,DU UAE,Transguard Group LLC,API User,E6AEAE17361
2022-02-13 10:11,72116915,"7,802.7610","7,792.9610",10.00 AED,10.00,9.8000,0.2000,563578173,1573309,Success,United Arab Emirates,DU UAE,Transguard Group LLC,API User,E6AEAE22430
2022-02-13 10:13,72117018,"7,792.9610","7,783.1610",10.00 AED,10.00,9.8000,0.2000,563578377,1573312,Success,United Arab Emirates,DU UAE,Transguard Group LLC,API User,E6AEAE22430
2022-02-13 10:20,72117346,"7,783.1610","7,778.2610",05.00 AED,5.00,4.9000,0.1000,563579063,1573323,Success,United Arab Emirates,DU UAE,Transguard Group LLC,API User,E6AEAE17361
2022-02-13 10:29,72117805,"7,778.2610","7,768.4610",10.00 AED,10.00,9.8000,0.2000,563580032,1573339,Success,United Arab Emirates,DU UAE,Transguard Group LLC,API User,E6AEAE22430
2022-02-13 10:30,72117856,"7,768.4610","7,758.6610",10.00 AED,10.00,9.8000,0.2000,563580130,1573342,Success,United Arab Emirates,DU UAE,Transguard Group LLC,API User,E6AEAE22430
2022-02-13 10:33,72117970,"7,758.6610","7,748.8610",10.00 AED,10.00,9.8000,0.2000,563580395,1573351,Success,United Arab Emirates,DU UAE,Transguard Group LLC,API User,E6AEAE22430
2022-02-13 10:34,72118021,"7,748.8610","7,743.9610",05.00 AED,5.00,4.9000,0.1000,563580485,1573354,Success,United Arab Emirates,DU UAE,Transguard Group LLC,API User,E6AEAE17361
2022-02-13 10:38,72118236,"7,743.9610","7,734.1610",10.00 AED,10.00,9.8000,0.2000,563580947,1573362,Success,United Arab Emirates,DU UAE,Transguard Group LLC,API User,E6AEAE22430
2022-02-13 10:43,72118459,"7,734.1610","7,729.2610",05.00 AED,5.00,4.9000,0.1000,563581412,1573370,Success,United Arab Emirates,DU UAE,Transguard Group LLC,API User,E6AEAE17361
2022-02-13 10:44,72118480,"7,729.2610","7,724.3610",05.00 AED,5.00,4.9000,0.1000,563581456,1573374,Success,United Arab Emirates,DU UAE,Transguard Group LLC,API User,E6AEAE17361
2022-02-13 10:48,72118721,"7,724.3610","7,714.5610",10.00 AED,10.00,9.8000,0.2000,563581942,1573385,Success,United Arab Emirates,DU UAE,Transguard Group LLC,API User,E6AEAE22430
2022-02-13 10:48,72118731,"7,714.5610","7,694.9610",20.00 AED,20.00,19.6000,0.4000,563581955,1573389,Success,United Arab Emirates,DU UAE,Transguard Group LLC,API User,E6AEAE12938
2022-02-13 10:48,72118735,"7,694.9610","7,691.2210",100.00 NPR,4.25,3.7400,0.5100,563581969,1573391,Success,Nepal,Ncell Nepal,Transguard Group LLC,API User,NP_NC_TopUp_100.00
2022-02-13 10:48,72118736,"7,691.2210","7,682.4210",02.00 USD,10.00,8.8000,1.2000,563581972,1573392,Success,Liberia,Lonestar Cell Liberia,Transguard Group LLC,API User,LR_LC_TopUp
2022-02-13 10:51,72118901,"7,682.4210","7,675.1610",200.00 NPR,8.25,7.2600,0.9900,563582301,1573397,Success,Nepal,Nepal Telecom Nepal,Transguard Group LLC,API User,NP_NE_TopUp_200.00
2022-02-13 11:00,72119337,"7,675.1610","7,665.3610",10.00 AED,10.00,9.8000,0.2000,563583181,1573409,Success,United Arab Emirates,DU UAE,Transguard Group LLC,API User,E6AEAE22430
2022-02-13 11:01,72119358,"7,665.3610","7,655.5610",10.00 AED,10.00,9.8000,0.2000,563583236,1573413,Success,United Arab Emirates,DU UAE,Transguard Group LLC,API User,E6AEAE22430
2022-02-13 11:01,72119360,"7,655.5610","7,650.6610",05.00 AED,5.00,4.9000,0.1000,563583242,1573414,Success,United Arab Emirates,DU UAE,Transguard Group LLC,API User,E6AEAE17361
2022-02-13 11:01,72119372,"7,650.6610","7,645.7610",05.00 AED,5.00,4.9000,0.1000,563583268,1573417,Success,United Arab Emirates,DU UAE,Transguard Group LLC,API User,E6AEAE17361
2022-02-13 11:03,72119483,"7,645.7610","7,640.8610",05.00 AED,5.00,4.9000,0.1000,563583473,1573420,Success,United Arab Emirates,DU UAE,Transguard Group LLC,API User,E6AEAE17361
2022-02-13 11:05,72119580,"7,640.8610","7,635.9610",05.00 AED,5.00,4.9000,0.1000,563583663,1573425,Success,United Arab Emirates,DU UAE,Transguard Group LLC,API User,E6AEAE17361
2022-02-13 11:06,72119639,"7,635.9610","7,631.0610",05.00 AED,5.00,4.9000,0.1000,563583793,1573433,Success,United Arab Emirates,DU UAE,Transguard Group LLC,API User,E6AEAE17361
2022-02-13 11:07,72119705,"7,631.0610","7,606.6410",899.00 PKR,27.75,24.4200,3.3300,563583937,1573439,Success,Pakistan,Zong Pakistan,Transguard Group LLC,API User,ZNPKPK48367
2022-02-13 11:09,72119810,"7,606.6410","7,601.7410",05.00 AED,5.00,4.9000,0.1000,563584158,1573441,Success,United Arab Emirates,DU UAE,Transguard Group LLC,API User,E6AEAE17361
2022-02-13 11:12,72119970,"7,601.7410","7,591.9410",10.00 AED,10.00,9.8000,0.2000,563584470,1573446,Success,United Arab Emirates,DU UAE,Transguard Group LLC,API User,E6AEAE22430
2022-02-13 11:13,72120014,"7,591.9410","7,587.0410",05.00 AED,5.00,4.9000,0.1000,563584557,1573449,Success,United Arab Emirates,DU UAE,Transguard Group LLC,API User,E6AEAE17361
2022-02-13 11:18,72120280,"7,587.0410","7,582.1410",05.00 AED,5.00,4.9000,0.1000,563585121,1573452,Success,United Arab Emirates,DU UAE,Transguard Group LLC,API User,E6AEAE17361
2022-02-13 11:22,72120498,"7,582.1410","7,577.2410",05.00 AED,5.00,4.9000,0.1000,563585533,1573460,Success,United Arab Emirates,DU UAE,Transguard Group LLC,API User,E6AEAE17361
2022-02-13 11:23,72120510,"7,577.2410","7,572.3410",05.00 AED,5.00,4.9000,0.1000,563585564,1573463,Success,United Arab Emirates,DU UAE,Transguard Group LLC,API User,E6AEAE17361
2022-02-13 11:23,72120537,"7,572.3410","7,562.5410",10.00 AED,10.00,9.8000,0.2000,563585631,1573466,Success,United Arab Emirates,DU UAE,Transguard Group LLC,API User,E6AEAE22430
2022-02-13 11:24,72120577,"7,562.5410","7,557.6410",05.00 AED,5.00,4.9000,0.1000,563585719,1573470,Success,United Arab Emirates,DU UAE,Transguard Group LLC,API User,E6AEAE17361
2022-02-13 11:25,72120639,"7,557.6410","7,547.8410",10.00 AED,10.00,9.8000,0.2000,563585850,1573475,Success,United Arab Emirates,DU UAE,Transguard Group LLC,API User,E6AEAE22430
2022-02-13 11:26,72120675,"7,547.8410","7,542.9410",05.00 AED,5.00,4.9000,0.1000,563585937,1573479,Success,United Arab Emirates,DU UAE,Transguard Group LLC,API User,E6AEAE17361
2022-02-13 11:28,72120762,"7,542.9410","7,523.3410",20.00 AED,20.00,19.6000,0.4000,563586120,1573485,Success,United Arab Emirates,DU UAE,Transguard Group LLC,API User,E6AEAE12938
2022-02-13 11:28,72120778,"7,523.3410","7,518.4410",05.00 AED,5.00,4.9000,0.1000,563586154,1573487,Success,United Arab Emirates,DU UAE,Transguard Group LLC,API User,E6AEAE17361
2022-02-13 11:32,72120969,"7,518.4410","7,513.5410",05.00 AED,5.00,4.9000,0.1000,563586571,1573497,Success,United Arab Emirates,DU UAE,Transguard Group LLC,API User,E6AEAE17361
2022-02-13 11:38,72121230,"7,513.5410","7,508.6410",05.00 AED,5.00,4.9000,0.1000,563587088,1573507,Success,United Arab Emirates,DU UAE,Transguard Group LLC,API User,E6AEAE17361
2022-02-13 11:41,72121408,"7,508.6410","7,503.7410",05.00 AED,5.00,4.9000,0.1000,563587462,1573513,Success,United Arab Emirates,DU UAE,Transguard Group LLC,API User,E6AEAE17361
2022-02-13 11:42,72121458,"7,503.7410","7,498.8410",05.00 AED,5.00,4.9000,0.1000,563587534,1573517,Success,United Arab Emirates,DU UAE,Transguard Group LLC,API User,E6AEAE17361
2022-02-13 11:44,72121555,"7,498.8410","7,454.7410",45.00 AED,45.00,44.1000,0.9000,563587724,1573520,Success,United Arab Emirates,DU UAE,Transguard Group LLC,API User,E6AEAE35243
2022-02-13 11:45,72121613,"7,454.7410","7,444.9410",10.00 AED,10.00,9.8000,0.2000,563587829,1573523,Success,United Arab Emirates,DU UAE,Transguard Group LLC,API User,E6AEAE22430
2022-02-13 11:48,72121798,"7,444.9410","7,425.3410",20.00 AED,20.00,19.6000,0.4000,563588195,1573528,Success,United Arab Emirates,DU UAE,Transguard Group LLC,API User,E6AEAE12938
2022-02-13 11:49,72121831,"7,425.3410","7,420.4410",05.00 AED,5.00,4.9000,0.1000,563588267,1573531,Success,United Arab Emirates,DU UAE,Transguard Group LLC,API User,E6AEAE17361
2022-02-13 11:51,72121938,"7,420.4410","7,410.6410",10.00 AED,10.00,9.8000,0.2000,563588505,1573540,Success,United Arab Emirates,DU UAE,Transguard Group LLC,API User,E6AEAE22430
2022-02-13 11:52,72121971,"7,410.6410","7,405.7410",05.00 AED,5.00,4.9000,0.1000,563588572,1573542,Success,United Arab Emirates,DU UAE,Transguard Group LLC,API User,E6AEAE17361
2022-02-13 11:55,72122122,"7,405.7410","7,400.8410",05.00 AED,5.00,4.9000,0.1000,563588866,1573547,Success,United Arab Emirates,DU UAE,Transguard Group LLC,API User,E6AEAE17361
2022-02-13 11:56,72122157,"7,400.8410","7,395.9410",05.00 AED,5.00,4.9000,0.1000,563588944,1573551,Success,United Arab Emirates,DU UAE,Transguard Group LLC,API User,E6AEAE17361
2022-02-13 11:57,72122191,"7,395.9410","7,391.0410",05.00 AED,5.00,4.9000,0.1000,563589009,1573555,Success,United Arab Emirates,DU UAE,Transguard Group LLC,API User,E6AEAE17361
2022-02-13 11:58,72122260,"7,391.0410","7,386.1410",05.00 AED,5.00,4.9000,0.1000,563589138,1573558,Success,United Arab Emirates,DU UAE,Transguard Group LLC,API User,E6AEAE17361
2022-02-13 11:59,72122313,"7,386.1410","7,381.2410",05.00 AED,5.00,4.9000,0.1000,563589260,1573562,Success,United Arab Emirates,DU UAE,Transguard Group LLC,API User,E6AEAE17361
2022-02-13 12:00,72122332,"7,381.2410","7,376.3410",05.00 AED,5.00,4.9000,0.1000,563589300,1573566,Success,United Arab Emirates,DU UAE,Transguard Group LLC,API User,E6AEAE17361
2022-02-13 12:00,72122378,"7,376.3410","7,371.4410",05.00 AED,5.00,4.9000,0.1000,563589378,1573569,Success,United Arab Emirates,DU UAE,Transguard Group LLC,API User,E6AEAE17361
2022-02-13 12:01,72122423,"7,371.4410","7,366.5410",05.00 AED,5.00,4.9000,0.1000,563589482,1573574,Success,United Arab Emirates,DU UAE,Transguard Group LLC,API User,E6AEAE17361
2022-02-13 12:02,72122449,"7,366.5410","7,362.3610",150.00 PKR,4.75,4.1800,0.5700,563589533,1573579,Success,Pakistan,Zong Pakistan,Transguard Group LLC,API User,ZNPKPK65621
2022-02-13 12:03,72122521,"7,362.3610","7,357.4610",05.00 AED,5.00,4.9000,0.1000,563589664,1573585,Success,United Arab Emirates,DU UAE,Transguard Group LLC,API User,E6AEAE17361
2022-02-13 12:04,72122538,"7,357.4610","7,347.6610",10.00 AED,10.00,9.8000,0.2000,563589704,1573589,Success,United Arab Emirates,DU UAE,Transguard Group LLC,API User,E6AEAE22430
2022-02-13 12:05,72122586,"7,347.6610","7,308.4610",40.00 AED,40.00,39.2000,0.8000,563589804,1573593,Success,United Arab Emirates,DU UAE,Transguard Group LLC,API User,E6AEAE64011
2022-02-13 12:06,72122649,"7,308.4610","7,288.8610",20.00 AED,20.00,19.6000,0.4000,563589925,1573596,Success,United Arab Emirates,DU UAE,Transguard Group LLC,API User,E6AEAE12938
2022-02-13 12:07,72122695,"7,288.8610","7,280.7210",300.00 PKR,9.25,8.1400,1.1100,563590040,1573601,Success,Pakistan,Zong Pakistan,Transguard Group LLC,API User,ZNPKPK70504
2022-02-13 12:08,72122715,"7,280.7210","7,270.9210",10.00 AED,10.00,9.8000,0.2000,563590093,1573604,Success,United Arab Emirates,DU UAE,Transguard Group LLC,API User,E6AEAE22430
2022-02-13 12:10,72122808,"7,270.9210","7,226.8210",45.00 AED,45.00,44.1000,0.9000,563590271,1573610,Success,United Arab Emirates,DU UAE,Transguard Group LLC,API User,E6AEAE35243
2022-02-13 12:10,72122817,"7,226.8210","7,221.9210",05.00 AED,5.00,4.9000,0.1000,563590299,1573612,Success,United Arab Emirates,DU UAE,Transguard Group LLC,API User,E6AEAE17361
2022-02-13 12:10,72122847,"7,221.9210","7,217.0210",05.00 AED,5.00,4.9000,0.1000,563590357,1573616,Success,United Arab Emirates,DU UAE,Transguard Group LLC,API User,E6AEAE17361
2022-02-13 12:11,72122863,"7,217.0210","7,207.2210",10.00 AED,10.00,9.8000,0.2000,563590383,1573619,Success,United Arab Emirates,DU UAE,Transguard Group LLC,API User,E6AEAE22430
2022-02-13 12:13,72123007,"7,207.2210","7,197.4210",10.00 AED,10.00,9.8000,0.2000,563590645,1573626,Success,United Arab Emirates,DU UAE,Transguard Group LLC,API User,E6AEAE22430
2022-02-13 12:14,72123067,"7,197.4210","7,192.5210",05.00 AED,5.00,4.9000,0.1000,563590784,1573630,Success,United Arab Emirates,DU UAE,Transguard Group LLC,API User,E6AEAE17361
2022-02-13 12:15,72123101,"7,192.5210","7,187.6210",05.00 AED,5.00,4.9000,0.1000,563590847,1573637,Success,United Arab Emirates,DU UAE,Transguard Group LLC,API User,E6AEAE17361
2022-02-13 12:15,72123110,"7,187.6210","7,177.8210",10.00 AED,10.00,9.8000,0.2000,563590857,1573638,Success,United Arab Emirates,DU UAE,Transguard Group LLC,API User,E6AEAE22430
2022-02-13 12:16,72123147,"7,177.8210","7,172.9210",05.00 AED,5.00,4.9000,0.1000,563590933,1573641,Success,United Arab Emirates,DU UAE,Transguard Group LLC,API User,E6AEAE17361
2022-02-13 12:17,72123227,"7,172.9210","7,159.9410",460.00 PKR,14.75,12.9800,1.7700,563591085,1573651,Success,Pakistan,Telenor Pakistan,Transguard Group LLC,API User,TPPKPK34330
2022-02-13 12:19,72123289,"7,159.9410","7,155.0410",05.00 AED,5.00,4.9000,0.1000,563591225,1573655,Success,United Arab Emirates,DU UAE,Transguard Group LLC,API User,E6AEAE17361
2022-02-13 12:19,72123309,"7,155.0410","7,145.2410",10.00 AED,10.00,9.8000,0.2000,563591261,1573658,Success,United Arab Emirates,DU UAE,Transguard Group LLC,API User,E6AEAE22430
2022-02-13 12:25,72123610,"7,145.2410","7,141.5010",100.00 NPR,4.25,3.7400,0.5100,563591893,1573670,Success,Nepal,Ncell Nepal,Transguard Group LLC,API User,NP_NC_TopUp_100.00
2022-02-13 12:25,72123622,"7,141.5010","7,136.6010",05.00 AED,5.00,4.9000,0.1000,563591913,1573672,Success,United Arab Emirates,DU UAE,Transguard Group LLC,API User,E6AEAE17361
2022-02-13 12:27,72123669,"7,136.6010","7,132.8610",100.00 NPR,4.25,3.7400,0.5100,563592030,1573678,Success,Nepal,Ncell Nepal,Transguard Group LLC,API User,NP_NC_TopUp_100.00
2022-02-13 12:27,72123676,"7,132.8610","7,123.0610",10.00 AED,10.00,9.8000,0.2000,563592041,1573679,Success,United Arab Emirates,DU UAE,Transguard Group LLC,API User,E6AEAE22430
2022-02-13 12:31,72123871,"7,123.0610","7,113.2610",10.00 AED,10.00,9.8000,0.2000,563592464,1573685,Success,United Arab Emirates,DU UAE,Transguard Group LLC,API User,E6AEAE22430
2022-02-13 12:32,72123963,"7,113.2610","7,103.4610",10.00 AED,10.00,9.8000,0.2000,563592637,1573691,Success,United Arab Emirates,DU UAE,Transguard Group LLC,API User,E6AEAE22430
2022-02-13 12:32,72123970,"7,103.4610","7,093.6610",10.00 AED,10.00,9.8000,0.2000,563592648,1573692,Success,United Arab Emirates,DU UAE,Transguard Group LLC,API User,E6AEAE22430
2022-02-13 12:35,72124118,"7,093.6610","7,088.7610",05.00 AED,5.00,4.9000,0.1000,563592929,1573698,Success,United Arab Emirates,DU UAE,Transguard Group LLC,API User,E6AEAE17361
2022-02-13 12:41,72124430,"7,088.7610","7,083.8610",05.00 AED,5.00,4.9000,0.1000,563593544,1573705,Success,United Arab Emirates,DU UAE,Transguard Group LLC,API User,E6AEAE17361
2022-02-13 12:46,72124718,"7,083.8610","7,074.0610",10.00 AED,10.00,9.8000,0.2000,563594132,1573717,Success,United Arab Emirates,DU UAE,Transguard Group LLC,API User,E6AEAE22430
2022-02-13 12:55,72125343,"7,074.0610","7,069.1610",05.00 AED,5.00,4.9000,0.1000,563595200,1573743,Success,United Arab Emirates,DU UAE,Transguard Group LLC,API User,E6AEAE17361
2022-02-13 12:58,72125476,"7,069.1610","7,064.2610",05.00 AED,5.00,4.9000,0.1000,563595467,1573752,Success,United Arab Emirates,DU UAE,Transguard Group LLC,API User,E6AEAE17361
2022-02-13 13:00,72125582,"7,064.2610","7,059.3610",05.00 AED,5.00,4.9000,0.1000,563595694,1573759,Success,United Arab Emirates,DU UAE,Transguard Group LLC,API User,E6AEAE17361
2022-02-13 13:02,72125671,"7,059.3610","7,050.5610",13.20 GHS,10.00,8.8000,1.2000,563595878,1573764,Success,Ghana,MTN Ghana,Transguard Group LLC,API User,GH_MT_TopUp
2022-02-13 13:02,72125682,"7,050.5610","7,045.6610",05.00 AED,5.00,4.9000,0.1000,563595907,1573765,Success,United Arab Emirates,DU UAE,Transguard Group LLC,API User,E6AEAE17361
2022-02-13 13:04,72125762,"7,045.6610","7,040.7610",05.00 AED,5.00,4.9000,0.1000,563596076,1573773,Success,United Arab Emirates,DU UAE,Transguard Group LLC,API User,E6AEAE17361
2022-02-13 13:11,72126057,"7,040.7610","7,030.9610",10.00 AED,10.00,9.8000,0.2000,563596731,1573785,Success,United Arab Emirates,DU UAE,Transguard Group LLC,API User,E6AEAE22430
2022-02-13 13:13,72126165,"7,030.9610","7,021.1610",10.00 AED,10.00,9.8000,0.2000,563596964,1573792,Success,United Arab Emirates,DU UAE,Transguard Group LLC,API User,E6AEAE22430
2022-02-13 13:18,72126412,"7,021.1610","7,011.3610",10.00 AED,10.00,9.8000,0.2000,563597483,1573800,Success,United Arab Emirates,DU UAE,Transguard Group LLC,API User,E6AEAE22430
2022-02-13 13:18,72126430,"7,011.3610","7,006.4610",05.00 AED,5.00,4.9000,0.1000,563597522,1573801,Success,United Arab Emirates,DU UAE,Transguard Group LLC,API User,E6AEAE17361
2022-02-13 13:18,72126439,"7,006.4610","7,001.5610",05.00 AED,5.00,4.9000,0.1000,563597540,1573803,Success,United Arab Emirates,DU UAE,Transguard Group LLC,API User,E6AEAE17361
2022-02-13 13:19,72126473,"7,001.5610","6,996.6610",05.00 AED,5.00,4.9000,0.1000,563597602,1573808,Success,United Arab Emirates,DU UAE,Transguard Group LLC,API User,E6AEAE17361
2022-02-13 13:24,72126731,"6,996.6610","6,986.8610",10.00 AED,10.00,9.8000,0.2000,563598149,1573811,Success,United Arab Emirates,DU UAE,Transguard Group LLC,API User,E6AEAE22430
2022-02-13 13:26,72126830,"6,986.8610","6,977.0610",10.00 AED,10.00,9.8000,0.2000,563598361,1573821,Success,United Arab Emirates,DU UAE,Transguard Group LLC,API User,E6AEAE22430
2022-02-13 13:26,72126857,"6,977.0610","6,972.1610",05.00 AED,5.00,4.9000,0.1000,563598425,1573825,Success,United Arab Emirates,DU UAE,Transguard Group LLC,API User,E6AEAE17361
2022-02-13 13:28,72126919,"6,972.1610","6,967.2610",05.00 AED,5.00,4.9000,0.1000,563598562,1573831,Success,United Arab Emirates,DU UAE,Transguard Group LLC,API User,E6AEAE17361
2022-02-13 13:28,72126940,"6,967.2610","6,957.4610",10.00 AED,10.00,9.8000,0.2000,563598613,1573834,Success,United Arab Emirates,DU UAE,Transguard Group LLC,API User,E6AEAE22430
2022-02-13 13:29,72126993,"6,957.4610","6,952.5610",05.00 AED,5.00,4.9000,0.1000,563598717,1573838,Success,United Arab Emirates,DU UAE,Transguard Group LLC,API User,E6AEAE17361
2022-02-13 13:39,72127528,"6,952.5610","6,947.6610",05.00 AED,5.00,4.9000,0.1000,563599822,1573848,Success,United Arab Emirates,DU UAE,Transguard Group LLC,API User,E6AEAE17361
2022-02-13 13:40,72127571,"6,947.6610","6,940.4010",200.00 NPR,8.25,7.2600,0.9900,563599925,1573851,Success,Nepal,Nepal Telecom Nepal,Transguard Group LLC,API User,NP_NE_TopUp_200.00
2022-02-13 13:42,72127654,"6,940.4010","6,935.5010",05.00 AED,5.00,4.9000,0.1000,563600109,1573855,Success,United Arab Emirates,DU UAE,Transguard Group LLC,API User,E6AEAE17361
2022-02-13 13:42,72127666,"6,935.5010","6,925.7010",10.00 AED,10.00,9.8000,0.2000,563600142,1573858,Success,United Arab Emirates,DU UAE,Transguard Group LLC,API User,E6AEAE22430
2022-02-13 13:45,72127862,"6,925.7010","6,920.8010",05.00 AED,5.00,4.9000,0.1000,563600532,1573864,Success,United Arab Emirates,DU UAE,Transguard Group LLC,API User,E6AEAE17361
2022-02-13 13:49,72128073,"6,920.8010","6,915.9010",05.00 AED,5.00,4.9000,0.1000,563600974,1573873,Success,United Arab Emirates,DU UAE,Transguard Group LLC,API User,E6AEAE17361
2022-02-13 13:50,72128114,"6,915.9010","6,906.1010",10.00 AED,10.00,9.8000,0.2000,563601073,1573878,Success,United Arab Emirates,DU UAE,Transguard Group LLC,API User,E6AEAE22430
2022-02-13 13:52,72128208,"6,906.1010","6,896.3010",10.00 AED,10.00,9.8000,0.2000,563601280,1573883,Success,United Arab Emirates,DU UAE,Transguard Group LLC,API User,E6AEAE22430
2022-02-13 13:54,72128252,"6,896.3010","6,891.4010",05.00 AED,5.00,4.9000,0.1000,563601392,1573886,Success,United Arab Emirates,DU UAE,Transguard Group LLC,API User,E6AEAE17361
2022-02-13 13:55,72128342,"6,891.4010","6,882.8210",315.00 PKR,9.75,8.5800,1.1700,563601580,1573889,Success,Pakistan,Zong Pakistan,Transguard Group LLC,API User,ZNPKPK29953
2022-02-13 13:56,72128416,"6,882.8210","6,877.9210",05.00 AED,5.00,4.9000,0.1000,563601717,1573893,Success,United Arab Emirates,DU UAE,Transguard Group LLC,API User,E6AEAE17361
2022-02-13 13:58,72128502,"6,877.9210","6,868.1210",10.00 AED,10.00,9.8000,0.2000,563601904,1573896,Success,United Arab Emirates,DU UAE,Transguard Group LLC,API User,E6AEAE22430
2022-02-13 14:04,72128816,"6,868.1210","6,858.3210",10.00 AED,10.00,9.8000,0.2000,563602552,1573906,Success,United Arab Emirates,DU UAE,Transguard Group LLC,API User,E6AEAE22430
2022-02-13 14:07,72128977,"6,858.3210","6,848.5210",10.00 AED,10.00,9.8000,0.2000,563602903,1573916,Success,United Arab Emirates,DU UAE,Transguard Group LLC,API User,E6AEAE22430
2022-02-13 14:12,72129246,"6,848.5210","6,838.7210",10.00 AED,10.00,9.8000,0.2000,563603447,1573921,Success,United Arab Emirates,DU UAE,Transguard Group LLC,API User,E6AEAE22430
2022-02-13 14:17,72129460,"6,838.7210","6,828.9210",10.00 AED,10.00,9.8000,0.2000,563603972,1573926,Success,United Arab Emirates,DU UAE,Transguard Group LLC,API User,E6AEAE22430
2022-02-13 14:19,72129608,"6,828.9210","6,824.0210",05.00 AED,5.00,4.9000,0.1000,563604286,1573929,Success,United Arab Emirates,DU UAE,Transguard Group LLC,API User,E6AEAE17361
2022-02-13 14:27,72129957,"6,824.0210","6,814.2210",10.00 AED,10.00,9.8000,0.2000,563605107,1573942,Success,United Arab Emirates,DU UAE,Transguard Group LLC,API User,E6AEAE22430
2022-02-13 14:30,72130106,"6,814.2210","6,809.3210",05.00 AED,5.00,4.9000,0.1000,563605425,1573945,Success,United Arab Emirates,DU UAE,Transguard Group LLC,API User,E6AEAE17361
2022-02-13 14:42,72130705,"6,809.3210","6,765.2210",45.00 AED,45.00,44.1000,0.9000,563606798,1573956,Success,United Arab Emirates,DU UAE,Transguard Group LLC,API User,E6AEAE35243
2022-02-13 14:43,72130741,"6,765.2210","6,755.4210",10.00 AED,10.00,9.8000,0.2000,563606891,1573960,Success,United Arab Emirates,DU UAE,Transguard Group LLC,API User,E6AEAE22430
2022-02-13 14:44,72130779,"6,755.4210","6,750.5210",05.00 AED,5.00,4.9000,0.1000,563606987,1573964,Success,United Arab Emirates,DU UAE,Transguard Group LLC,API User,E6AEAE17361
2022-02-13 14:45,72130861,"6,750.5210","6,745.6210",05.00 AED,5.00,4.9000,0.1000,563607189,1573968,Success,United Arab Emirates,DU UAE,Transguard Group LLC,API User,E6AEAE17361
2022-02-13 14:46,72130910,"6,745.6210","6,740.7210",05.00 AED,5.00,4.9000,0.1000,563607298,1573971,Success,United Arab Emirates,DU UAE,Transguard Group LLC,API User,E6AEAE17361
2022-02-13 14:49,72131019,"6,740.7210","6,730.9210",10.00 AED,10.00,9.8000,0.2000,563607532,1573979,Success,United Arab Emirates,DU UAE,Transguard Group LLC,API User,E6AEAE22430
2022-02-13 14:49,72131026,"6,730.9210","6,726.7410",150.00 PKR,4.75,4.1800,0.5700,563607555,1573980,Success,Pakistan,Ufone Pakistan,Transguard Group LLC,API User,UFPKPK90336
2022-02-13 14:55,72131307,"6,726.7410","6,721.8410",05.00 AED,5.00,4.9000,0.1000,563608178,1573985,Success,United Arab Emirates,DU UAE,Transguard Group LLC,API User,E6AEAE17361
2022-02-13 14:56,72131368,"6,721.8410","6,716.9410",05.00 AED,5.00,4.9000,0.1000,563608299,1573989,Success,United Arab Emirates,DU UAE,Transguard Group LLC,API User,E6AEAE17361
2022-02-13 14:59,72131532,"6,716.9410","6,707.1410",10.00 AED,10.00,9.8000,0.2000,563608664,1573994,Success,United Arab Emirates,DU UAE,Transguard Group LLC,API User,E6AEAE22430
2022-02-13 15:01,72131590,"6,707.1410","6,702.2410",05.00 AED,5.00,4.9000,0.1000,563608786,1573997,Success,United Arab Emirates,DU UAE,Transguard Group LLC,API User,E6AEAE17361
2022-02-13 15:02,72131670,"6,702.2410","6,697.3410",05.00 AED,5.00,4.9000,0.1000,563608960,1574002,Success,United Arab Emirates,DU UAE,Transguard Group LLC,API User,E6AEAE17361
2022-02-13 15:07,72131905,"6,697.3410","6,692.4410",05.00 AED,5.00,4.9000,0.1000,563609481,1574005,Success,United Arab Emirates,DU UAE,Transguard Group LLC,API User,E6AEAE17361
2022-02-13 15:08,72131989,"6,692.4410","6,687.5410",05.00 AED,5.00,4.9000,0.1000,563609654,1574008,Success,United Arab Emirates,DU UAE,Transguard Group LLC,API User,E6AEAE17361
2022-02-13 15:12,72132144,"6,687.5410","6,682.6410",05.00 AED,5.00,4.9000,0.1000,563610043,1574015,Success,United Arab Emirates,DU UAE,Transguard Group LLC,API User,E6AEAE17361
2022-02-13 15:15,72132295,"6,682.6410","6,672.8410",10.00 AED,10.00,9.8000,0.2000,563610389,1574023,Success,United Arab Emirates,DU UAE,Transguard Group LLC,API User,E6AEAE22430
2022-02-13 15:18,72132469,"6,672.8410","6,663.0410",10.00 AED,10.00,9.8000,0.2000,563610767,1574028,Success,United Arab Emirates,DU UAE,Transguard Group LLC,API User,E6AEAE22430
2022-02-13 15:18,72132498,"6,663.0410","6,658.1410",05.00 AED,5.00,4.9000,0.1000,563610804,1574029,Success,United Arab Emirates,DU UAE,Transguard Group LLC,API User,E6AEAE17361
2022-02-13 15:19,72132511,"6,658.1410","6,648.3410",10.00 AED,10.00,9.8000,0.2000,563610864,1574032,Success,United Arab Emirates,DU UAE,Transguard Group LLC,API User,E6AEAE22430
2022-02-13 15:20,72132587,"6,648.3410","6,638.5410",10.00 AED,10.00,9.8000,0.2000,563611070,1574037,Success,United Arab Emirates,DU UAE,Transguard Group LLC,API User,E6AEAE22430
2022-02-13 15:26,72132883,"6,638.5410","6,628.7410",10.00 AED,10.00,9.8000,0.2000,563611743,1574047,Success,United Arab Emirates,DU UAE,Transguard Group LLC,API User,E6AEAE22430
2022-02-13 15:27,72132891,"6,628.7410","6,623.8410",05.00 AED,5.00,4.9000,0.1000,563611784,1574049,Success,United Arab Emirates,DU UAE,Transguard Group LLC,API User,E6AEAE17361
2022-02-13 15:27,72132926,"6,623.8410","6,618.9410",05.00 AED,5.00,4.9000,0.1000,563611872,1574054,Success,United Arab Emirates,DU UAE,Transguard Group LLC,API User,E6AEAE17361
2022-02-13 15:33,72133165,"6,618.9410","6,614.0410",05.00 AED,5.00,4.9000,0.1000,563612446,1574061,Success,United Arab Emirates,DU UAE,Transguard Group LLC,API User,E6AEAE17361
2022-02-13 15:40,72133534,"6,614.0410","6,609.1410",05.00 AED,5.00,4.9000,0.1000,563613267,1574072,Success,United Arab Emirates,DU UAE,Transguard Group LLC,API User,E6AEAE17361
2022-02-13 15:47,72133882,"6,609.1410","6,604.9610",150.00 PKR,4.75,4.1800,0.5700,563614101,1574084,Success,Pakistan,Zong Pakistan,Transguard Group LLC,API User,ZNPKPK65621
2022-02-13 15:50,72134002,"6,604.9610","6,600.0610",05.00 AED,5.00,4.9000,0.1000,563614393,1574092,Success,United Arab Emirates,DU UAE,Transguard Group LLC,API User,E6AEAE17361
2022-02-13 15:50,72134005,"6,600.0610","6,590.2610",10.00 AED,10.00,9.8000,0.2000,563614397,1574093,Success,United Arab Emirates,DU UAE,Transguard Group LLC,API User,E6AEAE22430
2022-02-13 15:56,72134304,"6,590.2610","6,568.0410",800.00 PKR,25.25,22.2200,3.0300,563615107,1574101,Success,Pakistan,Jazz Pakistan,Transguard Group LLC,API User,MBPKPK58682
2022-02-13 15:58,72134398,"6,568.0410","6,550.4410",635.00 PKR,20.00,17.6000,2.4000,563615309,1574104,Success,Pakistan,Ufone Pakistan,Transguard Group LLC,API User,UFPKPK67474
2022-02-13 15:59,72134471,"6,550.4410","6,540.6410",10.00 AED,10.00,9.8000,0.2000,563615453,1574107,Success,United Arab Emirates,DU UAE,Transguard Group LLC,API User,E6AEAE22430
2022-02-13 16:02,72134593,"6,540.6410","6,535.7410",05.00 AED,5.00,4.9000,0.1000,563615749,1574110,Success,United Arab Emirates,DU UAE,Transguard Group LLC,API User,E6AEAE17361
2022-02-13 16:02,72134625,"6,535.7410","6,525.9410",10.00 AED,10.00,9.8000,0.2000,563615830,1574113,Success,United Arab Emirates,DU UAE,Transguard Group LLC,API User,E6AEAE22430
2022-02-13 16:04,72134697,"6,525.9410","6,516.1410",10.00 AED,10.00,9.8000,0.2000,563616014,1574119,Success,United Arab Emirates,DU UAE,Transguard Group LLC,API User,E6AEAE22430
2022-02-13 16:05,72134750,"6,516.1410","6,506.3410",10.00 AED,10.00,9.8000,0.2000,563616164,1574122,Success,United Arab Emirates,DU UAE,Transguard Group LLC,API User,E6AEAE22430
2022-02-13 16:10,72134959,"6,506.3410","6,501.4410",05.00 AED,5.00,4.9000,0.1000,563616690,1574131,Success,United Arab Emirates,DU UAE,Transguard Group LLC,API User,E6AEAE17361
2022-02-13 16:10,72134982,"6,501.4410","6,496.5410",05.00 AED,5.00,4.9000,0.1000,563616750,1574135,Success,United Arab Emirates,DU UAE,Transguard Group LLC,API User,E6AEAE17361
2022-02-13 16:11,72134990,"6,496.5410","6,486.7410",10.00 AED,10.00,9.8000,0.2000,563616773,1574137,Success,United Arab Emirates,DU UAE,Transguard Group LLC,API User,E6AEAE22430
2022-02-13 16:15,72135170,"6,486.7410","6,476.9410",10.00 AED,10.00,9.8000,0.2000,563617278,1574142,Success,United Arab Emirates,DU UAE,Transguard Group LLC,API User,E6AEAE22430
2022-02-13 16:15,72135175,"6,476.9410","6,472.0410",05.00 AED,5.00,4.9000,0.1000,563617282,1574143,Success,United Arab Emirates,DU UAE,Transguard Group LLC,API User,E6AEAE17361
2022-02-13 16:17,72135272,"6,472.0410","6,467.1410",05.00 AED,5.00,4.9000,0.1000,563617456,1574146,Success,United Arab Emirates,DU UAE,Transguard Group LLC,API User,E6AEAE17361
2022-02-13 16:19,72135401,"6,467.1410","6,462.2410",05.00 AED,5.00,4.9000,0.1000,563617842,1574149,Success,United Arab Emirates,DU UAE,Transguard Group LLC,API User,E6AEAE17361
2022-02-13 16:20,72135444,"6,462.2410","6,457.3410",05.00 AED,5.00,4.9000,0.1000,563617991,1574154,Success,United Arab Emirates,DU UAE,Transguard Group LLC,API User,E6AEAE17361
2022-02-13 16:22,72135503,"6,457.3410","6,447.5410",10.00 AED,10.00,9.8000,0.2000,563618132,1574164,Success,United Arab Emirates,DU UAE,Transguard Group LLC,API User,E6AEAE22430
2022-02-13 16:22,72135519,"6,447.5410","6,442.6410",05.00 AED,5.00,4.9000,0.1000,563618175,1574165,Success,United Arab Emirates,DU UAE,Transguard Group LLC,API User,E6AEAE17361
2022-02-13 16:23,72135611,"6,442.6410","6,439.5610",50.00 INR,3.50,3.0800,0.4200,563618379,1574168,Success,India,Vi India,Transguard Group LLC,API User,VFININ24286
2022-02-13 16:30,72135957,"6,439.5610","6,419.9610",20.00 AED,20.00,19.6000,0.4000,563619223,1574171,Success,United Arab Emirates,DU UAE,Transguard Group LLC,API User,E6AEAE12938
2022-02-13 16:36,72136265,"6,419.9610","6,415.0610",05.00 AED,5.00,4.9000,0.1000,563619992,1574185,Success,United Arab Emirates,DU UAE,Transguard Group LLC,API User,E6AEAE17361
2022-02-13 16:36,72136277,"6,415.0610","6,395.4610",20.00 AED,20.00,19.6000,0.4000,563620025,1574188,Success,United Arab Emirates,DU UAE,Transguard Group LLC,API User,E6AEAE12938
2022-02-13 16:36,72136304,"6,395.4610","6,385.6610",10.00 AED,10.00,9.8000,0.2000,563620049,1574190,Success,United Arab Emirates,DU UAE,Transguard Group LLC,API User,E6AEAE22430
2022-02-13 16:37,72136341,"6,385.6610","6,380.7610",05.00 AED,5.00,4.9000,0.1000,563620148,1574194,Success,United Arab Emirates,DU UAE,Transguard Group LLC,API User,E6AEAE17361
2022-02-13 16:38,72136425,"6,380.7610","6,375.8610",05.00 AED,5.00,4.9000,0.1000,563620296,1574198,Success,United Arab Emirates,DU UAE,Transguard Group LLC,API User,E6AEAE17361
2022-02-13 16:39,72136458,"6,375.8610","6,370.9610",05.00 AED,5.00,4.9000,0.1000,563620391,1574201,Success,United Arab Emirates,DU UAE,Transguard Group LLC,API User,E6AEAE17361
2022-02-13 16:43,72136684,"6,370.9610","6,366.0610",05.00 AED,5.00,4.9000,0.1000,563620889,1574214,Success,United Arab Emirates,DU UAE,Transguard Group LLC,API User,E6AEAE17361
2022-02-13 16:43,72136687,"6,366.0610","6,356.2610",10.00 AED,10.00,9.8000,0.2000,563620894,1574215,Success,United Arab Emirates,DU UAE,Transguard Group LLC,API User,E6AEAE22430
2022-02-13 16:47,72136936,"6,356.2610","6,351.3610",05.00 AED,5.00,4.9000,0.1000,563621508,1574223,Success,United Arab Emirates,DU UAE,Transguard Group LLC,API User,E6AEAE17361
2022-02-13 16:50,72137089,"6,351.3610","6,346.4610",05.00 AED,5.00,4.9000,0.1000,563621925,1574234,Success,United Arab Emirates,DU UAE,Transguard Group LLC,API User,E6AEAE17361
2022-02-13 16:52,72137200,"6,346.4610","6,341.5610",05.00 AED,5.00,4.9000,0.1000,563622174,1574242,Success,United Arab Emirates,DU UAE,Transguard Group LLC,API User,E6AEAE17361
2022-02-13 16:54,72137280,"6,341.5610","6,321.9610",20.00 AED,20.00,19.6000,0.4000,563622368,1574252,Success,United Arab Emirates,DU UAE,Transguard Group LLC,API User,E6AEAE12938
2022-02-13 16:55,72137344,"6,321.9610","6,317.0610",05.00 AED,5.00,4.9000,0.1000,563622541,1574258,Success,United Arab Emirates,DU UAE,Transguard Group LLC,API User,E6AEAE17361
2022-02-13 16:57,72137450,"6,317.0610","6,297.4610",20.00 AED,20.00,19.6000,0.4000,563622760,1574264,Success,United Arab Emirates,DU UAE,Transguard Group LLC,API User,E6AEAE12938
2022-02-13 17:00,72137632,"6,297.4610","6,287.6610",10.00 AED,10.00,9.8000,0.2000,563623221,1574276,Success,United Arab Emirates,DU UAE,Transguard Group LLC,API User,E6AEAE22430
2022-02-13 17:00,72137651,"6,287.6610","6,282.7610",05.00 AED,5.00,4.9000,0.1000,563623267,1574279,Success,United Arab Emirates,DU UAE,Transguard Group LLC,API User,E6AEAE17361
2022-02-13 17:00,72137675,"6,282.7610","6,243.5610",40.00 AED,40.00,39.2000,0.8000,563623338,1574281,Success,United Arab Emirates,DU UAE,Transguard Group LLC,API User,E6AEAE64011
2022-02-13 17:01,72137733,"6,243.5610","6,233.7610",10.00 AED,10.00,9.8000,0.2000,563623479,1574287,Success,United Arab Emirates,DU UAE,Transguard Group LLC,API User,E6AEAE22430
2022-02-13 17:06,72138054,"6,233.7610","6,223.9610",10.00 AED,10.00,9.8000,0.2000,563624262,1574300,Success,United Arab Emirates,DU UAE,Transguard Group LLC,API User,E6AEAE22430
2022-02-13 17:09,72138182,"6,223.9610","6,219.0610",05.00 AED,5.00,4.9000,0.1000,563624552,1574306,Success,United Arab Emirates,DU UAE,Transguard Group LLC,API User,E6AEAE17361
2022-02-13 17:10,72138262,"6,219.0610","6,214.1610",05.00 AED,5.00,4.9000,0.1000,563624749,1574315,Success,United Arab Emirates,DU UAE,Transguard Group LLC,API User,E6AEAE17361
2022-02-13 17:11,72138379,"6,214.1610","6,209.2610",05.00 AED,5.00,4.9000,0.1000,563624981,1574323,Success,United Arab Emirates,DU UAE,Transguard Group LLC,API User,E6AEAE17361
2022-02-13 17:11,72138416,"6,209.2610","6,204.8610",01.09 USD,5.00,4.4000,0.6000,563625050,1574327,Success,Afghanistan,MTN Afghanistan,Transguard Group LLC,API User,AF_MT_TopUp
2022-02-13 17:13,72138583,"6,204.8610","6,199.9610",05.00 AED,5.00,4.9000,0.1000,563625387,1574331,Success,United Arab Emirates,DU UAE,Transguard Group LLC,API User,E6AEAE17361
2022-02-13 17:16,72138786,"6,199.9610","6,185.2610",15.00 AED,15.00,14.7000,0.3000,563625884,1574345,Success,United Arab Emirates,DU UAE,Transguard Group LLC,API User,E6AEAE8527
2022-02-13 17:16,72138794,"6,185.2610","6,180.3610",05.00 AED,5.00,4.9000,0.1000,563625895,1574346,Success,United Arab Emirates,DU UAE,Transguard Group LLC,API User,E6AEAE17361
2022-02-13 17:18,72138880,"6,180.3610","6,175.4610",05.00 AED,5.00,4.9000,0.1000,563626101,1574355,Success,United Arab Emirates,DU UAE,Transguard Group LLC,API User,E6AEAE17361
2022-02-13 17:18,72138887,"6,175.4610","6,170.5610",05.00 AED,5.00,4.9000,0.1000,563626113,1574356,Success,United Arab Emirates,DU UAE,Transguard Group LLC,API User,E6AEAE17361
2022-02-13 17:19,72138970,"6,170.5610","6,160.7610",10.00 AED,10.00,9.8000,0.2000,563626298,1574359,Success,United Arab Emirates,DU UAE,Transguard Group LLC,API User,E6AEAE22430
2022-02-13 17:23,72139247,"6,160.7610","6,155.8610",05.00 AED,5.00,4.9000,0.1000,563626992,1574366,Success,United Arab Emirates,DU UAE,Transguard Group LLC,API User,E6AEAE17361
2022-02-13 17:29,72139655,"6,155.8610","6,150.9610",05.00 AED,5.00,4.9000,0.1000,563627958,1574379,Success,United Arab Emirates,DU UAE,Transguard Group LLC,API User,E6AEAE17361
2022-02-13 17:31,72139767,"6,150.9610","6,146.0610",05.00 AED,5.00,4.9000,0.1000,563628267,1574384,Success,United Arab Emirates,DU UAE,Transguard Group LLC,API User,E6AEAE17361
2022-02-13 17:33,72139882,"6,146.0610","6,141.1610",05.00 AED,5.00,4.9000,0.1000,563628559,1574387,Success,United Arab Emirates,DU UAE,Transguard Group LLC,API User,E6AEAE17361
2022-02-13 17:35,72139981,"6,141.1610","6,131.3610",10.00 AED,10.00,9.8000,0.2000,563628792,1574392,Success,United Arab Emirates,DU UAE,Transguard Group LLC,API User,E6AEAE22430
2022-02-13 17:37,72140124,"6,131.3610","6,126.4610",05.00 AED,5.00,4.9000,0.1000,563629197,1574395,Success,United Arab Emirates,DU UAE,Transguard Group LLC,API User,E6AEAE17361
2022-02-13 17:41,72140417,"6,126.4610","6,097.0610",30.00 AED,30.00,29.4000,0.6000,563629946,1574400,Success,United Arab Emirates,DU UAE,Transguard Group LLC,API User,E6AEAE46146
2022-02-13 17:49,72140990,"6,097.0610","6,062.7610",35.00 AED,35.00,34.3000,0.7000,563631443,1574409,Success,United Arab Emirates,DU UAE,Transguard Group LLC,API User,E6AEAE73954
2022-02-13 17:51,72141082,"6,062.7610","6,052.9610",10.00 AED,10.00,9.8000,0.2000,563631669,1574413,Success,United Arab Emirates,DU UAE,Transguard Group LLC,API User,E6AEAE22430
2022-02-13 17:51,72141116,"6,052.9610","6,043.1610",10.00 AED,10.00,9.8000,0.2000,563631762,1574416,Success,United Arab Emirates,DU UAE,Transguard Group LLC,API User,E6AEAE22430
2022-02-13 17:53,72141280,"6,043.1610","6,033.3610",10.00 AED,10.00,9.8000,0.2000,563632133,1574421,Success,United Arab Emirates,DU UAE,Transguard Group LLC,API User,E6AEAE22430
2022-02-13 17:54,72141334,"6,033.3610","6,028.4610",05.00 AED,5.00,4.9000,0.1000,563632262,1574424,Success,United Arab Emirates,DU UAE,Transguard Group LLC,API User,E6AEAE17361
2022-02-13 17:59,72141716,"6,028.4610","6,018.6610",10.00 AED,10.00,9.8000,0.2000,563633223,1574437,Success,United Arab Emirates,DU UAE,Transguard Group LLC,API User,E6AEAE22430
2022-02-13 18:01,72141776,"6,018.6610","6,013.7610",05.00 AED,5.00,4.9000,0.1000,563633421,1574443,Success,United Arab Emirates,DU UAE,Transguard Group LLC,API User,E6AEAE17361
2022-02-13 18:01,72141779,"6,013.7610","6,008.8610",05.00 AED,5.00,4.9000,0.1000,563633426,1574444,Success,United Arab Emirates,DU UAE,Transguard Group LLC,API User,E6AEAE17361
2022-02-13 18:01,72141818,"6,008.8610","6,003.9610",05.00 AED,5.00,4.9000,0.1000,563633560,1574449,Success,United Arab Emirates,DU UAE,Transguard Group LLC,API User,E6AEAE17361
2022-02-13 18:02,72141859,"6,003.9610","5,999.0610",05.00 AED,5.00,4.9000,0.1000,563633702,1574454,Success,United Arab Emirates,DU UAE,Transguard Group LLC,API User,E6AEAE17361
2022-02-13 18:03,72141932,"5,999.0610","5,989.2610",10.00 AED,10.00,9.8000,0.2000,563633888,1574457,Success,United Arab Emirates,DU UAE,Transguard Group LLC,API User,E6AEAE22430
2022-02-13 18:05,72142122,"5,989.2610","5,983.3210",99.00 INR,6.75,5.9400,0.8100,563634326,1574459,Success,India,Airtel India,Transguard Group LLC,API User,AIININ6418
2022-02-13 18:15,72142789,"5,983.3210","5,978.4210",05.00 AED,5.00,4.9000,0.1000,563636047,1574474,Success,United Arab Emirates,DU UAE,Transguard Group LLC,API User,E6AEAE17361
2022-02-13 18:18,72143023,"5,978.4210","5,973.5210",05.00 AED,5.00,4.9000,0.1000,563636747,1574482,Success,United Arab Emirates,DU UAE,Transguard Group LLC,API User,E6AEAE17361
2022-02-13 18:19,72143044,"5,973.5210","5,968.6210",05.00 AED,5.00,4.9000,0.1000,563636799,1574486,Success,United Arab Emirates,DU UAE,Transguard Group LLC,API User,E6AEAE17361
2022-02-13 18:20,72143158,"5,968.6210","5,964.8810",98.00 NPR,4.25,3.7400,0.5100,563637101,1574497,Success,Nepal,Ncell Nepal,Transguard Group LLC,API User,NCNPNP3715
2022-02-13 18:30,72143853,"5,964.8810","5,959.9810",05.00 AED,5.00,4.9000,0.1000,563638910,1574516,Success,United Arab Emirates,DU UAE,Transguard Group LLC,API User,E6AEAE17361
2022-02-13 18:31,72143911,"5,959.9810","5,955.8010",150.00 PKR,4.75,4.1800,0.5700,563639084,1574520,Success,Pakistan,Zong Pakistan,Transguard Group LLC,API User,ZNPKPK65621
2022-02-13 18:33,72144110,"5,955.8010","5,946.0010",10.00 AED,10.00,9.8000,0.2000,563639551,1574529,Success,United Arab Emirates,DU UAE,Transguard Group LLC,API User,E6AEAE22430
2022-02-13 18:33,72144121,"5,946.0010","5,941.1010",05.00 AED,5.00,4.9000,0.1000,563639576,1574531,Success,United Arab Emirates,DU UAE,Transguard Group LLC,API User,E6AEAE17361
2022-02-13 18:36,72144297,"5,941.1010","5,931.3010",10.00 AED,10.00,9.8000,0.2000,563640049,1574540,Success,United Arab Emirates,DU UAE,Transguard Group LLC,API User,E6AEAE22430
2022-02-13 18:38,72144454,"5,931.3010","5,926.4010",05.00 AED,5.00,4.9000,0.1000,563640465,1574547,Success,United Arab Emirates,DU UAE,Transguard Group LLC,API User,E6AEAE17361
2022-02-13 18:38,72144511,"5,926.4010","5,921.5010",05.00 AED,5.00,4.9000,0.1000,563640611,1574550,Success,United Arab Emirates,DU UAE,Transguard Group LLC,API User,E6AEAE17361
2022-02-13 18:41,72144744,"5,921.5010","5,916.6010",05.00 AED,5.00,4.9000,0.1000,563641171,1574558,Success,United Arab Emirates,DU UAE,Transguard Group LLC,API User,E6AEAE17361
2022-02-13 18:43,72144905,"5,916.6010","5,911.7010",05.00 AED,5.00,4.9000,0.1000,563641571,1574569,Success,United Arab Emirates,DU UAE,Transguard Group LLC,API User,E6AEAE17361
2022-02-13 18:43,72144946,"5,911.7010","5,906.8010",05.00 AED,5.00,4.9000,0.1000,563641662,1574576,Success,United Arab Emirates,DU UAE,Transguard Group LLC,API User,E6AEAE17361
2022-02-13 18:46,72145153,"5,906.8010","5,901.9010",05.00 AED,5.00,4.9000,0.1000,563642198,1574592,Success,United Arab Emirates,DU UAE,Transguard Group LLC,API User,E6AEAE17361
2022-02-13 18:46,72145172,"5,901.9010","5,897.0010",05.00 AED,5.00,4.9000,0.1000,563642240,1574594,Success,United Arab Emirates,DU UAE,Transguard Group LLC,API User,E6AEAE17361
2022-02-13 18:46,72145199,"5,897.0010","5,889.0810",220.00 NPR,9.00,7.9200,1.0800,563642318,1574596,Success,Nepal,Ncell Nepal,Transguard Group LLC,API User,NCNPNP79518
2022-02-13 18:48,72145351,"5,889.0810","5,879.2810",10.00 AED,10.00,9.8000,0.2000,563642659,1574599,Success,United Arab Emirates,DU UAE,Transguard Group LLC,API User,E6AEAE22430
2022-02-13 18:51,72145595,"5,879.2810","5,874.3810",05.00 AED,5.00,4.9000,0.1000,563643321,1574608,Success,United Arab Emirates,DU UAE,Transguard Group LLC,API User,E6AEAE17361
2022-02-13 18:51,72145604,"5,874.3810","5,869.4810",05.00 AED,5.00,4.9000,0.1000,563643336,1574609,Success,United Arab Emirates,DU UAE,Transguard Group LLC,API User,E6AEAE17361
2022-02-13 18:52,72145683,"5,869.4810","5,864.5810",05.00 AED,5.00,4.9000,0.1000,563643544,1574617,Success,United Arab Emirates,DU UAE,Transguard Group LLC,API User,E6AEAE17361
2022-02-13 18:53,72145703,"5,864.5810","5,859.6810",05.00 AED,5.00,4.9000,0.1000,563643595,1574621,Success,United Arab Emirates,DU UAE,Transguard Group LLC,API User,E6AEAE17361
2022-02-13 18:53,72145707,"5,859.6810","5,835.1810",25.00 AED,25.00,24.5000,0.5000,563643597,1574622,Success,United Arab Emirates,DU UAE,Transguard Group LLC,API User,E6AEAE17343
2022-02-13 18:54,72145780,"5,835.1810","5,830.2810",05.00 AED,5.00,4.9000,0.1000,563643788,1574627,Success,United Arab Emirates,DU UAE,Transguard Group LLC,API User,E6AEAE17361
2022-02-13 18:56,72145965,"5,830.2810","5,825.3810",05.00 AED,5.00,4.9000,0.1000,563644256,1574634,Success,United Arab Emirates,DU UAE,Transguard Group LLC,API User,E6AEAE17361
2022-02-13 19:00,72146313,"5,825.3810","5,815.5810",10.00 AED,10.00,9.8000,0.2000,563645103,1574644,Success,United Arab Emirates,DU UAE,Transguard Group LLC,API User,E6AEAE22430
2022-02-13 19:02,72146543,"5,815.5810","5,810.6810",05.00 AED,5.00,4.9000,0.1000,563645650,1574659,Success,United Arab Emirates,DU UAE,Transguard Group LLC,API User,E6AEAE17361
2022-02-13 19:02,72146553,"5,810.6810","5,800.8810",10.00 AED,10.00,9.8000,0.2000,563645668,1574662,Success,United Arab Emirates,DU UAE,Transguard Group LLC,API User,E6AEAE22430
2022-02-13 19:03,72146605,"5,800.8810","5,795.9810",05.00 AED,5.00,4.9000,0.1000,563645775,1574664,Success,United Arab Emirates,DU UAE,Transguard Group LLC,API User,E6AEAE17361
2022-02-13 19:03,72146628,"5,795.9810","5,786.1810",10.00 AED,10.00,9.8000,0.2000,563645834,1574668,Success,United Arab Emirates,DU UAE,Transguard Group LLC,API User,E6AEAE22430
2022-02-13 19:03,72146630,"5,786.1810","5,781.2810",05.00 AED,5.00,4.9000,0.1000,563645847,1574669,Success,United Arab Emirates,DU UAE,Transguard Group LLC,API User,E6AEAE17361
2022-02-13 19:04,72146748,"5,781.2810","5,776.3810",05.00 AED,5.00,4.9000,0.1000,563646066,1574677,Success,United Arab Emirates,DU UAE,Transguard Group LLC,API User,E6AEAE17361
2022-02-13 19:04,72146757,"5,776.3810","5,771.4810",05.00 AED,5.00,4.9000,0.1000,563646091,1574678,Success,United Arab Emirates,DU UAE,Transguard Group LLC,API User,E6AEAE17361
2022-02-13 19:04,72146778,"5,771.4810","5,766.5810",05.00 AED,5.00,4.9000,0.1000,563646124,1574681,Success,United Arab Emirates,DU UAE,Transguard Group LLC,API User,E6AEAE17361
2022-02-13 19:05,72146904,"5,766.5810","5,756.7810",10.00 AED,10.00,9.8000,0.2000,563646403,1574686,Success,United Arab Emirates,DU UAE,Transguard Group LLC,API User,E6AEAE22430
2022-02-13 19:06,72146935,"5,756.7810","5,751.8810",05.00 AED,5.00,4.9000,0.1000,563646528,1574689,Success,United Arab Emirates,DU UAE,Transguard Group LLC,API User,E6AEAE17361
2022-02-13 19:08,72147107,"5,751.8810","5,746.9810",05.00 AED,5.00,4.9000,0.1000,563646944,1574706,Success,United Arab Emirates,DU UAE,Transguard Group LLC,API User,E6AEAE17361
2022-02-13 19:09,72147183,"5,746.9810","5,737.1810",10.00 AED,10.00,9.8000,0.2000,563647142,1574712,Success,United Arab Emirates,DU UAE,Transguard Group LLC,API User,E6AEAE22430
2022-02-13 19:11,72147376,"5,737.1810","5,697.9810",40.00 AED,40.00,39.2000,0.8000,563647628,1574723,Success,United Arab Emirates,DU UAE,Transguard Group LLC,API User,E6AEAE64011
2022-02-13 19:11,72147386,"5,697.9810","5,688.1810",10.00 AED,10.00,9.8000,0.2000,563647646,1574724,Success,United Arab Emirates,DU UAE,Transguard Group LLC,API User,E6AEAE22430
2022-02-13 19:13,72147501,"5,688.1810","5,683.2810",05.00 AED,5.00,4.9000,0.1000,563647969,1574729,Success,United Arab Emirates,DU UAE,Transguard Group LLC,API User,E6AEAE17361
2022-02-13 19:16,72147764,"5,683.2810","5,673.4810",10.00 AED,10.00,9.8000,0.2000,563648662,1574740,Success,United Arab Emirates,DU UAE,Transguard Group LLC,API User,E6AEAE22430
2022-02-13 19:16,72147803,"5,673.4810","5,668.5810",05.00 AED,5.00,4.9000,0.1000,563648754,1574743,Success,United Arab Emirates,DU UAE,Transguard Group LLC,API User,E6AEAE17361
2022-02-13 19:21,72148130,"5,668.5810","5,660.2210",300.00 PKR,9.50,8.3600,1.1400,563649654,1574757,Success,Pakistan,Jazz Pakistan,Transguard Group LLC,API User,PK_MB_TopUp_300.00
2022-02-13 19:23,72148340,"5,660.2210","5,655.3210",05.00 AED,5.00,4.9000,0.1000,563650182,1574766,Success,United Arab Emirates,DU UAE,Transguard Group LLC,API User,E6AEAE17361
2022-02-13 19:31,72148978,"5,655.3210","5,650.4210",05.00 AED,5.00,4.9000,0.1000,563651798,1574779,Success,United Arab Emirates,DU UAE,Transguard Group LLC,API User,E6AEAE17361
2022-02-13 19:31,72149020,"5,650.4210","5,645.5210",05.00 AED,5.00,4.9000,0.1000,563651924,1574783,Success,United Arab Emirates,DU UAE,Transguard Group LLC,API User,E6AEAE17361
2022-02-13 19:33,72149157,"5,645.5210","5,635.7210",10.00 AED,10.00,9.8000,0.2000,563652294,1574790,Success,United Arab Emirates,DU UAE,Transguard Group LLC,API User,E6AEAE22430
2022-02-13 19:35,72149329,"5,635.7210","5,630.8210",05.00 AED,5.00,4.9000,0.1000,563652753,1574795,Success,United Arab Emirates,DU UAE,Transguard Group LLC,API User,E6AEAE17361
2022-02-13 19:37,72149470,"5,630.8210","5,621.0210",10.00 AED,10.00,9.8000,0.2000,563653107,1574800,Success,United Arab Emirates,DU UAE,Transguard Group LLC,API User,E6AEAE22430
2022-02-13 19:37,72149485,"5,621.0210","5,616.6210",401.00 NGN,5.00,4.4000,0.6000,563653140,1574801,Success,Nigeria,MTN Nigeria,Transguard Group LLC,API User,NG_MT_TopUp
2022-02-13 19:39,72149612,"5,616.6210","5,611.7210",05.00 AED,5.00,4.9000,0.1000,563653474,1574806,Success,United Arab Emirates,DU UAE,Transguard Group LLC,API User,E6AEAE17361
2022-02-13 19:39,72149616,"5,611.7210","5,601.9210",10.00 AED,10.00,9.8000,0.2000,563653484,1574807,Success,United Arab Emirates,DU UAE,Transguard Group LLC,API User,E6AEAE22430
2022-02-13 19:41,72149829,"5,601.9210","5,595.9810",100.00 INR,6.75,5.9400,0.8100,563654021,1574813,Success,India,Vi India,Transguard Group LLC,API User,VFININ43046
2022-02-13 19:42,72149887,"5,595.9810","5,591.0810",05.00 AED,5.00,4.9000,0.1000,563654156,1574818,Success,United Arab Emirates,DU UAE,Transguard Group LLC,API User,E6AEAE17361
2022-02-13 19:43,72149971,"5,591.0810","5,586.1810",05.00 AED,5.00,4.9000,0.1000,563654356,1574822,Success,United Arab Emirates,DU UAE,Transguard Group LLC,API User,E6AEAE17361
2022-02-13 19:43,72150001,"5,586.1810","5,566.5810",20.00 AED,20.00,19.6000,0.4000,563654430,1574824,Success,United Arab Emirates,DU UAE,Transguard Group LLC,API User,E6AEAE12938
2022-02-13 19:47,72150315,"5,566.5810","5,563.5010",50.00 INR,3.50,3.0800,0.4200,563655254,1574833,Success,India,Vi India,Transguard Group LLC,API User,VFININ24286
2022-02-13 19:50,72150565,"5,563.5010","5,539.0010",25.00 AED,25.00,24.5000,0.5000,563655886,1574839,Success,United Arab Emirates,DU UAE,Transguard Group LLC,API User,E6AEAE17343
2022-02-13 19:52,72150698,"5,539.0010","5,529.2010",10.00 AED,10.00,9.8000,0.2000,563656286,1574842,Success,United Arab Emirates,DU UAE,Transguard Group LLC,API User,E6AEAE22430
2022-02-13 19:57,72151107,"5,529.2010","5,524.3010",05.00 AED,5.00,4.9000,0.1000,563657421,1574859,Success,United Arab Emirates,DU UAE,Transguard Group LLC,API User,E6AEAE17361
2022-02-13 19:58,72151157,"5,524.3010","5,519.4010",05.00 AED,5.00,4.9000,0.1000,563657564,1574866,Success,United Arab Emirates,DU UAE,Transguard Group LLC,API User,E6AEAE17361
2022-02-13 19:59,72151220,"5,519.4010","5,514.5010",05.00 AED,5.00,4.9000,0.1000,563657709,1574871,Success,United Arab Emirates,DU UAE,Transguard Group LLC,API User,E6AEAE17361
2022-02-13 20:00,72151324,"5,514.5010","5,504.7010",10.00 AED,10.00,9.8000,0.2000,563658022,1574878,Success,United Arab Emirates,DU UAE,Transguard Group LLC,API User,E6AEAE22430
2022-02-13 20:01,72151356,"5,504.7010","5,499.8010",05.00 AED,5.00,4.9000,0.1000,563658120,1574881,Success,United Arab Emirates,DU UAE,Transguard Group LLC,API User,E6AEAE17361
2022-02-13 20:04,72151580,"5,499.8010","5,494.9010",05.00 AED,5.00,4.9000,0.1000,563658763,1574889,Success,United Arab Emirates,DU UAE,Transguard Group LLC,API User,E6AEAE17361
2022-02-13 20:05,72151706,"5,494.9010","5,485.1010",10.00 AED,10.00,9.8000,0.2000,563659098,1574897,Success,United Arab Emirates,DU UAE,Transguard Group LLC,API User,E6AEAE22430
2022-02-13 20:06,72151751,"5,485.1010","5,475.3010",10.00 AED,10.00,9.8000,0.2000,563659231,1574904,Success,United Arab Emirates,DU UAE,Transguard Group LLC,API User,E6AEAE22430
2022-02-13 20:06,72151755,"5,475.3010","5,471.5610",100.00 NPR,4.25,3.7400,0.5100,563659253,1574905,Success,Nepal,Nepal Telecom Nepal,Transguard Group LLC,API User,NP_NE_TopUp_100.00
2022-02-13 20:10,72152077,"5,471.5610","5,461.7610",10.00 AED,10.00,9.8000,0.2000,563660116,1574914,Success,United Arab Emirates,DU UAE,Transguard Group LLC,API User,E6AEAE22430
2022-02-13 20:11,72152145,"5,461.7610","5,451.9610",10.00 AED,10.00,9.8000,0.2000,563660332,1574921,Success,United Arab Emirates,DU UAE,Transguard Group LLC,API User,E6AEAE22430
2022-02-13 20:12,72152194,"5,451.9610","5,447.0610",05.00 AED,5.00,4.9000,0.1000,563660483,1574925,Success,United Arab Emirates,DU UAE,Transguard Group LLC,API User,E6AEAE17361
2022-02-13 20:13,72152294,"5,447.0610","5,443.3210",100.00 NPR,4.25,3.7400,0.5100,563660733,1574931,Success,Nepal,SmartCell Nepal,Transguard Group LLC,API User,NQNPNP58761
2022-02-13 20:15,72152406,"5,443.3210","5,438.4210",05.00 AED,5.00,4.9000,0.1000,563661011,1574938,Success,United Arab Emirates,DU UAE,Transguard Group LLC,API User,E6AEAE17361
2022-02-13 20:19,72152730,"5,438.4210","5,428.6210",10.00 AED,10.00,9.8000,0.2000,563661917,1574946,Success,United Arab Emirates,DU UAE,Transguard Group LLC,API User,E6AEAE22430
2022-02-13 20:20,72152832,"5,428.6210","5,423.7210",05.00 AED,5.00,4.9000,0.1000,563662213,1574951,Success,United Arab Emirates,DU UAE,Transguard Group LLC,API User,E6AEAE17361
2022-02-13 20:21,72152870,"5,423.7210","5,418.8210",05.00 AED,5.00,4.9000,0.1000,563662294,1574953,Success,United Arab Emirates,DU UAE,Transguard Group LLC,API User,E6AEAE17361
2022-02-13 20:25,72153212,"5,418.8210","5,409.0210",10.00 AED,10.00,9.8000,0.2000,563663195,1574964,Success,United Arab Emirates,DU UAE,Transguard Group LLC,API User,E6AEAE22430
2022-02-13 20:26,72153247,"5,409.0210","5,399.2210",10.00 AED,10.00,9.8000,0.2000,563663311,1574966,Success,United Arab Emirates,DU UAE,Transguard Group LLC,API User,E6AEAE22430
2022-02-13 20:27,72153297,"5,399.2210","5,389.4210",10.00 AED,10.00,9.8000,0.2000,563663490,1574974,Success,United Arab Emirates,DU UAE,Transguard Group LLC,API User,E6AEAE22430
2022-02-13 20:28,72153412,"5,389.4210","5,381.5010",220.00 NPR,9.00,7.9200,1.0800,563663800,1574982,Success,Nepal,Ncell Nepal,Transguard Group LLC,API User,NCNPNP79518
2022-02-13 20:29,72153446,"5,381.5010","5,376.6010",05.00 AED,5.00,4.9000,0.1000,563663882,1574984,Success,United Arab Emirates,DU UAE,Transguard Group LLC,API User,E6AEAE17361
2022-02-13 20:29,72153480,"5,376.6010","5,371.7010",05.00 AED,5.00,4.9000,0.1000,563663992,1574990,Success,United Arab Emirates,DU UAE,Transguard Group LLC,API User,E6AEAE17361
2022-02-13 20:36,72154003,"5,371.7010","5,361.9010",10.00 AED,10.00,9.8000,0.2000,563665390,1575001,Success,United Arab Emirates,DU UAE,Transguard Group LLC,API User,E6AEAE22430
2022-02-13 20:39,72154199,"5,361.9010","5,357.7210",150.00 PKR,4.75,4.1800,0.5700,563665929,1575006,Success,Pakistan,Zong Pakistan,Transguard Group LLC,API User,ZNPKPK65621
2022-02-13 20:41,72154334,"5,357.7210","5,352.8210",05.00 AED,5.00,4.9000,0.1000,563666340,1575011,Success,United Arab Emirates,DU UAE,Transguard Group LLC,API User,E6AEAE17361
2022-02-13 20:42,72154354,"5,352.8210","5,347.9210",05.00 AED,5.00,4.9000,0.1000,563666390,1575013,Success,United Arab Emirates,DU UAE,Transguard Group LLC,API User,E6AEAE17361
2022-02-13 20:44,72154515,"5,347.9210","5,328.3210",20.00 AED,20.00,19.6000,0.4000,563666770,1575017,Success,United Arab Emirates,DU UAE,Transguard Group LLC,API User,E6AEAE12938
2022-02-13 20:48,72154858,"5,328.3210","5,318.5210",10.00 AED,10.00,9.8000,0.2000,563667688,1575026,Success,United Arab Emirates,DU UAE,Transguard Group LLC,API User,E6AEAE22430
2022-02-13 20:49,72154889,"5,318.5210","5,308.7210",10.00 AED,10.00,9.8000,0.2000,563667777,1575028,Success,United Arab Emirates,DU UAE,Transguard Group LLC,API User,E6AEAE22430
2022-02-13 20:50,72154936,"5,308.7210","5,303.8210",05.00 AED,5.00,4.9000,0.1000,563667908,1575032,Success,United Arab Emirates,DU UAE,Transguard Group LLC,API User,E6AEAE17361
2022-02-13 20:52,72155101,"5,303.8210","5,298.9210",05.00 AED,5.00,4.9000,0.1000,563668394,1575042,Success,United Arab Emirates,DU UAE,Transguard Group LLC,API User,E6AEAE17361
2022-02-13 20:52,72155105,"5,298.9210","5,295.1810",151.00 PKR,4.25,3.7400,0.5100,563668408,1575043,Success,Pakistan,Telenor Pakistan,Transguard Group LLC,API User,TPPKPK94108
2022-02-13 20:52,72155111,"5,295.1810","5,290.2810",05.00 AED,5.00,4.9000,0.1000,563668412,1575044,Success,United Arab Emirates,DU UAE,Transguard Group LLC,API User,E6AEAE17361
2022-02-13 20:52,72155164,"5,290.2810","5,285.3810",05.00 AED,5.00,4.9000,0.1000,563668557,1575049,Success,United Arab Emirates,DU UAE,Transguard Group LLC,API User,E6AEAE17361
2022-02-13 20:54,72155280,"5,285.3810","5,280.4810",05.00 AED,5.00,4.9000,0.1000,563668877,1575054,Success,United Arab Emirates,DU UAE,Transguard Group LLC,API User,E6AEAE17361
2022-02-13 20:55,72155289,"5,280.4810","5,275.5810",05.00 AED,5.00,4.9000,0.1000,563668924,1575055,Success,United Arab Emirates,DU UAE,Transguard Group LLC,API User,E6AEAE17361
2022-02-13 20:57,72155444,"5,275.5810","5,270.6810",05.00 AED,5.00,4.9000,0.1000,563669349,1575062,Success,United Arab Emirates,DU UAE,Transguard Group LLC,API User,E6AEAE17361
2022-02-13 21:00,72155664,"5,270.6810","5,265.7810",05.00 AED,5.00,4.9000,0.1000,563669946,1575070,Success,United Arab Emirates,DU UAE,Transguard Group LLC,API User,E6AEAE17361
2022-02-13 21:00,72155718,"5,265.7810","5,260.8810",05.00 AED,5.00,4.9000,0.1000,563670103,1575075,Success,United Arab Emirates,DU UAE,Transguard Group LLC,API User,E6AEAE17361
2022-02-13 21:01,72155780,"5,260.8810","5,251.0810",10.00 AED,10.00,9.8000,0.2000,563670281,1575083,Success,United Arab Emirates,DU UAE,Transguard Group LLC,API User,E6AEAE22430
2022-02-13 21:02,72155815,"5,251.0810","5,246.1810",05.00 AED,5.00,4.9000,0.1000,563670399,1575087,Success,United Arab Emirates,DU UAE,Transguard Group LLC,API User,E6AEAE17361
2022-02-13 21:02,72155871,"5,246.1810","5,241.2810",05.00 AED,5.00,4.9000,0.1000,563670530,1575093,Success,United Arab Emirates,DU UAE,Transguard Group LLC,API User,E6AEAE17361
2022-02-13 21:03,72155905,"5,241.2810","5,226.5810",15.00 AED,15.00,14.7000,0.3000,563670619,1575100,Success,United Arab Emirates,DU UAE,Transguard Group LLC,API User,E6AEAE8527
2022-02-13 21:03,72155907,"5,226.5810","5,221.6810",05.00 AED,5.00,4.9000,0.1000,563670629,1575101,Success,United Arab Emirates,DU UAE,Transguard Group LLC,API User,E6AEAE17361
2022-02-13 21:04,72155964,"5,221.6810","5,203.2010",675.00 PKR,21.00,18.4800,2.5200,563670795,1575107,Success,Pakistan,Zong Pakistan,Transguard Group LLC,API User,ZNPKPK63585
2022-02-13 21:08,72156237,"5,203.2010","5,193.4010",10.00 AED,10.00,9.8000,0.2000,563671574,1575119,Success,United Arab Emirates,DU UAE,Transguard Group LLC,API User,E6AEAE22430
2022-02-13 21:09,72156258,"5,193.4010","5,188.5010",05.00 AED,5.00,4.9000,0.1000,563671625,1575121,Success,United Arab Emirates,DU UAE,Transguard Group LLC,API User,E6AEAE17361
2022-02-13 21:09,72156299,"5,188.5010","5,183.6010",05.00 AED,5.00,4.9000,0.1000,563671739,1575125,Success,United Arab Emirates,DU UAE,Transguard Group LLC,API User,E6AEAE17361
2022-02-13 21:11,72156379,"5,183.6010","5,178.7010",05.00 AED,5.00,4.9000,0.1000,563671975,1575129,Success,United Arab Emirates,DU UAE,Transguard Group LLC,API User,E6AEAE17361
2022-02-13 21:12,72156502,"5,178.7010","5,168.9010",10.00 AED,10.00,9.8000,0.2000,563672286,1575139,Success,United Arab Emirates,DU UAE,Transguard Group LLC,API User,E6AEAE22430
2022-02-13 21:12,72156535,"5,168.9010","5,164.0010",05.00 AED,5.00,4.9000,0.1000,563672359,1575142,Success,United Arab Emirates,DU UAE,Transguard Group LLC,API User,E6AEAE17361
2022-02-13 21:13,72156560,"5,164.0010","5,159.1010",05.00 AED,5.00,4.9000,0.1000,563672411,1575147,Success,United Arab Emirates,DU UAE,Transguard Group LLC,API User,E6AEAE17361
2022-02-13 21:13,72156574,"5,159.1010","5,149.3010",10.00 AED,10.00,9.8000,0.2000,563672461,1575149,Success,United Arab Emirates,DU UAE,Transguard Group LLC,API User,E6AEAE22430
2022-02-13 21:14,72156627,"5,149.3010","5,134.6010",15.00 AED,15.00,14.7000,0.3000,563672604,1575154,Success,United Arab Emirates,DU UAE,Transguard Group LLC,API User,E6AEAE8527
2022-02-13 21:15,72156736,"5,134.6010","5,129.7010",05.00 AED,5.00,4.9000,0.1000,563672902,1575160,Success,United Arab Emirates,DU UAE,Transguard Group LLC,API User,E6AEAE17361
2022-02-13 21:16,72156751,"5,129.7010","5,124.8010",05.00 AED,5.00,4.9000,0.1000,563672955,1575162,Success,United Arab Emirates,DU UAE,Transguard Group LLC,API User,E6AEAE17361
2022-02-13 21:26,72157361,"5,124.8010","5,119.9010",05.00 AED,5.00,4.9000,0.1000,563674895,1575180,Success,United Arab Emirates,DU UAE,Transguard Group LLC,API User,E6AEAE17361
2022-02-13 21:31,72157692,"5,119.9010","5,115.0010",05.00 AED,5.00,4.9000,0.1000,563675763,1575196,Success,United Arab Emirates,DU UAE,Transguard Group LLC,API User,E6AEAE17361
2022-02-13 21:32,72157771,"5,115.0010","5,110.1010",05.00 AED,5.00,4.9000,0.1000,563676003,1575204,Success,United Arab Emirates,DU UAE,Transguard Group LLC,API User,E6AEAE17361
2022-02-13 21:34,72157873,"5,110.1010","5,105.2010",05.00 AED,5.00,4.9000,0.1000,563676286,1575208,Success,United Arab Emirates,DU UAE,Transguard Group LLC,API User,E6AEAE17361
2022-02-13 21:36,72158007,"5,105.2010","5,100.3010",05.00 AED,5.00,4.9000,0.1000,563676731,1575219,Success,United Arab Emirates,DU UAE,Transguard Group LLC,API User,E6AEAE17361
2022-02-13 21:36,72158024,"5,100.3010","5,095.4010",05.00 AED,5.00,4.9000,0.1000,563676793,1575222,Success,United Arab Emirates,DU UAE,Transguard Group LLC,API User,E6AEAE17361
2022-02-13 21:37,72158055,"5,095.4010","5,090.5010",05.00 AED,5.00,4.9000,0.1000,563676902,1575226,Success,United Arab Emirates,DU UAE,Transguard Group LLC,API User,E6AEAE17361
2022-02-13 21:38,72158158,"5,090.5010","5,085.6010",05.00 AED,5.00,4.9000,0.1000,563677206,1575231,Success,United Arab Emirates,DU UAE,Transguard Group LLC,API User,E6AEAE17361
2022-02-13 21:41,72158346,"5,085.6010","5,075.8010",10.00 AED,10.00,9.8000,0.2000,563677763,1575242,Success,United Arab Emirates,DU UAE,Transguard Group LLC,API User,E6AEAE22430
2022-02-13 21:42,72158386,"5,075.8010","5,066.0010",10.00 AED,10.00,9.8000,0.2000,563677856,1575245,Success,United Arab Emirates,DU UAE,Transguard Group LLC,API User,E6AEAE22430
2022-02-13 21:43,72158459,"5,066.0010","5,016.7510",50.00 AED,50.00,49.2500,0.7500,563678046,1575249,Success,United Arab Emirates,App Store & iTunes Gift Card UAE,Transguard Group LLC,API User,IASASA96606
2022-02-13 21:47,72158732,"5,016.7510","5,011.8510",05.00 AED,5.00,4.9000,0.1000,563678903,1575261,Success,United Arab Emirates,DU UAE,Transguard Group LLC,API User,E6AEAE17361
2022-02-13 21:50,72158890,"5,011.8510","5,006.9510",05.00 AED,5.00,4.9000,0.1000,563679317,1575267,Success,United Arab Emirates,DU UAE,Transguard Group LLC,API User,E6AEAE17361
2022-02-13 21:53,72159074,"5,006.9510","4,997.1510",10.00 AED,10.00,9.8000,0.2000,563679881,1575274,Success,United Arab Emirates,DU UAE,Transguard Group LLC,API User,E6AEAE22430
2022-02-13 21:55,72159198,"4,997.1510","4,993.1910",500.00 XAF,4.50,3.9600,0.5400,563680222,1575277,Success,Cameroon,MTN Cameroon,Transguard Group LLC,API User,CM_MT_TopUp_500.00
2022-02-13 22:01,72159601,"4,993.1910","4,983.3910",10.00 AED,10.00,9.8000,0.2000,563681352,1575288,Success,United Arab Emirates,DU UAE,Transguard Group LLC,API User,E6AEAE22430
2022-02-13 22:06,72159883,"4,983.3910","4,973.5910",10.00 AED,10.00,9.8000,0.2000,563682179,1575303,Success,United Arab Emirates,DU UAE,Transguard Group LLC,API User,E6AEAE22430
2022-02-13 22:07,72159963,"4,973.5910","4,968.6910",05.00 AED,5.00,4.9000,0.1000,563682430,1575310,Success,United Arab Emirates,DU UAE,Transguard Group LLC,API User,E6AEAE17361
2022-02-13 22:11,72160173,"4,968.6910","4,963.7910",05.00 AED,5.00,4.9000,0.1000,563683060,1575315,Success,United Arab Emirates,DU UAE,Transguard Group LLC,API User,E6AEAE17361
2022-02-13 22:15,72160375,"4,963.7910","4,958.8910",05.00 AED,5.00,4.9000,0.1000,563683611,1575326,Success,United Arab Emirates,DU UAE,Transguard Group LLC,API User,E6AEAE17361
2022-02-13 22:15,72160382,"4,958.8910","4,949.0910",10.00 AED,10.00,9.8000,0.2000,563683626,1575327,Success,United Arab Emirates,DU UAE,Transguard Group LLC,API User,E6AEAE22430
2022-02-13 22:16,72160480,"4,949.0910","4,944.1910",05.00 AED,5.00,4.9000,0.1000,563683914,1575333,Success,United Arab Emirates,DU UAE,Transguard Group LLC,API User,E6AEAE17361
2022-02-13 22:19,72160654,"4,944.1910","4,940.4510",100.00 NPR,4.25,3.7400,0.5100,563684391,1575343,Success,Nepal,Nepal Telecom Nepal,Transguard Group LLC,API User,NP_NE_TopUp_100.00
2022-02-13 22:20,72160701,"4,940.4510","4,935.5510",05.00 AED,5.00,4.9000,0.1000,563684539,1575348,Success,United Arab Emirates,DU UAE,Transguard Group LLC,API User,E6AEAE17361
2022-02-13 22:21,72160769,"4,935.5510","4,925.7510",10.00 AED,10.00,9.8000,0.2000,563684748,1575351,Success,United Arab Emirates,DU UAE,Transguard Group LLC,API User,E6AEAE22430
2022-02-13 22:26,72161060,"4,925.7510","4,920.8510",05.00 AED,5.00,4.9000,0.1000,563685557,1575354,Success,United Arab Emirates,DU UAE,Transguard Group LLC,API User,E6AEAE17361
2022-02-13 22:28,72161192,"4,920.8510","4,911.0510",10.00 AED,10.00,9.8000,0.2000,563685886,1575361,Success,United Arab Emirates,DU UAE,Transguard Group LLC,API User,E6AEAE22430
2022-02-13 22:31,72161412,"4,911.0510","4,893.8910",65.00 EGP,19.50,17.1600,2.3400,563686466,1575371,Success,Egypt,Etisalat Egypt,Transguard Group LLC,API User,EG_ET_TopUp_65.00
2022-02-13 22:32,72161438,"4,893.8910","4,884.0910",10.00 AED,10.00,9.8000,0.2000,563686513,1575375,Success,United Arab Emirates,DU UAE,Transguard Group LLC,API User,E6AEAE22430
2022-02-13 22:37,72161685,"4,884.0910","4,874.2910",10.00 AED,10.00,9.8000,0.2000,563687348,1575384,Success,United Arab Emirates,DU UAE,Transguard Group LLC,API User,E6AEAE22430
2022-02-13 22:43,72161972,"4,874.2910","4,869.3910",05.00 AED,5.00,4.9000,0.1000,563688283,1575389,Success,United Arab Emirates,DU UAE,Transguard Group LLC,API User,E6AEAE17361
2022-02-13 22:49,72162250,"4,869.3910","4,864.4910",05.00 AED,5.00,4.9000,0.1000,563689122,1575400,Success,United Arab Emirates,DU UAE,Transguard Group LLC,API User,E6AEAE17361
2022-02-13 22:54,72162506,"4,864.4910","4,856.5710",220.00 NPR,9.00,7.9200,1.0800,563689939,1575410,Success,Nepal,Ncell Nepal,Transguard Group LLC,API User,NCNPNP79518
2022-02-13 22:57,72162613,"4,856.5710","4,851.6710",05.00 AED,5.00,4.9000,0.1000,563690328,1575414,Success,United Arab Emirates,DU UAE,Transguard Group LLC,API User,E6AEAE17361
2022-02-13 22:57,72162636,"4,851.6710","4,846.7710",05.00 AED,5.00,4.9000,0.1000,563690401,1575417,Success,United Arab Emirates,DU UAE,Transguard Group LLC,API User,E6AEAE17361
2022-02-13 23:04,72162951,"4,846.7710","4,836.9710",10.00 AED,10.00,9.8000,0.2000,563691358,1575424,Success,United Arab Emirates,DU UAE,Transguard Group LLC,API User,E6AEAE22430
2022-02-13 23:04,72162956,"4,836.9710","4,817.3710",20.00 AED,20.00,19.6000,0.4000,563691374,1575425,Success,United Arab Emirates,DU UAE,Transguard Group LLC,API User,E6AEAE12938
2022-02-13 23:14,72163434,"4,817.3710","4,812.4710",05.00 AED,5.00,4.9000,0.1000,563692916,1575441,Success,United Arab Emirates,DU UAE,Transguard Group LLC,API User,E6AEAE17361
2022-02-13 23:15,72163451,"4,812.4710","4,802.6710",10.00 AED,10.00,9.8000,0.2000,563692946,1575445,Success,United Arab Emirates,DU UAE,Transguard Group LLC,API User,E6AEAE22430
2022-02-13 23:16,72163496,"4,802.6710","4,780.8910",800.00 PKR,24.75,21.7800,2.9700,563693144,1575450,Success,Pakistan,Zong Pakistan,Transguard Group LLC,API User,ZNPKPK8195
2022-02-13 23:21,72163733,"4,780.8910","4,771.0910",10.00 AED,10.00,9.8000,0.2000,563693872,1575456,Success,United Arab Emirates,DU UAE,Transguard Group LLC,API User,E6AEAE22430
2022-02-13 23:22,72163755,"4,771.0910","4,761.2910",10.00 AED,10.00,9.8000,0.2000,563693944,1575460,Success,United Arab Emirates,DU UAE,Transguard Group LLC,API User,E6AEAE22430
2022-02-13 23:23,72163798,"4,761.2910","4,746.5910",15.00 AED,15.00,14.7000,0.3000,563694107,1575466,Success,United Arab Emirates,DU UAE,Transguard Group LLC,API User,E6AEAE8527
2022-02-13 23:36,72164311,"4,746.5910","4,742.4110",150.00 PKR,4.75,4.1800,0.5700,563696054,1575477,Success,Pakistan,Jazz Pakistan,Transguard Group LLC,API User,MBPKPK20699
2022-02-13 23:46,72164678,"4,742.4110","4,732.6110",10.00 AED,10.00,9.8000,0.2000,563697322,1575490,Success,United Arab Emirates,DU UAE,Transguard Group LLC,API User,E6AEAE22430
2022-02-13 23:48,72164731,"4,732.6110","4,722.8110",10.00 AED,10.00,9.8000,0.2000,563697554,1575493,Success,United Arab Emirates,DU UAE,Transguard Group LLC,API User,E6AEAE22430
2022-02-13 23:48,72164741,"4,722.8110","4,717.9110",05.00 AED,5.00,4.9000,0.1000,563697596,1575496,Success,United Arab Emirates,DU UAE,Transguard Group LLC,API User,E6AEAE17361
2022-02-14 00:00,72165155,"4,717.9110","4,708.1110",10.00 AED,10.00,9.8000,0.2000,563699059,1575505,Success,United Arab Emirates,DU UAE,Transguard Group LLC,API User,E6AEAE22430
2022-02-14 00:04,72165316,"4,708.1110","4,703.2110",05.00 AED,5.00,4.9000,0.1000,563699572,1575512,Success,United Arab Emirates,DU UAE,Transguard Group LLC,API User,E6AEAE17361
2022-02-14 00:06,72165393,"4,703.2110","4,698.3110",05.00 AED,5.00,4.9000,0.1000,563699803,1575517,Success,United Arab Emirates,DU UAE,Transguard Group LLC,API User,E6AEAE17361
2022-02-14 00:18,72165732,"4,698.3110","4,688.5110",10.00 AED,10.00,9.8000,0.2000,563701210,1575527,Success,United Arab Emirates,DU UAE,Transguard Group LLC,API User,E6AEAE22430
2022-02-14 00:49,72166550,"4,688.5110","4,670.2510",499.00 NPR,20.75,18.2600,2.4900,563704627,1575538,Success,Nepal,Ncell Nepal,Transguard Group LLC,API User,NCNPNP61382
2022-02-14 00:49,72166579,"4,670.2510","4,665.3510",05.00 AED,5.00,4.9000,0.1000,563704716,1575541,Success,United Arab Emirates,DU UAE,Transguard Group LLC,API User,E6AEAE17361
2022-02-14 00:51,72166611,"4,665.3510","4,655.5510",10.00 AED,10.00,9.8000,0.2000,563704870,1575544,Success,United Arab Emirates,DU UAE,Transguard Group LLC,API User,E6AEAE22430
2022-02-14 00:57,72166777,"4,655.5510","4,645.7510",10.00 AED,10.00,9.8000,0.2000,563705613,1575551,Success,United Arab Emirates,DU UAE,Transguard Group LLC,API User,E6AEAE22430
2022-02-14 01:14,72167139,"4,645.7510","4,640.8510",05.00 AED,5.00,4.9000,0.1000,563707305,1575554,Success,United Arab Emirates,DU UAE,Transguard Group LLC,API User,E6AEAE17361
2022-02-14 01:17,72167249,"4,640.8510","4,591.6010",50.00 AED,50.00,49.2500,0.7500,563707699,1575556,Success,United Arab Emirates,App Store & iTunes Gift Card UAE,Transguard Group LLC,API User,IASASA96606
2022-02-14 02:44,72169061,"4,591.6010","4,586.7010",05.00 AED,5.00,4.9000,0.1000,563716265,1575580,Success,United Arab Emirates,DU UAE,Transguard Group LLC,API User,E6AEAE17361
2022-02-14 02:46,72169099,"4,586.7010","4,581.8010",05.00 AED,5.00,4.9000,0.1000,563716455,1575589,Failure,United Arab Emirates,DU UAE,Transguard Group LLC,API User,E6AEAE17361
2022-02-14 02:46,72169099,"4,581.8010","4,576.9010",05.00 AED,5.00,4.9000,0.1000,563716455,1575589,Failure,United Arab Emirates,DU UAE,Transguard Group LLC,API User,E6AEAE17361
2022-02-14 03:06,72169490,"4,586.7010","4,576.9010",10.00 AED,10.00,9.8000,0.2000,563718413,1575603,Success,United Arab Emirates,DU UAE,Transguard Group LLC,API User,E6AEAE22430
2022-02-14 03:20,72169770,"4,576.9010","4,572.0010",05.00 AED,5.00,4.9000,0.1000,563719686,1575612,Success,United Arab Emirates,DU UAE,Transguard Group LLC,API User,E6AEAE17361
2022-02-14 03:21,72169785,"4,572.0010","4,562.2010",10.00 AED,10.00,9.8000,0.2000,563719793,1575615,Success,United Arab Emirates,DU UAE,Transguard Group LLC,API User,E6AEAE22430
2022-02-14 03:36,72170066,"4,562.2010","4,552.4010",10.00 AED,10.00,9.8000,0.2000,563721172,1575624,Failure,United Arab Emirates,DU UAE,Transguard Group LLC,API User,E6AEAE22430
2022-02-14 03:36,72170066,"4,552.4010","4,542.6010",10.00 AED,10.00,9.8000,0.2000,563721172,1575624,Failure,United Arab Emirates,DU UAE,Transguard Group LLC,API User,E6AEAE22430
2022-02-14 03:53,72170355,"4,562.2010","4,552.4010",10.00 AED,10.00,9.8000,0.2000,563722636,1575627,Success,United Arab Emirates,DU UAE,Transguard Group LLC,API User,E6AEAE22430
2022-02-14 04:23,72171022,"4,552.4010","4,542.6010",10.00 AED,10.00,9.8000,0.2000,563725231,1575638,Success,United Arab Emirates,DU UAE,Transguard Group LLC,API User,E6AEAE22430
2022-02-14 04:26,72171084,"4,542.6010","4,537.7010",05.00 AED,5.00,4.9000,0.1000,563725466,1575644,Success,United Arab Emirates,DU UAE,Transguard Group LLC,API User,E6AEAE17361
2022-02-14 04:29,72171148,"4,537.7010","4,527.9010",10.00 AED,10.00,9.8000,0.2000,563725732,1575657,Success,United Arab Emirates,DU UAE,Transguard Group LLC,API User,E6AEAE22430
2022-02-14 04:31,72171202,"4,527.9010","4,518.1010",10.00 AED,10.00,9.8000,0.2000,563725972,1575660,Success,United Arab Emirates,DU UAE,Transguard Group LLC,API User,E6AEAE22430
2022-02-14 04:39,72171366,"4,518.1010","4,513.2010",05.00 AED,5.00,4.9000,0.1000,563726678,1575663,Success,United Arab Emirates,DU UAE,Transguard Group LLC,API User,E6AEAE17361
2022-02-14 04:48,72171528,"4,513.2010","4,503.4010",10.00 AED,10.00,9.8000,0.2000,563727357,1575670,Success,United Arab Emirates,DU UAE,Transguard Group LLC,API User,E6AEAE22430
2022-02-14 04:55,72171688,"4,503.4010","4,498.5010",05.00 AED,5.00,4.9000,0.1000,563727935,1575673,Success,United Arab Emirates,DU UAE,Transguard Group LLC,API User,E6AEAE17361
2022-02-14 05:00,72171815,"4,498.5010","4,493.6010",05.00 AED,5.00,4.9000,0.1000,563728319,1575676,Success,United Arab Emirates,DU UAE,Transguard Group LLC,API User,E6AEAE17361
2022-02-14 05:16,72172254,"4,493.6010","4,483.8010",10.00 AED,10.00,9.8000,0.2000,563729604,1575685,Success,United Arab Emirates,DU UAE,Transguard Group LLC,API User,E6AEAE22430
2022-02-14 05:16,72172257,"4,483.8010","4,478.9010",05.00 AED,5.00,4.9000,0.1000,563729623,1575687,Success,United Arab Emirates,DU UAE,Transguard Group LLC,API User,E6AEAE17361
2022-02-14 05:19,72172317,"4,478.9010","4,469.1010",10.00 AED,10.00,9.8000,0.2000,563729850,1575691,Success,United Arab Emirates,DU UAE,Transguard Group LLC,API User,E6AEAE22430
2022-02-14 05:27,72172530,"4,469.1010","4,464.2010",05.00 AED,5.00,4.9000,0.1000,563730525,1575696,Success,United Arab Emirates,DU UAE,Transguard Group LLC,API User,E6AEAE17361
2022-02-14 05:56,72173283,"4,464.2010","4,459.3010",05.00 AED,5.00,4.9000,0.1000,563732863,1575728,Success,United Arab Emirates,DU UAE,Transguard Group LLC,API User,E6AEAE17361
2022-02-14 05:56,72173291,"4,459.3010","4,444.6010",15.00 AED,15.00,14.7000,0.3000,563732874,1575729,Success,United Arab Emirates,DU UAE,Transguard Group LLC,API User,E6AEAE8527
2022-02-14 06:02,72173422,"4,444.6010","4,439.7010",05.00 AED,5.00,4.9000,0.1000,563733318,1575735,Success,United Arab Emirates,DU UAE,Transguard Group LLC,API User,E6AEAE17361
2022-02-14 06:08,72173586,"4,434.8010","4,425.0010",10.00 AED,10.00,9.8000,0.2000,563733811,1575745,Success,United Arab Emirates,DU UAE,Transguard Group LLC,API User,E6AEAE22430
2022-02-14 06:08,72173585,"4,439.7010","4,434.8010",05.00 AED,5.00,4.9000,0.1000,563733809,1575744,Success,United Arab Emirates,DU UAE,Transguard Group LLC,API User,E6AEAE17361
2022-02-14 06:14,72173790,"4,425.0010","4,415.2010",10.00 AED,10.00,9.8000,0.2000,563734312,1575754,Success,United Arab Emirates,DU UAE,Transguard Group LLC,API User,E6AEAE22430
2022-02-14 06:21,72173993,"4,415.2010","4,410.3010",05.00 AED,5.00,4.9000,0.1000,563734878,1575759,Success,United Arab Emirates,DU UAE,Transguard Group LLC,API User,E6AEAE17361
2022-02-14 06:25,72174091,"4,410.3010","4,405.4010",05.00 AED,5.00,4.9000,0.1000,563735131,1575765,Success,United Arab Emirates,DU UAE,Transguard Group LLC,API User,E6AEAE17361
2022-02-14 06:25,72174109,"4,405.4010","4,400.5010",05.00 AED,5.00,4.9000,0.1000,563735177,1575769,Success,United Arab Emirates,DU UAE,Transguard Group LLC,API User,E6AEAE17361
2022-02-14 06:34,72174364,"4,400.5010","4,395.6010",05.00 AED,5.00,4.9000,0.1000,563735905,1575781,Success,United Arab Emirates,DU UAE,Transguard Group LLC,API User,E6AEAE17361
2022-02-14 06:35,72174401,"4,395.6010","4,385.8010",10.00 AED,10.00,9.8000,0.2000,563736001,1575786,Success,United Arab Emirates,DU UAE,Transguard Group LLC,API User,E6AEAE22430
2022-02-14 06:47,72174708,"4,385.8010","4,376.0010",10.00 AED,10.00,9.8000,0.2000,563736895,1575810,Success,United Arab Emirates,DU UAE,Transguard Group LLC,API User,E6AEAE22430
2022-02-14 06:47,72174714,"4,376.0010","4,371.1010",05.00 AED,5.00,4.9000,0.1000,563736909,1575811,Success,United Arab Emirates,DU UAE,Transguard Group LLC,API User,E6AEAE17361
2022-02-14 06:48,72174751,"4,371.1010","4,361.3010",10.00 AED,10.00,9.8000,0.2000,563736987,1575814,Success,United Arab Emirates,DU UAE,Transguard Group LLC,API User,E6AEAE22430
2022-02-14 06:49,72174775,"4,361.3010","4,356.4010",05.00 AED,5.00,4.9000,0.1000,563737060,1575818,Success,United Arab Emirates,DU UAE,Transguard Group LLC,API User,E6AEAE17361
2022-02-14 06:51,72174818,"4,356.4010","4,351.5010",05.00 AED,5.00,4.9000,0.1000,563737190,1575822,Success,United Arab Emirates,DU UAE,Transguard Group LLC,API User,E6AEAE17361
2022-02-14 06:52,72174835,"4,351.5010","4,346.6010",05.00 AED,5.00,4.9000,0.1000,563737226,1575825,Success,United Arab Emirates,DU UAE,Transguard Group LLC,API User,E6AEAE17361
2022-02-14 06:58,72175050,"4,346.6010","4,341.7010",05.00 AED,5.00,4.9000,0.1000,563737689,1575836,Success,United Arab Emirates,DU UAE,Transguard Group LLC,API User,E6AEAE17361
2022-02-14 06:59,72175077,"4,341.7010","4,336.8010",05.00 AED,5.00,4.9000,0.1000,563737763,1575841,Success,United Arab Emirates,DU UAE,Transguard Group LLC,API User,E6AEAE17361
2022-02-14 07:05,72175312,"4,336.8010","4,331.9010",05.00 AED,5.00,4.9000,0.1000,563738280,1575848,Success,United Arab Emirates,DU UAE,Transguard Group LLC,API User,E6AEAE17361
2022-02-14 07:08,72175413,"4,331.9010","4,322.1010",10.00 AED,10.00,9.8000,0.2000,563738530,1575853,Success,United Arab Emirates,DU UAE,Transguard Group LLC,API User,E6AEAE22430
2022-02-14 07:12,72175522,"4,322.1010","4,317.2010",05.00 AED,5.00,4.9000,0.1000,563738807,1575866,Success,United Arab Emirates,DU UAE,Transguard Group LLC,API User,E6AEAE17361
2022-02-14 07:14,72175610,"4,317.2010","4,312.3010",05.00 AED,5.00,4.9000,0.1000,563739007,1575873,Success,United Arab Emirates,DU UAE,Transguard Group LLC,API User,E6AEAE17361
2022-02-14 07:15,72175615,"4,312.3010","4,307.4010",05.00 AED,5.00,4.9000,0.1000,563739027,1575877,Success,United Arab Emirates,DU UAE,Transguard Group LLC,API User,E6AEAE17361
2022-02-14 07:18,72175711,"4,307.4010","4,282.9010",25.00 AED,25.00,24.5000,0.5000,563739247,1575883,Success,United Arab Emirates,DU UAE,Transguard Group LLC,API User,E6AEAE17343
2022-02-14 07:20,72175784,"4,282.9010","4,273.1010",10.00 AED,10.00,9.8000,0.2000,563739429,1575891,Success,United Arab Emirates,DU UAE,Transguard Group LLC,API User,E6AEAE22430
2022-02-14 07:36,72176332,"4,273.1010","4,263.3010",10.00 AED,10.00,9.8000,0.2000,563740797,1575919,Success,United Arab Emirates,DU UAE,Transguard Group LLC,API User,E6AEAE22430
2022-02-14 07:40,72176450,"4,263.3010","4,258.4010",05.00 AED,5.00,4.9000,0.1000,563741108,1575931,Success,United Arab Emirates,DU UAE,Transguard Group LLC,API User,E6AEAE17361
2022-02-14 07:43,72176519,"4,258.4010","4,253.5010",05.00 AED,5.00,4.9000,0.1000,563741313,1575934,Success,United Arab Emirates,DU UAE,Transguard Group LLC,API User,E6AEAE17361
2022-02-14 07:45,72176560,"4,253.5010","4,243.7010",10.00 AED,10.00,9.8000,0.2000,563741423,1575941,Success,United Arab Emirates,DU UAE,Transguard Group LLC,API User,E6AEAE22430
2022-02-14 07:54,72176836,"4,243.7010","4,238.8010",05.00 AED,5.00,4.9000,0.1000,563742192,1575957,Success,United Arab Emirates,DU UAE,Transguard Group LLC,API User,E6AEAE17361
2022-02-14 07:55,72176880,"4,238.8010","4,229.0010",10.00 AED,10.00,9.8000,0.2000,563742318,1575962,Success,United Arab Emirates,DU UAE,Transguard Group LLC,API User,E6AEAE22430
2022-02-14 07:58,72176974,"4,229.0010","4,224.1010",05.00 AED,5.00,4.9000,0.1000,563742572,1575971,Success,United Arab Emirates,DU UAE,Transguard Group LLC,API User,E6AEAE17361
2022-02-14 08:03,72177140,"4,224.1010","4,219.2010",05.00 AED,5.00,4.9000,0.1000,563742981,1575977,Success,United Arab Emirates,DU UAE,Transguard Group LLC,API User,E6AEAE17361
2022-02-14 08:04,72177174,"4,219.2010","4,184.9010",35.00 AED,35.00,34.3000,0.7000,563743047,1575983,Success,United Arab Emirates,DU UAE,Transguard Group LLC,API User,E6AEAE73954
2022-02-14 08:05,72177196,"4,184.9010","4,175.1010",10.00 AED,10.00,9.8000,0.2000,563743112,1575991,Success,United Arab Emirates,DU UAE,Transguard Group LLC,API User,E6AEAE22430
2022-02-14 08:05,72177203,"4,175.1010","4,170.2010",05.00 AED,5.00,4.9000,0.1000,563743124,1575992,Success,United Arab Emirates,DU UAE,Transguard Group LLC,API User,E6AEAE17361
2022-02-14 08:06,72177225,"4,170.2010","4,160.4010",10.00 AED,10.00,9.8000,0.2000,563743176,1575995,Success,United Arab Emirates,DU UAE,Transguard Group LLC,API User,E6AEAE22430
2022-02-14 08:06,72177239,"4,160.4010","4,150.6010",10.00 AED,10.00,9.8000,0.2000,563743211,1575998,Success,United Arab Emirates,DU UAE,Transguard Group LLC,API User,E6AEAE22430
2022-02-14 08:08,72177297,"4,150.6010","4,145.7010",05.00 AED,5.00,4.9000,0.1000,563743401,1576004,Success,United Arab Emirates,DU UAE,Transguard Group LLC,API User,E6AEAE17361
2022-02-14 08:09,72177314,"4,145.7010","4,140.8010",05.00 AED,5.00,4.9000,0.1000,563743447,1576009,Success,United Arab Emirates,DU UAE,Transguard Group LLC,API User,E6AEAE17361
2022-02-14 08:09,72177321,"4,140.8010","4,132.6610",300.00 PKR,9.25,8.1400,1.1100,563743469,1576010,Success,Pakistan,Zong Pakistan,Transguard Group LLC,API User,ZNPKPK70504
2022-02-14 08:12,72177405,"4,132.6610","4,113.0610",20.00 AED,20.00,19.6000,0.4000,563743678,1576016,Success,United Arab Emirates,DU UAE,Transguard Group LLC,API User,E6AEAE12938
2022-02-14 08:18,72177610,"4,113.0610","4,108.1610",05.00 AED,5.00,4.9000,0.1000,563744189,1576028,Success,United Arab Emirates,DU UAE,Transguard Group LLC,API User,E6AEAE17361
2022-02-14 08:21,72177708,"4,108.1610","4,088.5610",20.00 AED,20.00,19.6000,0.4000,563744453,1576039,Success,United Arab Emirates,DU UAE,Transguard Group LLC,API User,E6AEAE12938
2022-02-14 08:22,72177739,"4,088.5610","4,078.0010",179.00 INR,12.00,10.5600,1.4400,563744535,1576041,Success,India,Airtel India,Transguard Group LLC,API User,AIININ72188
2022-02-14 08:23,72177752,"4,078.0010","4,068.2010",10.00 AED,10.00,9.8000,0.2000,563744580,1576047,Success,United Arab Emirates,DU UAE,Transguard Group LLC,API User,E6AEAE22430
2022-02-14 08:23,72177761,"4,068.2010","4,058.4010",10.00 AED,10.00,9.8000,0.2000,563744598,1576048,Success,United Arab Emirates,DU UAE,Transguard Group LLC,API User,E6AEAE22430
2022-02-14 08:24,72177789,"4,058.4010","4,038.8010",20.00 AED,20.00,19.6000,0.4000,563744683,1576051,Success,United Arab Emirates,DU UAE,Transguard Group LLC,API User,E6AEAE12938
2022-02-14 08:28,72177894,"4,038.8010","4,033.9010",05.00 AED,5.00,4.9000,0.1000,563745004,1576056,Success,United Arab Emirates,DU UAE,Transguard Group LLC,API User,E6AEAE17361
2022-02-14 08:30,72177970,"4,033.9010","4,029.0010",05.00 AED,5.00,4.9000,0.1000,563745184,1576061,Success,United Arab Emirates,DU UAE,Transguard Group LLC,API User,E6AEAE17361
2022-02-14 08:30,72177987,"4,029.0010","4,024.1010",05.00 AED,5.00,4.9000,0.1000,563745218,1576063,Success,United Arab Emirates,DU UAE,Transguard Group LLC,API User,E6AEAE17361
2022-02-14 08:44,72178522,"4,024.1010","4,004.5010",20.00 AED,20.00,19.6000,0.4000,563746503,1576082,Success,United Arab Emirates,DU UAE,Transguard Group LLC,API User,E6AEAE12938
2022-02-14 08:45,72178535,"4,004.5010","3,994.7010",10.00 AED,10.00,9.8000,0.2000,563746532,1576087,Success,United Arab Emirates,DU UAE,Transguard Group LLC,API User,E6AEAE22430
2022-02-14 08:45,72178538,"3,994.7010","3,989.8010",05.00 AED,5.00,4.9000,0.1000,563746536,1576088,Success,United Arab Emirates,DU UAE,Transguard Group LLC,API User,E6AEAE17361
2022-02-14 08:47,72178634,"3,989.8010","3,980.0010",10.00 AED,10.00,9.8000,0.2000,563746738,1576092,Success,United Arab Emirates,DU UAE,Transguard Group LLC,API User,E6AEAE22430
2022-02-14 08:49,72178680,"3,980.0010","3,970.2010",10.00 AED,10.00,9.8000,0.2000,563746865,1576097,Success,United Arab Emirates,DU UAE,Transguard Group LLC,API User,E6AEAE22430
2022-02-14 08:49,72178689,"3,970.2010","3,965.3010",05.00 AED,5.00,4.9000,0.1000,563746886,1576099,Success,United Arab Emirates,DU UAE,Transguard Group LLC,API User,E6AEAE17361
2022-02-14 08:50,72178722,"3,965.3010","3,960.4010",05.00 AED,5.00,4.9000,0.1000,563746966,1576102,Success,United Arab Emirates,DU UAE,Transguard Group LLC,API User,E6AEAE17361
2022-02-14 08:51,72178757,"3,960.4010","3,955.5010",05.00 AED,5.00,4.9000,0.1000,563747050,1576106,Success,United Arab Emirates,DU UAE,Transguard Group LLC,API User,E6AEAE17361
2022-02-14 08:51,72178774,"3,955.5010","3,950.6010",05.00 AED,5.00,4.9000,0.1000,563747087,1576108,Success,United Arab Emirates,DU UAE,Transguard Group LLC,API User,E6AEAE17361
2022-02-14 08:52,72178812,"3,950.6010","3,942.6810",220.00 NPR,9.00,7.9200,1.0800,563747182,1576111,Success,Nepal,Ncell Nepal,Transguard Group LLC,API User,NCNPNP79518
2022-02-14 08:56,72178948,"3,942.6810","3,913.2810",30.00 AED,30.00,29.4000,0.6000,563747487,1576115,Success,United Arab Emirates,DU UAE,Transguard Group LLC,API User,E6AEAE46146
2022-02-14 08:58,72179020,"3,913.2810","3,908.3810",05.00 AED,5.00,4.9000,0.1000,563747650,1576123,Success,United Arab Emirates,DU UAE,Transguard Group LLC,API User,E6AEAE17361
2022-02-14 09:01,72179106,"3,908.3810","3,903.4810",05.00 AED,5.00,4.9000,0.1000,563747876,1576137,Success,United Arab Emirates,DU UAE,Transguard Group LLC,API User,E6AEAE17361
2022-02-14 09:01,72179149,"3,903.4810","3,898.5810",05.00 AED,5.00,4.9000,0.1000,563747957,1576142,Success,United Arab Emirates,DU UAE,Transguard Group LLC,API User,E6AEAE17361
2022-02-14 09:08,72180411,"3,898.5810","3,893.6810",05.00 AED,5.00,4.9000,0.1000,563749654,1576152,Success,United Arab Emirates,DU UAE,Transguard Group LLC,API User,E6AEAE17361
2022-02-14 09:09,72180763,"3,893.6810","3,874.0810",20.00 AED,20.00,19.6000,0.4000,563750560,1576160,Success,United Arab Emirates,DU UAE,Transguard Group LLC,API User,E6AEAE12938
2022-02-14 09:12,72182752,"3,874.0810","3,830.0810",69.61 GHS,50.00,44.0000,6.0000,563752838,1576168,Success,Ghana,Vodafone Ghana,Transguard Group LLC,API User,GH_VF_TopUp
2022-02-14 09:13,72183816,"3,830.0810","3,825.1810",05.00 AED,5.00,4.9000,0.1000,563753963,1576172,Success,United Arab Emirates,DU UAE,Transguard Group LLC,API User,E6AEAE17361
2022-02-14 09:14,72184230,"3,825.1810","3,815.3810",10.00 AED,10.00,9.8000,0.2000,563754911,1576177,Success,United Arab Emirates,DU UAE,Transguard Group LLC,API User,E6AEAE22430
2022-02-14 09:17,72186533,"3,815.3810","3,805.5810",10.00 AED,10.00,9.8000,0.2000,563757378,1576186,Success,United Arab Emirates,DU UAE,Transguard Group LLC,API User,E6AEAE22430
2022-02-14 09:22,72189049,"3,805.5810","3,800.6810",05.00 AED,5.00,4.9000,0.1000,563760521,1576200,Success,United Arab Emirates,DU UAE,Transguard Group LLC,API User,E6AEAE17361
2022-02-14 09:35,72194531,"3,800.6810","3,795.7810",05.00 AED,5.00,4.9000,0.1000,563768555,1576232,Success,United Arab Emirates,DU UAE,Transguard Group LLC,API User,E6AEAE17361
2022-02-14 09:42,72196394,"3,795.7810","3,790.8810",05.00 AED,5.00,4.9000,0.1000,563771909,1576248,Success,United Arab Emirates,DU UAE,Transguard Group LLC,API User,E6AEAE17361
2022-02-14 09:44,72196650,"3,790.8810","3,785.9810",05.00 AED,5.00,4.9000,0.1000,563772253,1576251,Success,United Arab Emirates,DU UAE,Transguard Group LLC,API User,E6AEAE17361
2022-02-14 09:45,72196831,"3,785.9810","3,776.1810",10.00 AED,10.00,9.8000,0.2000,563772574,1576259,Success,United Arab Emirates,DU UAE,Transguard Group LLC,API User,E6AEAE22430
2022-02-14 09:45,72196867,"3,776.1810","3,756.5810",20.00 AED,20.00,19.6000,0.4000,563772615,1576260,Success,United Arab Emirates,DU UAE,Transguard Group LLC,API User,E6AEAE12938
2022-02-14 09:48,72197644,"3,756.5810","3,751.6810",05.00 AED,5.00,4.9000,0.1000,563774155,1576274,Success,United Arab Emirates,DU UAE,Transguard Group LLC,API User,E6AEAE17361
2022-02-14 09:49,72197830,"3,751.6810","3,741.8810",10.00 AED,10.00,9.8000,0.2000,563774666,1576281,Success,United Arab Emirates,DU UAE,Transguard Group LLC,API User,E6AEAE22430
2022-02-14 09:49,72197837,"3,741.8810","3,736.9810",05.00 AED,5.00,4.9000,0.1000,563774696,1576282,Success,United Arab Emirates,DU UAE,Transguard Group LLC,API User,E6AEAE17361
2022-02-14 09:49,72197846,"3,736.9810","3,697.7810",40.00 AED,40.00,39.2000,0.8000,563774755,1576283,Success,United Arab Emirates,DU UAE,Transguard Group LLC,API User,E6AEAE64011
2022-02-14 09:49,72197882,"3,697.7810","3,663.4810",35.00 AED,35.00,34.3000,0.7000,563775000,1576285,Success,United Arab Emirates,DU UAE,Transguard Group LLC,API User,E6AEAE73954
2022-02-14 09:50,72198081,"3,663.4810","3,658.5810",05.00 AED,5.00,4.9000,0.1000,563775326,1576288,Success,United Arab Emirates,DU UAE,Transguard Group LLC,API User,E6AEAE17361
2022-02-14 09:57,72199520,"3,658.5810","3,637.6810",359.00 INR,23.75,20.9000,2.8500,563778193,1576308,Success,India,Airtel India,Transguard Group LLC,API User,AIININ62072
2022-02-14 09:58,72199772,"3,637.6810","3,632.7810",05.00 AED,5.00,4.9000,0.1000,563778763,1576319,Success,United Arab Emirates,DU UAE,Transguard Group LLC,API User,E6AEAE17361
2022-02-14 09:59,72199958,"3,632.7810","3,628.6010",150.00 PKR,4.75,4.1800,0.5700,563779253,1576322,Success,Pakistan,Ufone Pakistan,Transguard Group LLC,API User,UFPKPK90336
2022-02-14 09:59,72199994,"3,628.6010","3,609.0010",20.00 AED,20.00,19.6000,0.4000,563779452,1576327,Success,United Arab Emirates,DU UAE,Transguard Group LLC,API User,E6AEAE12938
2022-02-14 10:00,72200083,"3,609.0010","3,604.8210",150.00 PKR,4.75,4.1800,0.5700,563779700,1576332,Success,Pakistan,Ufone Pakistan,Transguard Group LLC,API User,UFPKPK90336
2022-02-14 10:01,72200223,"3,604.8210","3,599.9210",05.00 AED,5.00,4.9000,0.1000,563779842,1576335,Success,United Arab Emirates,DU UAE,Transguard Group LLC,API User,E6AEAE17361
2022-02-14 10:03,72200708,"3,599.9210","3,595.0210",05.00 AED,5.00,4.9000,0.1000,563780681,1576348,Success,United Arab Emirates,DU UAE,Transguard Group LLC,API User,E6AEAE17361
2022-02-14 10:04,72200789,"3,595.0210","3,590.1210",05.00 AED,5.00,4.9000,0.1000,563780756,1576350,Success,United Arab Emirates,DU UAE,Transguard Group LLC,API User,E6AEAE17361
2022-02-14 10:09,72201892,"3,590.1210","3,585.2210",05.00 AED,5.00,4.9000,0.1000,563782865,1576357,Success,United Arab Emirates,DU UAE,Transguard Group LLC,API User,E6AEAE17361
2022-02-14 10:10,72202128,"3,585.2210","3,579.2810",100.00 INR,6.75,5.9400,0.8100,563783471,1576364,Success,India,Jio India,Transguard Group LLC,API User,RJININ86374
2022-02-14 10:11,72202279,"3,579.2810","3,569.4810",10.00 AED,10.00,9.8000,0.2000,563783622,1576367,Success,United Arab Emirates,DU UAE,Transguard Group LLC,API User,E6AEAE22430
2022-02-14 10:13,72202718,"3,569.4810","3,559.6810",10.00 AED,10.00,9.8000,0.2000,563784367,1576382,Success,United Arab Emirates,DU UAE,Transguard Group LLC,API User,E6AEAE22430
2022-02-14 10:13,72202741,"3,559.6810","3,549.8810",10.00 AED,10.00,9.8000,0.2000,563784516,1576386,Success,United Arab Emirates,DU UAE,Transguard Group LLC,API User,E6AEAE22430
2022-02-14 10:13,72202744,"3,549.8810","3,543.9410",100.00 INR,6.75,5.9400,0.8100,563784569,1576387,Success,India,Jio India,Transguard Group LLC,API User,RJININ86374
2022-02-14 10:14,72202925,"3,543.9410","3,538.0010",100.00 INR,6.75,5.9400,0.8100,563785109,1576396,Success,India,Jio India,Transguard Group LLC,API User,RJININ86374
2022-02-14 10:15,72203085,"3,538.0010","3,533.1010",05.00 AED,5.00,4.9000,0.1000,563785387,1576400,Success,United Arab Emirates,DU UAE,Transguard Group LLC,API User,E6AEAE17361
2022-02-14 10:15,72203095,"3,533.1010","3,528.2010",05.00 AED,5.00,4.9000,0.1000,563785394,1576401,Success,United Arab Emirates,DU UAE,Transguard Group LLC,API User,E6AEAE17361
2022-02-14 10:27,72205201,"3,528.2010","3,523.3010",05.00 AED,5.00,4.9000,0.1000,563789214,1576420,Success,United Arab Emirates,DU UAE,Transguard Group LLC,API User,E6AEAE17361
2022-02-14 10:29,72205611,"3,523.3010","3,513.5010",10.00 AED,10.00,9.8000,0.2000,563789777,1576425,Success,United Arab Emirates,DU UAE,Transguard Group LLC,API User,E6AEAE22430
2022-02-14 10:31,72206009,"3,513.5010","3,508.6010",05.00 AED,5.00,4.9000,0.1000,563790286,1576429,Success,United Arab Emirates,DU UAE,Transguard Group LLC,API User,E6AEAE17361
2022-02-14 10:38,72207316,"3,508.6010","3,503.7010",05.00 AED,5.00,4.9000,0.1000,563792001,1576440,Success,United Arab Emirates,DU UAE,Transguard Group LLC,API User,E6AEAE17361
2022-02-14 10:42,72208060,"3,503.7010","3,498.8010",05.00 AED,5.00,4.9000,0.1000,563792988,1576454,Success,United Arab Emirates,DU UAE,Transguard Group LLC,API User,E6AEAE17361
2022-02-14 10:42,72208073,"3,498.8010","3,493.9010",05.00 AED,5.00,4.9000,0.1000,563793012,1576458,Success,United Arab Emirates,DU UAE,Transguard Group LLC,API User,E6AEAE17361
2022-02-14 10:46,72208661,"3,493.9010","3,484.1010",10.00 AED,10.00,9.8000,0.2000,563793772,1576467,Success,United Arab Emirates,DU UAE,Transguard Group LLC,API User,E6AEAE22430
2022-02-14 10:47,72208912,"3,484.1010","3,480.1410",500.00 XAF,4.50,3.9600,0.5400,563794104,1576472,Success,Cameroon,MTN Cameroon,Transguard Group LLC,API User,CM_MT_TopUp_500.00
2022-02-14 10:49,72209315,"3,480.1410","3,470.3410",10.00 AED,10.00,9.8000,0.2000,563794587,1576478,Success,United Arab Emirates,DU UAE,Transguard Group LLC,API User,E6AEAE22430
2022-02-14 10:53,72210050,"3,470.3410","3,461.9810",100.00 PHP,9.50,8.3600,1.1400,563795580,1576489,Success,Philippines,Smart (SunCellular) Philippines,Transguard Group LLC,API User,PH_SM_TopUp_100.00
2022-02-14 10:53,72210060,"3,461.9810","3,452.1810",10.00 AED,10.00,9.8000,0.2000,563795587,1576490,Success,United Arab Emirates,DU UAE,Transguard Group LLC,API User,E6AEAE22430
2022-02-14 10:55,72210414,"3,452.1810","3,447.2810",05.00 AED,5.00,4.9000,0.1000,563796039,1576502,Success,United Arab Emirates,DU UAE,Transguard Group LLC,API User,E6AEAE17361
2022-02-14 10:55,72210422,"3,447.2810","3,437.4810",10.00 AED,10.00,9.8000,0.2000,563796052,1576504,Success,United Arab Emirates,DU UAE,Transguard Group LLC,API User,E6AEAE22430
2022-02-14 10:59,72211121,"3,437.4810","3,432.5810",05.00 AED,5.00,4.9000,0.1000,563796957,1576513,Success,United Arab Emirates,DU UAE,Transguard Group LLC,API User,E6AEAE17361
2022-02-14 10:59,72211150,"3,432.5810","3,422.7810",10.00 AED,10.00,9.8000,0.2000,563797010,1576515,Success,United Arab Emirates,DU UAE,Transguard Group LLC,API User,E6AEAE22430
2022-02-14 11:00,72211305,"3,422.7810","3,417.8810",05.00 AED,5.00,4.9000,0.1000,563797196,1576519,Success,United Arab Emirates,DU UAE,Transguard Group LLC,API User,E6AEAE17361
2022-02-14 11:00,72211327,"3,417.8810","3,412.9810",05.00 AED,5.00,4.9000,0.1000,563797233,1576522,Success,United Arab Emirates,DU UAE,Transguard Group LLC,API User,E6AEAE17361
2022-02-14 11:04,72212006,"3,412.9810","3,408.0810",05.00 AED,5.00,4.9000,0.1000,563798160,1576531,Success,United Arab Emirates,DU UAE,Transguard Group LLC,API User,E6AEAE17361
2022-02-14 11:10,72213055,"3,408.0810","3,403.1810",05.00 AED,5.00,4.9000,0.1000,563799574,1576541,Success,United Arab Emirates,DU UAE,Transguard Group LLC,API User,E6AEAE17361
2022-02-14 11:12,72213237,"3,403.1810","3,398.2810",05.00 AED,5.00,4.9000,0.1000,563799822,1576544,Success,United Arab Emirates,DU UAE,Transguard Group LLC,API User,E6AEAE17361
2022-02-14 11:15,72213905,"3,398.2810","3,393.3810",05.00 AED,5.00,4.9000,0.1000,563800686,1576551,Success,United Arab Emirates,DU UAE,Transguard Group LLC,API User,E6AEAE17361
2022-02-14 11:16,72214068,"3,393.3810","3,388.4810",05.00 AED,5.00,4.9000,0.1000,563800900,1576560,Success,United Arab Emirates,DU UAE,Transguard Group LLC,API User,E6AEAE17361
2022-02-14 11:24,72214976,"3,388.4810","3,383.5810",05.00 AED,5.00,4.9000,0.1000,563802280,1576579,Success,United Arab Emirates,DU UAE,Transguard Group LLC,API User,E6AEAE17361
2022-02-14 11:24,72214982,"3,383.5810","3,378.6810",05.00 AED,5.00,4.9000,0.1000,563802290,1576580,Success,United Arab Emirates,DU UAE,Transguard Group LLC,API User,E6AEAE17361
2022-02-14 11:29,72215284,"3,378.6810","3,373.7810",05.00 AED,5.00,4.9000,0.1000,563802873,1576591,Success,United Arab Emirates,DU UAE,Transguard Group LLC,API User,E6AEAE17361
2022-02-14 11:35,72215659,"3,373.7810","3,368.8810",05.00 AED,5.00,4.9000,0.1000,563803749,1576606,Success,United Arab Emirates,DU UAE,Transguard Group LLC,API User,E6AEAE17361
2022-02-14 11:46,72216310,"3,368.8810","3,360.0810",13.20 GHS,10.00,8.8000,1.2000,563805061,1576623,Success,Ghana,MTN Ghana,Transguard Group LLC,API User,GH_MT_TopUp
2022-02-14 11:46,72216313,"3,360.0810","3,355.1810",05.00 AED,5.00,4.9000,0.1000,563805071,1576625,Success,United Arab Emirates,DU UAE,Transguard Group LLC,API User,E6AEAE17361
2022-02-14 11:46,72216316,"3,355.1810","3,345.3810",10.00 AED,10.00,9.8000,0.2000,563805072,1576626,Success,United Arab Emirates,DU UAE,Transguard Group LLC,API User,E6AEAE22430
2022-02-14 11:47,72216351,"3,345.3810","3,335.5810",10.00 AED,10.00,9.8000,0.2000,563805161,1576632,Success,United Arab Emirates,DU UAE,Transguard Group LLC,API User,E6AEAE22430
2022-02-14 11:48,72216429,"3,335.5810","3,330.6810",05.00 AED,5.00,4.9000,0.1000,563805308,1576638,Success,United Arab Emirates,DU UAE,Transguard Group LLC,API User,E6AEAE17361
2022-02-14 11:56,72216901,"3,330.6810","3,325.7810",05.00 AED,5.00,4.9000,0.1000,563806256,1576655,Success,United Arab Emirates,DU UAE,Transguard Group LLC,API User,E6AEAE17361
2022-02-14 11:56,72216913,"3,325.7810","3,315.9810",10.00 AED,10.00,9.8000,0.2000,563806278,1576657,Success,United Arab Emirates,DU UAE,Transguard Group LLC,API User,E6AEAE22430
2022-02-14 12:04,72217349,"3,315.9810","3,311.8010",50.00 PHP,4.75,4.1800,0.5700,563807439,72217349,Success,Philippines,Smart (SunCellular) Philippines,Transguard Group LLC,mohammed.arafath@transguardgroup.com,PH_SM_TopUp_50.00
2022-02-14 12:09,72217664,"3,311.8010","3,303.8810",220.00 NPR,9.00,7.9200,1.0800,563808251,1576675,Success,Nepal,Ncell Nepal,Transguard Group LLC,API User,NCNPNP79518
2022-02-14 12:12,72217831,"3,303.8810","3,298.9810",05.00 AED,5.00,4.9000,0.1000,563808646,1576681,Success,United Arab Emirates,DU UAE,Transguard Group LLC,API User,E6AEAE17361
2022-02-14 12:13,72217903,"3,298.9810","3,289.1810",10.00 AED,10.00,9.8000,0.2000,563808852,1576687,Success,United Arab Emirates,DU UAE,Transguard Group LLC,API User,E6AEAE22430
2022-02-14 12:19,72218252,"3,289.1810","3,271.5810","1,604.00 NGN",20.00,17.6000,2.4000,563809675,1576699,Success,Nigeria,MTN Nigeria,Transguard Group LLC,API User,NG_MT_TopUp
2022-02-14 12:23,72218459,"3,271.5810","3,261.7810",10.00 AED,10.00,9.8000,0.2000,563810263,1576705,Success,United Arab Emirates,DU UAE,Transguard Group LLC,API User,E6AEAE22430
2022-02-14 12:23,72218479,"3,261.7810","3,256.8810",05.00 AED,5.00,4.9000,0.1000,563810312,1576708,Success,United Arab Emirates,DU UAE,Transguard Group LLC,API User,E6AEAE17361
2022-02-14 12:24,72218521,"3,256.8810","3,247.0810",10.00 AED,10.00,9.8000,0.2000,563810391,1576712,Success,United Arab Emirates,DU UAE,Transguard Group LLC,API User,E6AEAE22430
2022-02-14 12:24,72218561,"3,247.0810","3,237.2810",10.00 AED,10.00,9.8000,0.2000,563810513,1576717,Success,United Arab Emirates,DU UAE,Transguard Group LLC,API User,E6AEAE22430
2022-02-14 12:28,72218804,"3,237.2810","3,198.0810",40.00 AED,40.00,39.2000,0.8000,563811144,1576726,Success,United Arab Emirates,DU UAE,Transguard Group LLC,API User,E6AEAE64011
2022-02-14 12:30,72218916,"3,198.0810","3,178.4810",20.00 AED,20.00,19.6000,0.4000,563811453,1576730,Success,United Arab Emirates,DU UAE,Transguard Group LLC,API User,E6AEAE12938
2022-02-14 12:35,72219171,"3,178.4810","3,173.5810",05.00 AED,5.00,4.9000,0.1000,563812134,1576742,Success,United Arab Emirates,DU UAE,Transguard Group LLC,API User,E6AEAE17361
2022-02-14 12:36,72219235,"3,173.5810","3,169.8410",151.00 PKR,4.25,3.7400,0.5100,563812289,1576747,Success,Pakistan,Telenor Pakistan,Transguard Group LLC,API User,TPPKPK94108
2022-02-14 12:38,72219378,"3,169.8410","3,160.0410",10.00 AED,10.00,9.8000,0.2000,563812588,1576752,Success,United Arab Emirates,DU UAE,Transguard Group LLC,API User,E6AEAE22430
2022-02-14 12:41,72219555,"3,160.0410","3,150.2410",10.00 AED,10.00,9.8000,0.2000,563812954,1577748,Success,United Arab Emirates,DU UAE,Transguard Group LLC,API User,E6AEAE22430
2022-02-14 12:42,72219607,"3,150.2410","3,145.3410",05.00 AED,5.00,4.9000,0.1000,563813062,1577753,Success,United Arab Emirates,DU UAE,Transguard Group LLC,API User,E6AEAE17361
2022-02-14 12:43,72219681,"3,145.3410","3,135.5410",10.00 AED,10.00,9.8000,0.2000,563813190,1577758,Success,United Arab Emirates,DU UAE,Transguard Group LLC,API User,E6AEAE22430
2022-02-14 12:43,72219698,"3,135.5410","3,125.7410",10.00 AED,10.00,9.8000,0.2000,563813222,1577761,Success,United Arab Emirates,DU UAE,Transguard Group LLC,API User,E6AEAE22430
2022-02-14 13:13,72221558,"3,125.7410","3,115.9410",10.00 AED,10.00,9.8000,0.2000,563817125,1578775,Success,United Arab Emirates,DU UAE,Transguard Group LLC,API User,E6AEAE22430
2022-02-14 13:16,72221772,"3,115.9410","3,111.0410",05.00 AED,5.00,4.9000,0.1000,563817587,1578788,Success,United Arab Emirates,DU UAE,Transguard Group LLC,API User,E6AEAE17361
2022-02-14 13:17,72221802,"3,111.0410","3,091.4410",20.00 AED,20.00,19.6000,0.4000,563817660,1578790,Success,United Arab Emirates,DU UAE,Transguard Group LLC,API User,E6AEAE12938
2022-02-14 13:17,72221856,"3,091.4410","3,081.6410",10.00 AED,10.00,9.8000,0.2000,563817782,1578794,Success,United Arab Emirates,DU UAE,Transguard Group LLC,API User,E6AEAE22430
2022-02-14 13:23,72222256,"3,076.7410","3,071.8160",05.00 AED,5.00,4.9250,0.0750,563818616,72222256,Success,United Arab Emirates,Etisalat UAE,Transguard Group LLC,mohammed.arafath@transguardgroup.com,ETAEAE54031
2022-02-14 13:23,72222262,"3,081.6410","3,076.7410",05.00 AED,5.00,4.9000,0.1000,563818612,1578799,Success,United Arab Emirates,DU UAE,Transguard Group LLC,API User,E6AEAE17361
2022-02-14 13:29,72222659,"3,071.8160","3,066.9160",05.00 AED,5.00,4.9000,0.1000,563819449,1578809,Success,United Arab Emirates,DU UAE,Transguard Group LLC,API User,E6AEAE17361
2022-02-14 13:38,72223361,"3,066.9160","3,057.1160",10.00 AED,10.00,9.8000,0.2000,563820828,1578823,Success,United Arab Emirates,DU UAE,Transguard Group LLC,API User,E6AEAE22430
2022-02-14 13:41,72223573,"3,057.1160","3,052.2160",05.00 AED,5.00,4.9000,0.1000,563821267,1578828,Success,United Arab Emirates,DU UAE,Transguard Group LLC,API User,E6AEAE17361
2022-02-14 13:42,72223614,"3,052.2160","3,048.4760",151.00 PKR,4.25,3.7400,0.5100,563821363,1578835,Success,Pakistan,Telenor Pakistan,Transguard Group LLC,API User,TPPKPK94108
2022-02-14 13:55,72224608,"3,048.4760","3,043.5760",05.00 AED,5.00,4.9000,0.1000,563823413,1578854,Success,United Arab Emirates,DU UAE,Transguard Group LLC,API User,E6AEAE17361
2022-02-14 13:56,72224728,"3,043.5760","3,033.7760",10.00 AED,10.00,9.8000,0.2000,563823648,1578861,Success,United Arab Emirates,DU UAE,Transguard Group LLC,API User,E6AEAE22430
2022-02-14 14:03,72225208,"3,033.7760","3,023.9760",10.00 AED,10.00,9.8000,0.2000,563824764,1578869,Success,United Arab Emirates,DU UAE,Transguard Group LLC,API User,E6AEAE22430
2022-02-14 14:13,72226016,"3,023.9760","3,015.1760","1,226.00 XOF",10.00,8.8000,1.2000,563826991,1578879,Success,Ivory Coast,MTN Ivory Coast,Transguard Group LLC,API User,CI_MT_TopUp
2022-02-14 14:14,72226078,"3,015.1760","3,010.2760",05.00 AED,5.00,4.9000,0.1000,563827152,1578882,Success,United Arab Emirates,DU UAE,Transguard Group LLC,API User,E6AEAE17361
2022-02-14 14:17,72226323,"3,010.2760","3,000.4760",10.00 AED,10.00,9.8000,0.2000,563827904,1578892,Success,United Arab Emirates,DU UAE,Transguard Group LLC,API User,E6AEAE22430
2022-02-14 14:18,72226419,"3,000.4760","2,995.5760",05.00 AED,5.00,4.9000,0.1000,563828155,1578900,Success,United Arab Emirates,DU UAE,Transguard Group LLC,API User,E6AEAE17361
2022-02-14 14:26,72226953,"2,995.5760","2,990.6760",05.00 AED,5.00,4.9000,0.1000,563829759,1578914,Success,United Arab Emirates,DU UAE,Transguard Group LLC,API User,E6AEAE17361
2022-02-14 14:28,72227145,"2,990.6760","2,985.7760",05.00 AED,5.00,4.9000,0.1000,563830324,1578923,Success,United Arab Emirates,DU UAE,Transguard Group LLC,API User,E6AEAE17361
2022-02-14 14:32,72227493,"2,985.7760","2,980.8760",05.00 AED,5.00,4.9000,0.1000,563831155,1578932,Success,United Arab Emirates,DU UAE,Transguard Group LLC,API User,E6AEAE17361
2022-02-14 14:38,72227982,"2,980.8760","2,971.0760",10.00 AED,10.00,9.8000,0.2000,563832450,1578947,Success,United Arab Emirates,DU UAE,Transguard Group LLC,API User,E6AEAE22430
2022-02-14 14:38,72227997,"2,971.0760","2,951.4760",20.00 AED,20.00,19.6000,0.4000,563832496,1578948,Success,United Arab Emirates,DU UAE,Transguard Group LLC,API User,E6AEAE12938
2022-02-14 14:42,72228356,"2,951.4760","2,946.5760",05.00 AED,5.00,4.9000,0.1000,563833438,1578951,Success,United Arab Emirates,DU UAE,Transguard Group LLC,API User,E6AEAE17361
2022-02-14 14:47,72228733,"2,946.5760","2,936.7760",10.00 AED,10.00,9.8000,0.2000,563834462,1578958,Success,United Arab Emirates,DU UAE,Transguard Group LLC,API User,E6AEAE22430
2022-02-14 14:49,72228835,"2,936.7760","2,931.8760",05.00 AED,5.00,4.9000,0.1000,563834739,1578961,Success,United Arab Emirates,DU UAE,Transguard Group LLC,API User,E6AEAE17361
2022-02-14 14:51,72229082,"2,931.8760","2,922.0760",10.00 AED,10.00,9.8000,0.2000,563835419,1578967,Success,United Arab Emirates,DU UAE,Transguard Group LLC,API User,E6AEAE22430
2022-02-14 14:56,72229440,"2,922.0760","2,917.1760",05.00 AED,5.00,4.9000,0.1000,563836451,1578980,Success,United Arab Emirates,DU UAE,Transguard Group LLC,API User,E6AEAE17361
2022-02-14 15:03,72230140,"2,917.1760","2,912.2760",05.00 AED,5.00,4.9000,0.1000,563838112,1578986,Success,United Arab Emirates,DU UAE,Transguard Group LLC,API User,E6AEAE17361
2022-02-14 15:06,72230445,"2,912.2760","2,907.3760",05.00 AED,5.00,4.9000,0.1000,563838842,1578991,Success,United Arab Emirates,DU UAE,Transguard Group LLC,API User,E6AEAE17361
2022-02-14 15:07,72230636,"2,907.3760","2,902.4760",05.00 AED,5.00,4.9000,0.1000,563839273,1578994,Success,United Arab Emirates,DU UAE,Transguard Group LLC,API User,E6AEAE17361
2022-02-14 15:12,72231133,"2,902.4760","2,868.1760",35.00 AED,35.00,34.3000,0.7000,563840569,1579009,Success,United Arab Emirates,DU UAE,Transguard Group LLC,API User,E6AEAE73954
2022-02-14 15:15,72231346,"2,868.1760","2,863.2760",05.00 AED,5.00,4.9000,0.1000,563841139,1579014,Success,United Arab Emirates,DU UAE,Transguard Group LLC,API User,E6AEAE17361
2022-02-14 15:16,72231460,"2,863.2760","2,858.3760",05.00 AED,5.00,4.9000,0.1000,563841415,1579018,Success,United Arab Emirates,DU UAE,Transguard Group LLC,API User,E6AEAE17361
2022-02-14 15:20,72231882,"2,858.3760","2,850.2360",300.00 PKR,9.25,8.1400,1.1100,563842504,1579021,Success,Pakistan,Zong Pakistan,Transguard Group LLC,API User,ZNPKPK70504
2022-02-14 15:21,72231969,"2,850.2360","2,845.3360",05.00 AED,5.00,4.9000,0.1000,563842713,1579024,Success,United Arab Emirates,DU UAE,Transguard Group LLC,API User,E6AEAE17361
2022-02-14 15:26,72232447,"2,845.3360","2,840.4360",05.00 AED,5.00,4.9000,0.1000,563843904,1579030,Success,United Arab Emirates,DU UAE,Transguard Group LLC,API User,E6AEAE17361
2022-02-14 15:28,72232679,"2,840.4360","2,830.6360",10.00 AED,10.00,9.8000,0.2000,563844382,1579037,Success,United Arab Emirates,DU UAE,Transguard Group LLC,API User,E6AEAE22430
2022-02-14 15:31,72233094,"2,830.6360","2,825.7360",05.00 AED,5.00,4.9000,0.1000,563845207,1579042,Success,United Arab Emirates,DU UAE,Transguard Group LLC,API User,E6AEAE17361
2022-02-14 15:34,72233322,"2,825.7360","2,820.8360",05.00 AED,5.00,4.9000,0.1000,563845684,1579046,Success,United Arab Emirates,DU UAE,Transguard Group LLC,API User,E6AEAE17361
2022-02-14 15:35,72233508,"2,820.8360","2,811.0360",10.00 AED,10.00,9.8000,0.2000,563846069,1579050,Success,United Arab Emirates,DU UAE,Transguard Group LLC,API User,E6AEAE22430
2022-02-14 15:36,72233664,"2,811.0360","2,806.1360",05.00 AED,5.00,4.9000,0.1000,563846365,1579053,Success,United Arab Emirates,DU UAE,Transguard Group LLC,API User,E6AEAE17361
2022-02-14 15:41,72234174,"2,806.1360","2,801.2360",05.00 AED,5.00,4.9000,0.1000,563847377,1579061,Success,United Arab Emirates,DU UAE,Transguard Group LLC,API User,E6AEAE17361
2022-02-14 15:55,72235909,"2,801.2360","2,791.4360",10.00 AED,10.00,9.8000,0.2000,563850725,1579072,Success,United Arab Emirates,DU UAE,Transguard Group LLC,API User,E6AEAE22430
2022-02-14 15:58,72236334,"2,791.4360","2,786.5360",05.00 AED,5.00,4.9000,0.1000,563851542,1579080,Success,United Arab Emirates,DU UAE,Transguard Group LLC,API User,E6AEAE17361
2022-02-14 16:01,72236628,"2,786.5360","2,781.6360",05.00 AED,5.00,4.9000,0.1000,563852113,1579087,Success,United Arab Emirates,DU UAE,Transguard Group LLC,API User,E6AEAE17361
2022-02-14 16:02,72236796,"2,781.6360","2,776.7360",05.00 AED,5.00,4.9000,0.1000,563852400,1579090,Success,United Arab Emirates,DU UAE,Transguard Group LLC,API User,E6AEAE17361
2022-02-14 16:03,72237034,"2,776.7360","2,771.8360",05.00 AED,5.00,4.9000,0.1000,563852854,1579095,Success,United Arab Emirates,DU UAE,Transguard Group LLC,API User,E6AEAE17361
2022-02-14 16:05,72237301,"2,771.8360","2,766.9360",05.00 AED,5.00,4.9000,0.1000,563853351,1579100,Success,United Arab Emirates,DU UAE,Transguard Group LLC,API User,E6AEAE17361
2022-02-14 16:07,72237616,"2,766.9360","2,762.0360",05.00 AED,5.00,4.9000,0.1000,563853921,1579104,Success,United Arab Emirates,DU UAE,Transguard Group LLC,API User,E6AEAE17361
2022-02-14 16:13,72238370,"2,762.0360","2,757.1360",05.00 AED,5.00,4.9000,0.1000,563855418,1579115,Success,United Arab Emirates,DU UAE,Transguard Group LLC,API User,E6AEAE17361
2022-02-14 16:19,72239263,"2,757.1360","2,752.2360",05.00 AED,5.00,4.9000,0.1000,563857105,1579124,Success,United Arab Emirates,DU UAE,Transguard Group LLC,API User,E6AEAE17361
2022-02-14 16:26,72240336,"2,752.2360","2,747.3360",05.00 AED,5.00,4.9000,0.1000,563859149,1579132,Success,United Arab Emirates,DU UAE,Transguard Group LLC,API User,E6AEAE17361
2022-02-14 16:31,72241061,"2,747.3360","2,742.4360",05.00 AED,5.00,4.9000,0.1000,563860578,1579139,Success,United Arab Emirates,DU UAE,Transguard Group LLC,API User,E6AEAE17361
2022-02-14 16:32,72241176,"2,742.4360","2,737.5360",05.00 AED,5.00,4.9000,0.1000,563860809,1579142,Success,United Arab Emirates,DU UAE,Transguard Group LLC,API User,E6AEAE17361
2022-02-14 16:38,72242134,"2,737.5360","2,638.5360",100.00 AED,100.00,99.0000,1.0000,563862723,72242134,Success,United Arab Emirates,Salik UAE,Transguard Group LLC,mohammed.arafath@transguardgroup.com,ZOAEAE63899
2022-02-14 16:41,72242525,"2,638.5360","2,629.9560",315.00 PKR,9.75,8.5800,1.1700,563863487,72242525,Success,Pakistan,Zong Pakistan,Transguard Group LLC,mohammed.arafath@transguardgroup.com,ZNPKPK29953
2022-02-14 16:41,72242630,"2,629.9560","2,620.1560",10.00 AED,10.00,9.8000,0.2000,563863615,1579162,Success,United Arab Emirates,DU UAE,Transguard Group LLC,API User,E6AEAE22430
2022-02-14 16:43,72242871,"2,620.1560","2,610.3560",10.00 AED,10.00,9.8000,0.2000,563864097,72242871,Success,United Arab Emirates,DU UAE,Transguard Group LLC,mohammed.arafath@transguardgroup.com,E6AEAE22430
2022-02-14 16:43,72242933,"2,610.3560","2,605.4560",05.00 AED,5.00,4.9000,0.1000,563864157,1579169,Success,United Arab Emirates,DU UAE,Transguard Group LLC,API User,E6AEAE17361
2022-02-14 16:44,72243056,"2,605.4560","2,600.5560",05.00 AED,5.00,4.9000,0.1000,563864367,1579173,Success,United Arab Emirates,DU UAE,Transguard Group LLC,API User,E6AEAE17361
2022-02-14 16:44,72243038,"2,600.5560","2,590.7560",10.00 AED,10.00,9.8000,0.2000,563864389,72243038,Success,United Arab Emirates,DU UAE,Transguard Group LLC,mohammed.arafath@transguardgroup.com,E6AEAE22430
2022-02-14 16:45,72243182,"2,590.7560","2,580.9560",10.00 AED,10.00,9.8000,0.2000,563864632,72243182,Success,United Arab Emirates,DU UAE,Transguard Group LLC,mohammed.arafath@transguardgroup.com,E6AEAE22430
2022-02-14 16:46,72243464,"2,580.9560","2,571.1560",10.00 AED,10.00,9.8000,0.2000,563865131,72243464,Success,United Arab Emirates,DU UAE,Transguard Group LLC,mohammed.arafath@transguardgroup.com,E6AEAE22430
2022-02-14 16:47,72243658,"2,571.1560","2,567.4160",130.00 PKR,4.25,3.7400,0.5100,563865499,72243658,Success,Pakistan,Ufone Pakistan,Transguard Group LLC,mohammed.arafath@transguardgroup.com,UFPKPK56132
2022-02-14 16:49,72243908,"2,567.4160","2,557.6160",10.00 AED,10.00,9.8000,0.2000,563865941,1579191,Success,United Arab Emirates,DU UAE,Transguard Group LLC,API User,E6AEAE22430
2022-02-14 16:50,72244058,"2,557.6160","2,552.7160",05.00 AED,5.00,4.9000,0.1000,563866247,72244058,Success,United Arab Emirates,DU UAE,Transguard Group LLC,mohammed.arafath@transguardgroup.com,E6AEAE17361
2022-02-14 16:50,72244129,"2,552.7160","2,547.8160",05.00 AED,5.00,4.9000,0.1000,563866342,1579194,Success,United Arab Emirates,DU UAE,Transguard Group LLC,API User,E6AEAE17361
2022-02-14 16:52,72244372,"2,547.8160","2,542.9160",05.00 AED,5.00,4.9000,0.1000,563866795,1579197,Success,United Arab Emirates,DU UAE,Transguard Group LLC,API User,E6AEAE17361
2022-02-14 16:52,72244459,"2,542.9160","2,538.0160",05.00 AED,5.00,4.9000,0.1000,563866959,1579200,Success,United Arab Emirates,DU UAE,Transguard Group LLC,API User,E6AEAE17361
2022-02-14 16:53,72244620,"2,538.0160","2,533.1160",05.00 AED,5.00,4.9000,0.1000,563867260,1579206,Success,United Arab Emirates,DU UAE,Transguard Group LLC,API User,E6AEAE17361
2022-02-14 16:53,72244644,"2,533.1160","2,528.2160",05.00 AED,5.00,4.9000,0.1000,563867309,1579208,Success,United Arab Emirates,DU UAE,Transguard Group LLC,API User,E6AEAE17361
2022-02-14 16:54,72244803,"2,528.2160","2,518.4160",10.00 AED,10.00,9.8000,0.2000,563867599,1579211,Success,United Arab Emirates,DU UAE,Transguard Group LLC,API User,E6AEAE22430
2022-02-14 16:56,72245078,"2,518.4160","2,508.6160",10.00 AED,10.00,9.8000,0.2000,563868120,72245078,Success,United Arab Emirates,DU UAE,Transguard Group LLC,mohammed.arafath@transguardgroup.com,E6AEAE22430
2022-02-14 16:57,72245321,"2,508.6160","2,503.7160",05.00 AED,5.00,4.9000,0.1000,563868544,1579218,Success,United Arab Emirates,DU UAE,Transguard Group LLC,API User,E6AEAE17361
2022-02-14 16:58,72245473,"2,503.7160","2,498.8160",05.00 AED,5.00,4.9000,0.1000,563868826,1579220,Success,United Arab Emirates,DU UAE,Transguard Group LLC,API User,E6AEAE17361
2022-02-14 16:59,72245636,"2,498.8160","2,493.9160",05.00 AED,5.00,4.9000,0.1000,563869117,1579229,Success,United Arab Emirates,DU UAE,Transguard Group LLC,API User,E6AEAE17361
2022-02-14 16:59,72245705,"2,493.9160","2,489.0160",05.00 AED,5.00,4.9000,0.1000,563869235,1579235,Success,United Arab Emirates,DU UAE,Transguard Group LLC,API User,E6AEAE17361
2022-02-14 17:00,72245734,"2,489.0160","2,484.1160",05.00 AED,5.00,4.9000,0.1000,563869304,1579238,Success,United Arab Emirates,DU UAE,Transguard Group LLC,API User,E6AEAE17361
2022-02-14 17:01,72245895,"2,484.1160","2,474.3160",10.00 AED,10.00,9.8000,0.2000,563869628,1579242,Success,United Arab Emirates,DU UAE,Transguard Group LLC,API User,E6AEAE22430
2022-02-14 17:02,72246155,"2,474.3160","2,469.4160",05.00 AED,5.00,4.9000,0.1000,563870113,1579248,Success,United Arab Emirates,DU UAE,Transguard Group LLC,API User,E6AEAE17361
2022-02-14 17:03,72246325,"2,469.4160","2,464.5160",05.00 AED,5.00,4.9000,0.1000,563870425,1579251,Success,United Arab Emirates,DU UAE,Transguard Group LLC,API User,E6AEAE17361
2022-02-14 17:05,72246564,"2,464.5160","2,454.7160",10.00 AED,10.00,9.8000,0.2000,563870858,1579259,Success,United Arab Emirates,DU UAE,Transguard Group LLC,API User,E6AEAE22430
2022-02-14 17:05,72246575,"2,454.7160","2,437.7760",470.00 NPR,19.25,16.9400,2.3100,563870882,1579260,Success,Nepal,Ncell Nepal,Transguard Group LLC,API User,NCNPNP37643
2022-02-14 17:15,72248347,"2,437.7760","2,432.8760",05.00 AED,5.00,4.9000,0.1000,563874364,1579265,Success,United Arab Emirates,DU UAE,Transguard Group LLC,API User,E6AEAE17361
2022-02-14 17:23,72249757,"2,432.8760","2,427.9760",05.00 AED,5.00,4.9000,0.1000,563877138,1579281,Success,United Arab Emirates,DU UAE,Transguard Group LLC,API User,E6AEAE17361
2022-02-14 17:24,72249890,"2,427.9760","2,418.1760",10.00 AED,10.00,9.8000,0.2000,563877410,1579289,Success,United Arab Emirates,DU UAE,Transguard Group LLC,API User,E6AEAE22430
2022-02-14 17:24,72249905,"2,418.1760","2,413.2760",05.00 AED,5.00,4.9000,0.1000,563877433,1579290,Success,United Arab Emirates,DU UAE,Transguard Group LLC,API User,E6AEAE17361
2022-02-14 17:27,72250530,"2,413.2760","2,403.4760",10.00 AED,10.00,9.8000,0.2000,563878670,1579296,Success,United Arab Emirates,DU UAE,Transguard Group LLC,API User,E6AEAE22430
2022-02-14 17:29,72250766,"2,403.4760","2,399.0760",401.00 NGN,5.00,4.4000,0.6000,563879165,1579301,Success,Nigeria,MTN Nigeria,Transguard Group LLC,API User,NG_MT_TopUp
2022-02-14 17:31,72251167,"2,399.0760","2,394.1760",05.00 AED,5.00,4.9000,0.1000,563879979,1579312,Success,United Arab Emirates,DU UAE,Transguard Group LLC,API User,E6AEAE17361
2022-02-14 17:32,72251444,"2,394.1760","2,389.2760",05.00 AED,5.00,4.9000,0.1000,563880532,1579316,Success,United Arab Emirates,DU UAE,Transguard Group LLC,API User,E6AEAE17361
2022-02-14 17:37,72252311,"2,389.2760","2,384.3760",05.00 AED,5.00,4.9000,0.1000,563882193,1579319,Success,United Arab Emirates,DU UAE,Transguard Group LLC,API User,E6AEAE17361
2022-02-14 17:45,72253797,"2,384.3760","2,379.4760",05.00 AED,5.00,4.9000,0.1000,563885237,1579328,Success,United Arab Emirates,DU UAE,Transguard Group LLC,API User,E6AEAE17361
2022-02-14 17:45,72253888,"2,379.4760","2,369.6760",10.00 AED,10.00,9.8000,0.2000,563885399,1579331,Success,United Arab Emirates,DU UAE,Transguard Group LLC,API User,E6AEAE22430
2022-02-14 17:47,72254171,"2,369.6760","2,364.7760",05.00 AED,5.00,4.9000,0.1000,563885979,1579336,Success,United Arab Emirates,DU UAE,Transguard Group LLC,API User,E6AEAE17361
2022-02-14 17:49,72254650,"2,364.7760","2,354.9760",10.00 AED,10.00,9.8000,0.2000,563886888,1579344,Success,United Arab Emirates,DU UAE,Transguard Group LLC,API User,E6AEAE22430
2022-02-14 17:55,72255759,"2,354.9760","2,350.0760",05.00 AED,5.00,4.9000,0.1000,563888930,1579360,Success,United Arab Emirates,DU UAE,Transguard Group LLC,API User,E6AEAE17361
2022-02-14 17:57,72256222,"2,350.0760","2,345.1760",05.00 AED,5.00,4.9000,0.1000,563889803,1579364,Success,United Arab Emirates,DU UAE,Transguard Group LLC,API User,E6AEAE17361
2022-02-14 17:59,72256572,"2,345.1760","2,340.2760",05.00 AED,5.00,4.9000,0.1000,563890492,1579372,Success,United Arab Emirates,DU UAE,Transguard Group LLC,API User,E6AEAE17361
2022-02-14 18:00,72256716,"2,340.2760","2,330.4760",10.00 AED,10.00,9.8000,0.2000,563890771,1579380,Success,United Arab Emirates,DU UAE,Transguard Group LLC,API User,E6AEAE22430
2022-02-14 18:00,72256766,"2,330.4760","2,320.6760",10.00 AED,10.00,9.8000,0.2000,563890875,1579383,Success,United Arab Emirates,DU UAE,Transguard Group LLC,API User,E6AEAE22430
2022-02-14 18:01,72257028,"2,320.6760","2,276.5760",45.00 AED,45.00,44.1000,0.9000,563891429,1579389,Success,United Arab Emirates,DU UAE,Transguard Group LLC,API User,E6AEAE35243
2022-02-14 18:02,72257208,"2,276.5760","2,271.6760",05.00 AED,5.00,4.9000,0.1000,563891776,1579392,Success,United Arab Emirates,DU UAE,Transguard Group LLC,API User,E6AEAE17361
2022-02-14 18:04,72257585,"2,271.6760","2,266.7760",05.00 AED,5.00,4.9000,0.1000,563892496,1579399,Success,United Arab Emirates,DU UAE,Transguard Group LLC,API User,E6AEAE17361
2022-02-14 18:11,72259051,"2,266.7760","2,256.9760",10.00 AED,10.00,9.8000,0.2000,563895328,1579417,Success,United Arab Emirates,DU UAE,Transguard Group LLC,API User,E6AEAE22430
2022-02-14 18:12,72259188,"2,256.9760","2,252.0760",05.00 AED,5.00,4.9000,0.1000,563895593,1579420,Success,United Arab Emirates,DU UAE,Transguard Group LLC,API User,E6AEAE17361
2022-02-14 18:15,72259811,"2,252.0760","2,242.2760",10.00 AED,10.00,9.8000,0.2000,563896859,1579428,Success,United Arab Emirates,DU UAE,Transguard Group LLC,API User,E6AEAE22430
2022-02-14 18:17,72260170,"2,242.2760","2,237.3760",05.00 AED,5.00,4.9000,0.1000,563897577,1579431,Success,United Arab Emirates,DU UAE,Transguard Group LLC,API User,E6AEAE17361
2022-02-14 18:20,72260704,"2,237.3760","2,234.2960",50.00 INR,3.50,3.0800,0.4200,563898621,1579436,Success,India,Jio India,Transguard Group LLC,API User,RJININ80851
2022-02-14 18:27,72262025,"2,234.2960","2,229.3960",05.00 AED,5.00,4.9000,0.1000,563901308,1579458,Success,United Arab Emirates,DU UAE,Transguard Group LLC,API User,E6AEAE17361
2022-02-14 18:28,72262255,"2,229.3960","2,209.7960",20.00 AED,20.00,19.6000,0.4000,563901760,1579462,Success,United Arab Emirates,DU UAE,Transguard Group LLC,API User,E6AEAE12938
2022-02-14 18:29,72262509,"2,209.7960","2,199.9960",10.00 AED,10.00,9.8000,0.2000,563902276,1579475,Success,United Arab Emirates,DU UAE,Transguard Group LLC,API User,E6AEAE22430
2022-02-14 18:31,72262905,"2,199.9960","2,195.0960",05.00 AED,5.00,4.9000,0.1000,563903062,1579482,Success,United Arab Emirates,DU UAE,Transguard Group LLC,API User,E6AEAE17361
2022-02-14 18:32,72263044,"2,195.0960","2,190.1960",05.00 AED,5.00,4.9000,0.1000,563903302,1579485,Success,United Arab Emirates,DU UAE,Transguard Group LLC,API User,E6AEAE17361
2022-02-14 18:34,72263449,"2,190.1960","2,180.3960",10.00 AED,10.00,9.8000,0.2000,563904097,1579491,Success,United Arab Emirates,DU UAE,Transguard Group LLC,API User,E6AEAE22430
2022-02-14 18:41,72264914,"2,180.3960","2,170.5960",10.00 AED,10.00,9.8000,0.2000,563906947,1579507,Success,United Arab Emirates,DU UAE,Transguard Group LLC,API User,E6AEAE22430
2022-02-14 18:44,72265648,"2,170.5960","2,165.6960",05.00 AED,5.00,4.9000,0.1000,563908324,1579517,Success,United Arab Emirates,DU UAE,Transguard Group LLC,API User,E6AEAE17361
2022-02-14 18:45,72265755,"2,165.6960","2,160.7960",05.00 AED,5.00,4.9000,0.1000,563908536,1579521,Success,United Arab Emirates,DU UAE,Transguard Group LLC,API User,E6AEAE17361
2022-02-14 18:46,72265994,"2,160.7960","2,155.8960",05.00 AED,5.00,4.9000,0.1000,563909085,1579529,Success,United Arab Emirates,DU UAE,Transguard Group LLC,API User,E6AEAE17361
2022-02-14 18:46,72265995,"2,155.8960","2,146.0960",10.00 AED,10.00,9.8000,0.2000,563909096,1579530,Success,United Arab Emirates,DU UAE,Transguard Group LLC,API User,E6AEAE22430
2022-02-14 18:47,72266178,"2,146.0960","2,141.1960",05.00 AED,5.00,4.9000,0.1000,563909426,1579536,Success,United Arab Emirates,DU UAE,Transguard Group LLC,API User,E6AEAE17361
2022-02-14 18:48,72266484,"2,141.1960","2,136.2960",05.00 AED,5.00,4.9000,0.1000,563910053,1579541,Success,United Arab Emirates,DU UAE,Transguard Group LLC,API User,E6AEAE17361
2022-02-14 18:49,72266639,"2,136.2960","2,126.4960",10.00 AED,10.00,9.8000,0.2000,563910349,1579548,Success,United Arab Emirates,DU UAE,Transguard Group LLC,API User,E6AEAE22430
2022-02-14 18:51,72266920,"2,126.4960","2,121.5960",05.00 AED,5.00,4.9000,0.1000,563910868,1579554,Success,United Arab Emirates,DU UAE,Transguard Group LLC,API User,E6AEAE17361
2022-02-14 18:51,72267028,"2,121.5960","2,099.3760",800.00 PKR,25.25,22.2200,3.0300,563911147,1579560,Success,Pakistan,Jazz Pakistan,Transguard Group LLC,API User,MBPKPK58682
2022-02-14 18:54,72267718,"2,099.3760","2,094.4760",05.00 AED,5.00,4.9000,0.1000,563912460,1579576,Success,United Arab Emirates,DU UAE,Transguard Group LLC,API User,E6AEAE17361
2022-02-14 18:55,72267801,"2,094.4760","2,089.5760",05.00 AED,5.00,4.9000,0.1000,563912623,1579580,Success,United Arab Emirates,DU UAE,Transguard Group LLC,API User,E6AEAE17361
2022-02-14 18:59,72268635,"2,089.5760","2,084.6760",05.00 AED,5.00,4.9000,0.1000,563914199,1579604,Success,United Arab Emirates,DU UAE,Transguard Group LLC,API User,E6AEAE17361
2022-02-14 19:00,72268983,"2,084.6760","2,074.8760",10.00 AED,10.00,9.8000,0.2000,563914865,1579612,Success,United Arab Emirates,DU UAE,Transguard Group LLC,API User,E6AEAE22430
2022-02-14 19:08,72270627,"2,074.8760","2,069.9760",05.00 AED,5.00,4.9000,0.1000,563917993,1579637,Success,United Arab Emirates,DU UAE,Transguard Group LLC,API User,E6AEAE17361
2022-02-14 19:18,72272999,"2,069.9760","2,065.0760",05.00 AED,5.00,4.9000,0.1000,563922638,1579665,Success,United Arab Emirates,DU UAE,Transguard Group LLC,API User,E6AEAE17361
2022-02-14 19:18,72273013,"2,065.0760","2,060.1760",05.00 AED,5.00,4.9000,0.1000,563922649,1579666,Success,United Arab Emirates,DU UAE,Transguard Group LLC,API User,E6AEAE17361
2022-02-14 19:20,72273383,"2,060.1760","2,055.2760",05.00 AED,5.00,4.9000,0.1000,563923435,1579679,Success,United Arab Emirates,DU UAE,Transguard Group LLC,API User,E6AEAE17361
2022-02-14 19:21,72273576,"2,055.2760","2,050.3760",05.00 AED,5.00,4.9000,0.1000,563923815,1579685,Success,United Arab Emirates,DU UAE,Transguard Group LLC,API User,E6AEAE17361
2022-02-14 19:21,72273603,"2,050.3760","2,040.5760",10.00 AED,10.00,9.8000,0.2000,563923878,1579687,Success,United Arab Emirates,DU UAE,Transguard Group LLC,API User,E6AEAE22430
2022-02-14 19:22,72273735,"2,040.5760","2,035.6760",05.00 AED,5.00,4.9000,0.1000,563924143,1579692,Success,United Arab Emirates,DU UAE,Transguard Group LLC,API User,E6AEAE17361
2022-02-14 19:22,72273741,"2,035.6760","2,030.7760",05.00 AED,5.00,4.9000,0.1000,563924153,1579693,Success,United Arab Emirates,DU UAE,Transguard Group LLC,API User,E6AEAE17361
2022-02-14 19:22,72273833,"2,030.7760","2,025.8760",05.00 AED,5.00,4.9000,0.1000,563924312,1579696,Success,United Arab Emirates,DU UAE,Transguard Group LLC,API User,E6AEAE17361
2022-02-14 19:23,72273990,"2,025.8760","2,016.0760",10.00 AED,10.00,9.8000,0.2000,563924616,1579699,Success,United Arab Emirates,DU UAE,Transguard Group LLC,API User,E6AEAE22430
2022-02-14 19:24,72274177,"2,016.0760","2,006.2760",10.00 AED,10.00,9.8000,0.2000,563924992,1579704,Success,United Arab Emirates,DU UAE,Transguard Group LLC,API User,E6AEAE22430
2022-02-14 19:24,72274248,"2,006.2760","1,996.4760",10.00 AED,10.00,9.8000,0.2000,563925139,1579707,Success,United Arab Emirates,DU UAE,Transguard Group LLC,API User,E6AEAE22430
2022-02-14 19:27,72274699,"1,996.4760","1,991.5760",05.00 AED,5.00,4.9000,0.1000,563926047,1579715,Success,United Arab Emirates,DU UAE,Transguard Group LLC,API User,E6AEAE17361
2022-02-14 19:27,72274842,"1,991.5760","1,986.6760",05.00 AED,5.00,4.9000,0.1000,563926333,1579718,Success,United Arab Emirates,DU UAE,Transguard Group LLC,API User,E6AEAE17361
2022-02-14 19:30,72275374,"1,986.6760","1,976.8760",10.00 AED,10.00,9.8000,0.2000,563927409,1579726,Success,United Arab Emirates,DU UAE,Transguard Group LLC,API User,E6AEAE22430
2022-02-14 19:30,72275419,"1,976.8760","1,971.9760",05.00 AED,5.00,4.9000,0.1000,563927520,1579729,Success,United Arab Emirates,DU UAE,Transguard Group LLC,API User,E6AEAE17361
2022-02-14 19:32,72275733,"1,971.9760","1,962.1760",10.00 AED,10.00,9.8000,0.2000,563928143,1579735,Success,United Arab Emirates,DU UAE,Transguard Group LLC,API User,E6AEAE22430
2022-02-14 19:35,72276356,"1,962.1760","1,957.2760",05.00 AED,5.00,4.9000,0.1000,563929335,1579743,Success,United Arab Emirates,DU UAE,Transguard Group LLC,API User,E6AEAE17361
2022-02-14 19:35,72276448,"1,957.2760","1,948.6960",02.00 USD,9.75,8.5800,1.1700,563929530,1579748,Success,Gambia,QCell Gambia,Transguard Group LLC,API User,QLGMGM50864
2022-02-14 19:37,72276801,"1,948.6960","1,938.8960",10.00 AED,10.00,9.8000,0.2000,563930273,1579756,Success,United Arab Emirates,DU UAE,Transguard Group LLC,API User,E6AEAE22430
2022-02-14 19:37,72276871,"1,938.8960","1,929.0960",10.00 AED,10.00,9.8000,0.2000,563930428,1579758,Success,United Arab Emirates,DU UAE,Transguard Group LLC,API User,E6AEAE22430
2022-02-14 19:40,72277469,"1,929.0960","1,909.4960",20.00 AED,20.00,19.6000,0.4000,563931581,1579766,Success,United Arab Emirates,DU UAE,Transguard Group LLC,API User,E6AEAE12938
2022-02-14 19:46,72278751,"1,909.4960","1,899.6960",10.00 AED,10.00,9.8000,0.2000,563934120,1579783,Success,United Arab Emirates,DU UAE,Transguard Group LLC,API User,E6AEAE22430
2022-02-14 19:46,72278766,"1,899.6960","1,889.8960",10.00 AED,10.00,9.8000,0.2000,563934136,1579784,Success,United Arab Emirates,DU UAE,Transguard Group LLC,API User,E6AEAE22430
2022-02-14 19:49,72279324,"1,889.8960","1,884.9960",05.00 AED,5.00,4.9000,0.1000,563935249,1579792,Success,United Arab Emirates,DU UAE,Transguard Group LLC,API User,E6AEAE17361
2022-02-14 19:52,72280031,"1,884.9960","1,880.0960",05.00 AED,5.00,4.9000,0.1000,563936654,1579801,Success,United Arab Emirates,DU UAE,Transguard Group LLC,API User,E6AEAE17361
2022-02-14 19:54,72280363,"1,880.0960","1,870.2960",10.00 AED,10.00,9.8000,0.2000,563937304,1579809,Success,United Arab Emirates,DU UAE,Transguard Group LLC,API User,E6AEAE22430
2022-02-14 19:56,72280766,"1,870.2960","1,865.3960",05.00 AED,5.00,4.9000,0.1000,563938107,1579822,Success,United Arab Emirates,DU UAE,Transguard Group LLC,API User,E6AEAE17361
2022-02-14 19:56,72280784,"1,865.3960","1,860.4960",05.00 AED,5.00,4.9000,0.1000,563938145,1579824,Success,United Arab Emirates,DU UAE,Transguard Group LLC,API User,E6AEAE17361
2022-02-14 19:56,72280792,"1,860.4960","1,850.6960",10.00 AED,10.00,9.8000,0.2000,563938164,1579825,Success,United Arab Emirates,DU UAE,Transguard Group LLC,API User,E6AEAE22430
2022-02-14 19:56,72280806,"1,850.6960","1,845.7960",05.00 AED,5.00,4.9000,0.1000,563938199,1579826,Success,United Arab Emirates,DU UAE,Transguard Group LLC,API User,E6AEAE17361
2022-02-14 19:57,72281110,"1,845.7960","1,840.8960",05.00 AED,5.00,4.9000,0.1000,563938818,1579832,Success,United Arab Emirates,DU UAE,Transguard Group LLC,API User,E6AEAE17361
2022-02-14 19:58,72281266,"1,840.8960","1,835.9960",05.00 AED,5.00,4.9000,0.1000,563939110,1579838,Success,United Arab Emirates,DU UAE,Transguard Group LLC,API User,E6AEAE17361
2022-02-14 20:01,72281988,"1,835.9960","1,831.0960",05.00 AED,5.00,4.9000,0.1000,563940492,1579853,Success,United Arab Emirates,DU UAE,Transguard Group LLC,API User,E6AEAE17361
2022-02-14 20:03,72282259,"1,831.0960","1,826.1960",05.00 AED,5.00,4.9000,0.1000,563941017,1579857,Success,United Arab Emirates,DU UAE,Transguard Group LLC,API User,E6AEAE17361
2022-02-14 20:03,72282334,"1,826.1960","1,805.2960",359.00 INR,23.75,20.9000,2.8500,563941184,1579859,Success,India,Airtel India,Transguard Group LLC,API User,AIININ62072
2022-02-14 20:06,72282954,"1,805.2960","1,795.4960",10.00 AED,10.00,9.8000,0.2000,563942357,1579866,Success,United Arab Emirates,DU UAE,Transguard Group LLC,API User,E6AEAE22430
2022-02-14 20:06,72282963,"1,795.4960","1,785.6960",10.00 AED,10.00,9.8000,0.2000,563942379,1579867,Success,United Arab Emirates,DU UAE,Transguard Group LLC,API User,E6AEAE22430
2022-02-14 20:08,72283413,"1,785.6960","1,780.7960",05.00 AED,5.00,4.9000,0.1000,563943284,1579877,Success,United Arab Emirates,DU UAE,Transguard Group LLC,API User,E6AEAE17361
2022-02-14 20:09,72283491,"1,780.7960","1,770.9960",10.00 AED,10.00,9.8000,0.2000,563943453,1579880,Success,United Arab Emirates,DU UAE,Transguard Group LLC,API User,E6AEAE22430
2022-02-14 20:10,72283887,"1,770.9960","1,766.0960",05.00 AED,5.00,4.9000,0.1000,563944315,1579895,Success,United Arab Emirates,DU UAE,Transguard Group LLC,API User,E6AEAE17361
2022-02-14 20:11,72283909,"1,766.0960","1,761.1960",05.00 AED,5.00,4.9000,0.1000,563944351,1579896,Success,United Arab Emirates,DU UAE,Transguard Group LLC,API User,E6AEAE17361
2022-02-14 20:12,72284213,"1,761.1960","1,756.2960",05.00 AED,5.00,4.9000,0.1000,563944970,1579900,Success,United Arab Emirates,DU UAE,Transguard Group LLC,API User,E6AEAE17361
2022-02-14 20:13,72284482,"1,756.2960","1,751.3960",05.00 AED,5.00,4.9000,0.1000,563945497,1579903,Success,United Arab Emirates,DU UAE,Transguard Group LLC,API User,E6AEAE17361
2022-02-14 20:14,72284651,"1,751.3960","1,746.4960",05.00 AED,5.00,4.9000,0.1000,563945851,1579908,Success,United Arab Emirates,DU UAE,Transguard Group LLC,API User,E6AEAE17361
2022-02-14 20:14,72284667,"1,746.4960","1,741.5960",05.00 AED,5.00,4.9000,0.1000,563945875,1579909,Success,United Arab Emirates,DU UAE,Transguard Group LLC,API User,E6AEAE17361
2022-02-14 20:16,72285081,"1,741.5960","1,731.7960",10.00 AED,10.00,9.8000,0.2000,563946791,1579917,Success,United Arab Emirates,DU UAE,Transguard Group LLC,API User,E6AEAE22430
2022-02-14 20:19,72285557,"1,731.7960","1,712.1960",20.00 AED,20.00,19.6000,0.4000,563947740,1579922,Success,United Arab Emirates,DU UAE,Transguard Group LLC,API User,E6AEAE12938
2022-02-14 20:19,72285688,"1,712.1960","1,707.2960",05.00 AED,5.00,4.9000,0.1000,563947946,1579926,Success,United Arab Emirates,DU UAE,Transguard Group LLC,API User,E6AEAE17361
2022-02-14 20:20,72285756,"1,707.2960","1,702.3960",05.00 AED,5.00,4.9000,0.1000,563947960,1579927,Success,United Arab Emirates,DU UAE,Transguard Group LLC,API User,E6AEAE17361
2022-02-14 20:24,72286682,"1,702.3960","1,697.4960",05.00 AED,5.00,4.9000,0.1000,563950049,1579941,Success,United Arab Emirates,DU UAE,Transguard Group LLC,API User,E6AEAE17361
2022-02-14 20:30,72287872,"1,697.4960","1,692.5960",05.00 AED,5.00,4.9000,0.1000,563952461,1579951,Success,United Arab Emirates,DU UAE,Transguard Group LLC,API User,E6AEAE17361
2022-02-14 20:32,72288137,"1,692.5960","1,658.2960",35.00 AED,35.00,34.3000,0.7000,563953037,1579960,Success,United Arab Emirates,DU UAE,Transguard Group LLC,API User,E6AEAE73954
2022-02-14 20:32,72288216,"1,658.2960","1,653.3960",05.00 AED,5.00,4.9000,0.1000,563953187,1579963,Success,United Arab Emirates,DU UAE,Transguard Group LLC,API User,E6AEAE17361
2022-02-14 20:32,72288298,"1,653.3960","1,648.4960",05.00 AED,5.00,4.9000,0.1000,563953360,1579966,Success,United Arab Emirates,DU UAE,Transguard Group LLC,API User,E6AEAE17361
2022-02-14 20:33,72288431,"1,648.4960","1,643.5960",05.00 AED,5.00,4.9000,0.1000,563953606,1579971,Success,United Arab Emirates,DU UAE,Transguard Group LLC,API User,E6AEAE17361
2022-02-14 20:36,72288898,"1,643.5960","1,633.7960",10.00 AED,10.00,9.8000,0.2000,563954675,1579975,Success,United Arab Emirates,DU UAE,Transguard Group LLC,API User,E6AEAE22430
2022-02-14 20:37,72289186,"1,633.7960","1,623.9960",10.00 AED,10.00,9.8000,0.2000,563955317,1579980,Success,United Arab Emirates,DU UAE,Transguard Group LLC,API User,E6AEAE22430
2022-02-14 20:37,72289190,"1,623.9960","1,619.0960",05.00 AED,5.00,4.9000,0.1000,563955336,1579981,Success,United Arab Emirates,DU UAE,Transguard Group LLC,API User,E6AEAE17361
2022-02-14 20:39,72289465,"1,619.0960","1,609.2960",10.00 AED,10.00,9.8000,0.2000,563955906,1579987,Success,United Arab Emirates,DU UAE,Transguard Group LLC,API User,E6AEAE22430
2022-02-14 20:43,72290435,"1,609.2960","1,604.8960",410.00 NGN,5.00,4.4000,0.6000,563957753,1579997,Success,Nigeria,Airtel Nigeria,Transguard Group LLC,API User,NG_ZA_TopUp
2022-02-14 20:47,72291176,"1,604.8960","1,599.9960",05.00 AED,5.00,4.9000,0.1000,563959208,1580009,Success,United Arab Emirates,DU UAE,Transguard Group LLC,API User,E6AEAE17361
2022-02-14 20:47,72291219,"1,599.9960","1,590.1960",10.00 AED,10.00,9.8000,0.2000,563959320,1580011,Success,United Arab Emirates,DU UAE,Transguard Group LLC,API User,E6AEAE22430
2022-02-14 20:49,72291661,"1,590.1960","1,585.2960",05.00 AED,5.00,4.9000,0.1000,563960206,1580015,Success,United Arab Emirates,DU UAE,Transguard Group LLC,API User,E6AEAE17361
2022-02-14 20:50,72291818,"1,585.2960","1,580.3960",05.00 AED,5.00,4.9000,0.1000,563960567,1580019,Success,United Arab Emirates,DU UAE,Transguard Group LLC,API User,E6AEAE17361
2022-02-14 20:50,72291918,"1,580.3960","1,575.4960",05.00 AED,5.00,4.9000,0.1000,563960734,1580022,Success,United Arab Emirates,DU UAE,Transguard Group LLC,API User,E6AEAE17361
2022-02-14 20:52,72292140,"1,575.4960","1,570.5960",05.00 AED,5.00,4.9000,0.1000,563961174,1580028,Success,United Arab Emirates,DU UAE,Transguard Group LLC,API User,E6AEAE17361
2022-02-14 20:52,72292260,"1,570.5960","1,560.7960",10.00 AED,10.00,9.8000,0.2000,563961403,1580031,Success,United Arab Emirates,DU UAE,Transguard Group LLC,API User,E6AEAE22430
2022-02-14 20:53,72292510,"1,560.7960","1,555.8960",05.00 AED,5.00,4.9000,0.1000,563961917,1580035,Success,United Arab Emirates,DU UAE,Transguard Group LLC,API User,E6AEAE17361
2022-02-14 20:58,72293354,"1,555.8960","1,550.9960",05.00 AED,5.00,4.9000,0.1000,563963652,1580048,Success,United Arab Emirates,DU UAE,Transguard Group LLC,API User,E6AEAE17361
2022-02-14 20:58,72293488,"1,550.9960","1,546.0960",05.00 AED,5.00,4.9000,0.1000,563963910,1580055,Success,United Arab Emirates,DU UAE,Transguard Group LLC,API User,E6AEAE17361
2022-02-14 20:58,72293504,"1,546.0960","1,536.2960",10.00 AED,10.00,9.8000,0.2000,563963946,1580056,Failure,United Arab Emirates,DU UAE,Transguard Group LLC,API User,E6AEAE22430
2022-02-14 20:58,72293504,"1,536.2960","1,526.4960",10.00 AED,10.00,9.8000,0.2000,563963946,1580056,Failure,United Arab Emirates,DU UAE,Transguard Group LLC,API User,E6AEAE22430
2022-02-14 20:59,72293632,"1,546.0960","1,526.4960",20.00 AED,20.00,19.6000,0.4000,563964170,1580059,Success,United Arab Emirates,DU UAE,Transguard Group LLC,API User,E6AEAE12938
2022-02-14 21:01,72294111,"1,526.4960","1,516.6960",10.00 AED,10.00,9.8000,0.2000,563965161,1580066,Success,United Arab Emirates,DU UAE,Transguard Group LLC,API User,E6AEAE22430
2022-02-14 21:05,72294760,"1,516.6960","1,511.7960",05.00 AED,5.00,4.9000,0.1000,563966420,1580074,Success,United Arab Emirates,DU UAE,Transguard Group LLC,API User,E6AEAE17361
2022-02-14 21:07,72295203,"1,511.7960","1,506.8960",05.00 AED,5.00,4.9000,0.1000,563967293,1580077,Success,United Arab Emirates,DU UAE,Transguard Group LLC,API User,E6AEAE17361
2022-02-14 21:09,72295689,"1,506.8960","1,497.0960",10.00 AED,10.00,9.8000,0.2000,563968189,1580085,Success,United Arab Emirates,DU UAE,Transguard Group LLC,API User,E6AEAE22430
2022-02-14 21:10,72295948,"1,497.0960","1,492.1960",05.00 AED,5.00,4.9000,0.1000,563968725,1580091,Success,United Arab Emirates,DU UAE,Transguard Group LLC,API User,E6AEAE17361
2022-02-14 21:10,72295988,"1,492.1960","1,482.3960",10.00 AED,10.00,9.8000,0.2000,563968812,1580094,Success,United Arab Emirates,DU UAE,Transguard Group LLC,API User,E6AEAE22430
2022-02-14 21:14,72296685,"1,482.3960","1,472.5960",10.00 AED,10.00,9.8000,0.2000,563970146,1580100,Success,United Arab Emirates,DU UAE,Transguard Group LLC,API User,E6AEAE22430
2022-02-14 21:15,72296854,"1,472.5960","1,467.6960",05.00 AED,5.00,4.9000,0.1000,563970477,1580103,Success,United Arab Emirates,DU UAE,Transguard Group LLC,API User,E6AEAE17361
2022-02-14 21:23,72298502,"1,467.6960","1,463.5160",150.00 PKR,4.75,4.1800,0.5700,563973829,1580120,Success,Pakistan,Zong Pakistan,Transguard Group LLC,API User,ZNPKPK65621
2022-02-14 21:24,72298678,"1,463.5160","1,458.6160",05.00 AED,5.00,4.9000,0.1000,563974191,1580127,Success,United Arab Emirates,DU UAE,Transguard Group LLC,API User,E6AEAE17361
2022-02-14 21:24,72298695,"1,458.6160","1,448.8160",10.00 AED,10.00,9.8000,0.2000,563974210,1580128,Success,United Arab Emirates,DU UAE,Transguard Group LLC,API User,E6AEAE22430
2022-02-14 21:24,72298739,"1,448.8160","1,439.0160",10.00 AED,10.00,9.8000,0.2000,563974307,1580131,Success,United Arab Emirates,DU UAE,Transguard Group LLC,API User,E6AEAE22430
2022-02-14 21:26,72299028,"1,439.0160","1,429.2160",10.00 AED,10.00,9.8000,0.2000,563974915,1580138,Success,United Arab Emirates,DU UAE,Transguard Group LLC,API User,E6AEAE22430
2022-02-14 21:30,72299777,"1,429.2160","1,424.3160",05.00 AED,5.00,4.9000,0.1000,563976409,1580150,Success,United Arab Emirates,DU UAE,Transguard Group LLC,API User,E6AEAE17361
2022-02-14 21:31,72300002,"1,424.3160","1,399.8160",25.00 AED,25.00,24.5000,0.5000,563976931,1580156,Success,United Arab Emirates,DU UAE,Transguard Group LLC,API User,E6AEAE17343
2022-02-14 21:35,72300657,"1,399.8160","1,390.0160",10.00 AED,10.00,9.8000,0.2000,563978219,1580166,Success,United Arab Emirates,DU UAE,Transguard Group LLC,API User,E6AEAE22430
2022-02-14 21:36,72300882,"1,390.0160","1,370.4160",20.00 AED,20.00,19.6000,0.4000,563978658,1580175,Success,United Arab Emirates,DU UAE,Transguard Group LLC,API User,E6AEAE12938
2022-02-14 21:36,72300890,"1,370.4160","1,360.6160",10.00 AED,10.00,9.8000,0.2000,563978670,1580177,Success,United Arab Emirates,DU UAE,Transguard Group LLC,API User,E6AEAE22430
2022-02-14 21:39,72301540,"1,360.6160","1,355.7160",05.00 AED,5.00,4.9000,0.1000,563979969,1580189,Success,United Arab Emirates,DU UAE,Transguard Group LLC,API User,E6AEAE17361
2022-02-14 21:42,72301986,"1,355.7160","1,341.0160",15.00 AED,15.00,14.7000,0.3000,563980940,1580195,Success,United Arab Emirates,DU UAE,Transguard Group LLC,API User,E6AEAE8527
2022-02-14 21:44,72302282,"1,341.0160","1,331.2160",10.00 AED,10.00,9.8000,0.2000,563981513,1580201,Success,United Arab Emirates,DU UAE,Transguard Group LLC,API User,E6AEAE22430
2022-02-14 21:46,72302668,"1,331.2160","1,296.9160",35.00 AED,35.00,34.3000,0.7000,563982233,1580208,Success,United Arab Emirates,DU UAE,Transguard Group LLC,API User,E6AEAE73954
2022-02-14 21:47,72302924,"1,296.9160","1,287.1160",10.00 AED,10.00,9.8000,0.2000,563982712,1580213,Success,United Arab Emirates,DU UAE,Transguard Group LLC,API User,E6AEAE22430
2022-02-14 21:47,72303004,"1,287.1160","1,267.5160",20.00 AED,20.00,19.6000,0.4000,563982888,1580215,Success,United Arab Emirates,DU UAE,Transguard Group LLC,API User,E6AEAE12938
2022-02-14 21:51,72303693,"1,267.5160","1,262.6160",05.00 AED,5.00,4.9000,0.1000,563984300,1580219,Success,United Arab Emirates,DU UAE,Transguard Group LLC,API User,E6AEAE17361
2022-02-14 21:52,72303750,"1,262.6160","1,255.3560",200.00 NPR,8.25,7.2600,0.9900,563984406,1580224,Success,Nepal,Nepal Telecom Nepal,Transguard Group LLC,API User,NP_NE_TopUp_200.00
2022-02-14 21:53,72303999,"1,255.3560","1,251.6160",100.00 NPR,4.25,3.7400,0.5100,563984915,1580229,Success,Nepal,Ncell Nepal,Transguard Group LLC,API User,NP_NC_TopUp_100.00
2022-02-14 21:55,72304379,"1,251.6160","1,246.7160",05.00 AED,5.00,4.9000,0.1000,563985646,1580237,Success,United Arab Emirates,DU UAE,Transguard Group LLC,API User,E6AEAE17361
2022-02-14 21:55,72304407,"1,246.7160","1,236.9160",10.00 AED,10.00,9.8000,0.2000,563985720,1580238,Success,United Arab Emirates,DU UAE,Transguard Group LLC,API User,E6AEAE22430
2022-02-14 22:01,72305416,"1,236.9160","1,232.0160",05.00 AED,5.00,4.9000,0.1000,563987706,1580248,Success,United Arab Emirates,DU UAE,Transguard Group LLC,API User,E6AEAE17361
2022-02-14 22:07,72306443,"1,232.0160","1,212.4160",20.00 AED,20.00,19.6000,0.4000,563989813,1580258,Success,United Arab Emirates,DU UAE,Transguard Group LLC,API User,E6AEAE12938
2022-02-14 22:10,72306885,"1,212.4160","1,207.5160",05.00 AED,5.00,4.9000,0.1000,563990711,1580265,Success,United Arab Emirates,DU UAE,Transguard Group LLC,API User,E6AEAE17361
2022-02-14 22:10,72306980,"1,207.5160","1,197.7160",10.00 AED,10.00,9.8000,0.2000,563990936,1580268,Success,United Arab Emirates,DU UAE,Transguard Group LLC,API User,E6AEAE22430
2022-02-14 22:10,72306996,"1,197.7160","1,178.1160",20.00 AED,20.00,19.6000,0.4000,563990971,1580269,Success,United Arab Emirates,DU UAE,Transguard Group LLC,API User,E6AEAE12938
2022-02-14 22:17,72308056,"1,178.1160","1,173.2160",05.00 AED,5.00,4.9000,0.1000,563993298,1580284,Success,United Arab Emirates,DU UAE,Transguard Group LLC,API User,E6AEAE17361
2022-02-14 22:17,72308108,"1,173.2160","1,168.3160",05.00 AED,5.00,4.9000,0.1000,563993421,1580287,Success,United Arab Emirates,DU UAE,Transguard Group LLC,API User,E6AEAE17361
2022-02-14 22:19,72308430,"1,168.3160","1,157.7560",179.00 INR,12.00,10.5600,1.4400,563994109,1580291,Success,India,Airtel India,Transguard Group LLC,API User,AIININ72188
2022-02-14 22:20,72308552,"1,157.7560","1,152.8560",05.00 AED,5.00,4.9000,0.1000,563994414,1580294,Success,United Arab Emirates,DU UAE,Transguard Group LLC,API User,E6AEAE17361
2022-02-14 22:29,72309825,"1,152.8560","1,143.0560",10.00 AED,10.00,9.8000,0.2000,563997083,1580303,Success,United Arab Emirates,DU UAE,Transguard Group LLC,API User,E6AEAE22430
2022-02-14 22:35,72310782,"1,143.0560","1,138.1560",05.00 AED,5.00,4.9000,0.1000,563999197,1580309,Success,United Arab Emirates,DU UAE,Transguard Group LLC,API User,E6AEAE17361
2022-02-14 22:40,72311557,"1,138.1560","1,134.4160",130.00 PKR,4.25,3.7400,0.5100,564000862,1580319,Success,Pakistan,Telenor Pakistan,Transguard Group LLC,API User,TPPKPK26966
2022-02-14 22:46,72312416,"1,134.4160","1,129.5160",05.00 AED,5.00,4.9000,0.1000,564002674,1580330,Success,United Arab Emirates,DU UAE,Transguard Group LLC,API User,E6AEAE17361
2022-02-14 22:48,72312665,"1,129.5160","1,124.6160",05.00 AED,5.00,4.9000,0.1000,564003187,1580333,Success,United Arab Emirates,DU UAE,Transguard Group LLC,API User,E6AEAE17361
2022-02-14 22:51,72313155,"1,124.6160","1,119.7160",05.00 AED,5.00,4.9000,0.1000,564004207,1580339,Success,United Arab Emirates,DU UAE,Transguard Group LLC,API User,E6AEAE17361
2022-02-14 23:00,72314509,"1,119.7160","1,114.8160",05.00 AED,5.00,4.9000,0.1000,564007052,1580347,Success,United Arab Emirates,DU UAE,Transguard Group LLC,API User,E6AEAE17361
2022-02-14 23:09,72315765,"1,114.8160","1,105.0160",10.00 AED,10.00,9.8000,0.2000,564009682,1580350,Success,United Arab Emirates,DU UAE,Transguard Group LLC,API User,E6AEAE22430
2022-02-14 23:10,72315816,"1,105.0160","1,100.1160",05.00 AED,5.00,4.9000,0.1000,564009827,1580353,Success,United Arab Emirates,DU UAE,Transguard Group LLC,API User,E6AEAE17361
2022-02-14 23:12,72316082,"1,100.1160","1,095.2160",05.00 AED,5.00,4.9000,0.1000,564010431,1580356,Success,United Arab Emirates,DU UAE,Transguard Group LLC,API User,E6AEAE17361
2022-02-14 23:13,72316325,"1,095.2160","1,090.3160",05.00 AED,5.00,4.9000,0.1000,564010932,1580359,Success,United Arab Emirates,DU UAE,Transguard Group LLC,API User,E6AEAE17361
2022-02-14 23:20,72317184,"1,090.3160","1,085.4160",05.00 AED,5.00,4.9000,0.1000,564012846,1580364,Success,United Arab Emirates,DU UAE,Transguard Group LLC,API User,E6AEAE17361
2022-02-14 23:21,72317280,"1,085.4160","1,081.6760",100.00 NPR,4.25,3.7400,0.5100,564013050,1580367,Success,Nepal,Ncell Nepal,Transguard Group LLC,API User,NP_NC_TopUp_100.00
2022-02-14 23:25,72317687,"1,081.6760","1,062.0760",20.00 AED,20.00,19.6000,0.4000,564013992,1580370,Success,United Arab Emirates,DU UAE,Transguard Group LLC,API User,E6AEAE12938
2022-02-14 23:28,72318176,"1,062.0760","1,057.1760",05.00 AED,5.00,4.9000,0.1000,564015021,1580373,Success,United Arab Emirates,DU UAE,Transguard Group LLC,API User,E6AEAE17361
2022-02-14 23:40,72319608,"1,057.1760","1,052.2760",05.00 AED,5.00,4.9000,0.1000,564018065,1580378,Success,United Arab Emirates,DU UAE,Transguard Group LLC,API User,E6AEAE17361
2022-02-14 23:46,72320446,"1,052.2760","1,047.3760",05.00 AED,5.00,4.9000,0.1000,564019945,1580384,Success,United Arab Emirates,DU UAE,Transguard Group LLC,API User,E6AEAE17361
2022-02-14 23:47,72320499,"1,047.3760","1,040.1160",200.00 NPR,8.25,7.2600,0.9900,564020067,1580386,Success,Nepal,Nepal Telecom Nepal,Transguard Group LLC,API User,NP_NE_TopUp_200.00
2022-02-14 23:59,72322031,"1,040.1160","1,030.3160",10.00 AED,10.00,9.8000,0.2000,564023156,1580397,Success,United Arab Emirates,DU UAE,Transguard Group LLC,API User,E6AEAE22430
2022-02-15 00:00,72322109,"1,030.3160","1,021.5160",13.20 GHS,10.00,8.8000,1.2000,564023295,1580399,Success,Ghana,MTN Ghana,Transguard Group LLC,API User,GH_MT_TopUp
2022-02-15 00:06,72322809,"1,021.5160","1,016.6160",05.00 AED,5.00,4.9000,0.1000,564024789,1580404,Success,United Arab Emirates,DU UAE,Transguard Group LLC,API User,E6AEAE17361
2022-02-15 00:07,72323012,"1,016.6160","1,011.7160",05.00 AED,5.00,4.9000,0.1000,564025199,1580407,Success,United Arab Emirates,DU UAE,Transguard Group LLC,API User,E6AEAE17361
2022-02-15 00:11,72323444,"1,011.7160",977.4160,35.00 AED,35.00,34.3000,0.7000,564026150,1580412,Success,United Arab Emirates,DU UAE,Transguard Group LLC,API User,E6AEAE73954
2022-02-15 00:28,72325297,977.4160,972.5160,05.00 AED,5.00,4.9000,0.1000,564030015,1580424,Success,United Arab Emirates,DU UAE,Transguard Group LLC,API User,E6AEAE17361
2022-02-15 00:29,72325471,972.5160,952.9160,20.00 AED,20.00,19.6000,0.4000,564030426,1580427,Success,United Arab Emirates,DU UAE,Transguard Group LLC,API User,E6AEAE12938
2022-02-15 00:55,72328333,952.9160,943.1160,10.00 AED,10.00,9.8000,0.2000,564036356,1580443,Success,United Arab Emirates,DU UAE,Transguard Group LLC,API User,E6AEAE22430
2022-02-15 01:02,72329123,943.1160,938.2160,05.00 AED,5.00,4.9000,0.1000,564038018,1580448,Success,United Arab Emirates,DU UAE,Transguard Group LLC,API User,E6AEAE17361
2022-02-15 01:16,72330573,938.2160,928.4160,10.00 AED,10.00,9.8000,0.2000,564041120,1580451,Success,United Arab Emirates,DU UAE,Transguard Group LLC,API User,E6AEAE22430
2022-02-15 01:25,72331507,928.4160,908.8160,20.00 AED,20.00,19.6000,0.4000,564043062,1580464,Success,United Arab Emirates,DU UAE,Transguard Group LLC,API User,E6AEAE12938
2022-02-15 01:39,72333174,908.8160,889.2160,20.00 AED,20.00,19.6000,0.4000,564046439,1580473,Success,United Arab Emirates,DU UAE,Transguard Group LLC,API User,E6AEAE12938
2022-02-15 01:57,72335194,889.2160,850.0160,40.00 AED,40.00,39.2000,0.8000,564050617,1580480,Success,United Arab Emirates,DU UAE,Transguard Group LLC,API User,E6AEAE64011
2022-02-15 01:58,72335293,850.0160,840.2160,10.00 AED,10.00,9.8000,0.2000,564050839,1580483,Success,United Arab Emirates,DU UAE,Transguard Group LLC,API User,E6AEAE22430
2022-02-15 02:09,72336563,840.2160,831.6360,315.00 PKR,9.75,8.5800,1.1700,564053558,1580486,Success,Pakistan,Zong Pakistan,Transguard Group LLC,API User,ZNPKPK29953
2022-02-15 02:27,72338581,831.6360,826.7360,05.00 AED,5.00,4.9000,0.1000,564057820,1580492,Failure,United Arab Emirates,DU UAE,Transguard Group LLC,API User,E6AEAE17361
2022-02-15 02:27,72338581,826.7360,821.8360,05.00 AED,5.00,4.9000,0.1000,564057820,1580492,Failure,United Arab Emirates,DU UAE,Transguard Group LLC,API User,E6AEAE17361
2022-02-15 02:29,72338799,831.6360,826.7360,05.00 AED,5.00,4.9000,0.1000,564058279,1580495,Success,United Arab Emirates,DU UAE,Transguard Group LLC,API User,E6AEAE17361
2022-02-15 02:31,72338973,826.7360,816.9360,10.00 AED,10.00,9.8000,0.2000,564058681,1580499,Success,United Arab Emirates,DU UAE,Transguard Group LLC,API User,E6AEAE22430
2022-02-15 02:41,72339914,816.9360,797.3360,20.00 AED,20.00,19.6000,0.4000,564060817,1580506,Success,United Arab Emirates,DU UAE,Transguard Group LLC,API User,E6AEAE12938
2022-02-15 02:45,72340421,797.3360,792.4360,05.00 AED,5.00,4.9000,0.1000,564062020,1580509,Success,United Arab Emirates,DU UAE,Transguard Group LLC,API User,E6AEAE17361
2022-02-15 02:55,72341370,792.4360,772.8360,20.00 AED,20.00,19.6000,0.4000,564064257,1580512,Success,United Arab Emirates,DU UAE,Transguard Group LLC,API User,E6AEAE12938
2022-02-15 03:00,72341832,772.8360,767.9360,05.00 AED,5.00,4.9000,0.1000,564065335,1580518,Success,United Arab Emirates,DU UAE,Transguard Group LLC,API User,E6AEAE17361
2022-02-15 03:20,72343845,767.9360,758.1360,10.00 AED,10.00,9.8000,0.2000,564069834,1580522,Success,United Arab Emirates,DU UAE,Transguard Group LLC,API User,E6AEAE22430
2022-02-15 03:44,72346191,758.1360,748.3360,10.00 AED,10.00,9.8000,0.2000,564075163,1580529,Success,United Arab Emirates,DU UAE,Transguard Group LLC,API User,E6AEAE22430
2022-02-15 03:51,72346927,748.3360,743.4360,05.00 AED,5.00,4.9000,0.1000,564076772,1580532,Success,United Arab Emirates,DU UAE,Transguard Group LLC,API User,E6AEAE17361
2022-02-15 04:00,72347837,743.4360,733.6360,10.00 AED,10.00,9.8000,0.2000,564078687,1580535,Success,United Arab Emirates,DU UAE,Transguard Group LLC,API User,E6AEAE22430
2022-02-15 04:16,72349471,733.6360,728.7360,05.00 AED,5.00,4.9000,0.1000,564082183,1580542,Success,United Arab Emirates,DU UAE,Transguard Group LLC,API User,E6AEAE17361
2022-02-15 04:22,72350066,728.7360,718.9360,10.00 AED,10.00,9.8000,0.2000,564083497,1580547,Success,United Arab Emirates,DU UAE,Transguard Group LLC,API User,E6AEAE22430
2022-02-15 04:28,72350762,718.9360,699.3360,20.00 AED,20.00,19.6000,0.4000,564084937,1580552,Success,United Arab Emirates,DU UAE,Transguard Group LLC,API User,E6AEAE12938
2022-02-15 04:53,72353091,699.3360,689.5360,10.00 AED,10.00,9.8000,0.2000,564089922,1580561,Success,United Arab Emirates,DU UAE,Transguard Group LLC,API User,E6AEAE22430
2022-02-15 04:54,72353206,689.5360,684.6360,05.00 AED,5.00,4.9000,0.1000,564090139,1580566,Success,United Arab Emirates,DU UAE,Transguard Group LLC,API User,E6AEAE17361
2022-02-15 05:00,72353799,684.6360,674.8360,10.00 AED,10.00,9.8000,0.2000,564091352,1580579,Success,United Arab Emirates,DU UAE,Transguard Group LLC,API User,E6AEAE22430
2022-02-15 05:05,72354347,674.8360,669.9360,05.00 AED,5.00,4.9000,0.1000,564092410,1580594,Success,United Arab Emirates,DU UAE,Transguard Group LLC,API User,E6AEAE17361
2022-02-15 05:18,72355510,669.9360,660.1360,10.00 AED,10.00,9.8000,0.2000,564094812,1580600,Success,United Arab Emirates,DU UAE,Transguard Group LLC,API User,E6AEAE22430
2022-02-15 05:30,72356707,660.1360,640.5360,20.00 AED,20.00,19.6000,0.4000,564097096,1580610,Success,United Arab Emirates,DU UAE,Transguard Group LLC,API User,E6AEAE12938
2022-02-15 05:35,72357157,640.5360,635.6360,05.00 AED,5.00,4.9000,0.1000,564097954,1580613,Success,United Arab Emirates,DU UAE,Transguard Group LLC,API User,E6AEAE17361
2022-02-15 05:36,72357296,635.6360,630.7360,05.00 AED,5.00,4.9000,0.1000,564098213,1580616,Success,United Arab Emirates,DU UAE,Transguard Group LLC,API User,E6AEAE17361
2022-02-15 05:38,72357450,630.7360,625.8360,05.00 AED,5.00,4.9000,0.1000,564098495,1580619,Success,United Arab Emirates,DU UAE,Transguard Group LLC,API User,E6AEAE17361
2022-02-15 05:42,72357804,625.8360,620.9360,05.00 AED,5.00,4.9000,0.1000,564099193,1580624,Success,United Arab Emirates,DU UAE,Transguard Group LLC,API User,E6AEAE17361
2022-02-15 05:42,72357846,620.9360,616.0360,05.00 AED,5.00,4.9000,0.1000,564099272,1580627,Success,United Arab Emirates,DU UAE,Transguard Group LLC,API User,E6AEAE17361
2022-02-15 05:44,72358009,616.0360,611.1360,05.00 AED,5.00,4.9000,0.1000,564099594,1580632,Success,United Arab Emirates,DU UAE,Transguard Group LLC,API User,E6AEAE17361
2022-02-15 05:48,72358267,611.1360,606.2360,05.00 AED,5.00,4.9000,0.1000,564100169,1580637,Success,United Arab Emirates,DU UAE,Transguard Group LLC,API User,E6AEAE17361
2022-02-15 05:55,72358904,606.2360,601.3360,05.00 AED,5.00,4.9000,0.1000,564101508,1580652,Success,United Arab Emirates,DU UAE,Transguard Group LLC,API User,E6AEAE17361
2022-02-15 06:01,72359432,601.3360,591.5360,10.00 AED,10.00,9.8000,0.2000,564102535,1580658,Success,United Arab Emirates,DU UAE,Transguard Group LLC,API User,E6AEAE22430
2022-02-15 06:07,72359939,591.5360,552.3360,40.00 AED,40.00,39.2000,0.8000,564103566,1580663,Success,United Arab Emirates,DU UAE,Transguard Group LLC,API User,E6AEAE64011
2022-02-15 06:10,72360152,552.3360,547.4360,05.00 AED,5.00,4.9000,0.1000,564104007,1580668,Success,United Arab Emirates,DU UAE,Transguard Group LLC,API User,E6AEAE17361
2022-02-15 06:11,72360224,547.4360,542.5360,05.00 AED,5.00,4.9000,0.1000,564104173,1580672,Success,United Arab Emirates,DU UAE,Transguard Group LLC,API User,E6AEAE17361
2022-02-15 06:12,72360270,542.5360,537.6360,05.00 AED,5.00,4.9000,0.1000,564104264,1580675,Success,United Arab Emirates,DU UAE,Transguard Group LLC,API User,E6AEAE17361
2022-02-15 06:21,72360945,537.6360,527.8360,10.00 AED,10.00,9.8000,0.2000,564105636,1580682,Success,United Arab Emirates,DU UAE,Transguard Group LLC,API User,E6AEAE22430
2022-02-15 06:25,72361284,527.8360,522.9360,05.00 AED,5.00,4.9000,0.1000,564106287,1580686,Success,United Arab Emirates,DU UAE,Transguard Group LLC,API User,E6AEAE17361
2022-02-15 06:33,72361862,522.9360,518.0360,05.00 AED,5.00,4.9000,0.1000,564107457,1580695,Success,United Arab Emirates,DU UAE,Transguard Group LLC,API User,E6AEAE17361
2022-02-15 06:35,72362019,518.0360,513.1360,05.00 AED,5.00,4.9000,0.1000,564107831,1580704,Success,United Arab Emirates,DU UAE,Transguard Group LLC,API User,E6AEAE17361
2022-02-15 06:36,72362040,513.1360,493.5360,20.00 AED,20.00,19.6000,0.4000,564107873,1580707,Success,United Arab Emirates,DU UAE,Transguard Group LLC,API User,E6AEAE12938
2022-02-15 06:38,72362206,493.5360,488.6360,05.00 AED,5.00,4.9000,0.1000,564108234,1580713,Success,United Arab Emirates,DU UAE,Transguard Group LLC,API User,E6AEAE17361
2022-02-15 06:39,72362311,488.6360,478.8360,10.00 AED,10.00,9.8000,0.2000,564108437,1580719,Success,United Arab Emirates,DU UAE,Transguard Group LLC,API User,E6AEAE22430
2022-02-15 06:41,72362449,478.8360,469.0360,10.00 AED,10.00,9.8000,0.2000,564108722,1580725,Success,United Arab Emirates,DU UAE,Transguard Group LLC,API User,E6AEAE22430
2022-02-15 06:41,72362461,469.0360,464.1360,05.00 AED,5.00,4.9000,0.1000,564108746,1580726,Success,United Arab Emirates,DU UAE,Transguard Group LLC,API User,E6AEAE17361
2022-02-15 06:48,72362890,464.1360,454.3360,10.00 AED,10.00,9.8000,0.2000,564109696,1580737,Success,United Arab Emirates,DU UAE,Transguard Group LLC,API User,E6AEAE22430
2022-02-15 06:53,72363186,454.3360,449.4360,05.00 AED,5.00,4.9000,0.1000,564110320,1580744,Success,United Arab Emirates,DU UAE,Transguard Group LLC,API User,E6AEAE17361
2022-02-15 06:54,72363283,449.4360,444.5360,05.00 AED,5.00,4.9000,0.1000,564110513,1580749,Success,United Arab Emirates,DU UAE,Transguard Group LLC,API User,E6AEAE17361
2022-02-15 06:57,72363451,444.5360,434.7360,10.00 AED,10.00,9.8000,0.2000,564110852,1580755,Success,United Arab Emirates,DU UAE,Transguard Group LLC,API User,E6AEAE22430
2022-02-15 07:00,72363619,434.7360,430.3360,50.00 PHP,5.00,4.4000,0.6000,564111197,1580763,Success,Philippines,BS_Globe Philippines,Transguard Group LLC,API User,PH_GB_TopUp_50.00
2022-02-15 07:01,72363694,430.3360,422.1960,300.00 PKR,9.25,8.1400,1.1100,564111359,1580766,Success,Pakistan,Zong Pakistan,Transguard Group LLC,API User,ZNPKPK70504
2022-02-15 07:04,72363913,422.1960,412.3960,10.00 AED,10.00,9.8000,0.2000,564111768,1580769,Success,United Arab Emirates,DU UAE,Transguard Group LLC,API User,E6AEAE22430
2022-02-15 07:07,72364139,412.3960,402.5960,10.00 AED,10.00,9.8000,0.2000,564112175,1580772,Success,United Arab Emirates,DU UAE,Transguard Group LLC,API User,E6AEAE22430
2022-02-15 07:09,72364284,402.5960,397.6960,05.00 AED,5.00,4.9000,0.1000,564112448,1580775,Success,United Arab Emirates,DU UAE,Transguard Group LLC,API User,E6AEAE17361
2022-02-15 07:13,72364505,397.6960,392.7960,05.00 AED,5.00,4.9000,0.1000,564112877,1580785,Success,United Arab Emirates,DU UAE,Transguard Group LLC,API User,E6AEAE17361
2022-02-15 07:15,72364635,392.7960,387.8960,05.00 AED,5.00,4.9000,0.1000,564113114,1580788,Success,United Arab Emirates,DU UAE,Transguard Group LLC,API User,E6AEAE17361
2022-02-15 07:18,72364847,387.8960,378.0960,10.00 AED,10.00,9.8000,0.2000,564113553,1580796,Success,United Arab Emirates,DU UAE,Transguard Group LLC,API User,E6AEAE22430
2022-02-15 07:18,72364862,378.0960,373.1960,05.00 AED,5.00,4.9000,0.1000,564113587,1580799,Success,United Arab Emirates,DU UAE,Transguard Group LLC,API User,E6AEAE17361
2022-02-15 07:20,72364960,373.1960,363.3960,10.00 AED,10.00,9.8000,0.2000,564113806,1580808,Success,United Arab Emirates,DU UAE,Transguard Group LLC,API User,E6AEAE22430
2022-02-15 07:21,72364997,363.3960,358.4960,05.00 AED,5.00,4.9000,0.1000,564113877,1580811,Success,United Arab Emirates,DU UAE,Transguard Group LLC,API User,E6AEAE17361
2022-02-15 07:23,72365159,358.4960,353.5960,05.00 AED,5.00,4.9000,0.1000,564114196,1580814,Success,United Arab Emirates,DU UAE,Transguard Group LLC,API User,E6AEAE17361
2022-02-15 07:30,72365486,353.5960,348.6960,05.00 AED,5.00,4.9000,0.1000,564114947,1580828,Success,United Arab Emirates,DU UAE,Transguard Group LLC,API User,E6AEAE17361
2022-02-15 07:33,72365674,348.6960,338.8960,10.00 AED,10.00,9.8000,0.2000,564115336,1580833,Success,United Arab Emirates,DU UAE,Transguard Group LLC,API User,E6AEAE22430
2022-02-15 07:36,72365831,338.8960,333.9960,05.00 AED,5.00,4.9000,0.1000,564115709,1580838,Success,United Arab Emirates,DU UAE,Transguard Group LLC,API User,E6AEAE17361
2022-02-15 07:36,72365850,333.9960,329.5960,48.55 ETB,5.00,4.4000,0.6000,564115752,1580843,Success,Ethiopia,Ethio Telecom Ethiopia,Transguard Group LLC,API User,BHETET55310
2022-02-15 07:37,72365882,329.5960,285.4960,45.00 AED,45.00,44.1000,0.9000,564115811,1580845,Success,United Arab Emirates,DU UAE,Transguard Group LLC,API User,E6AEAE35243
2022-02-15 07:37,72365924,285.4960,281.0960,48.55 ETB,5.00,4.4000,0.6000,564115904,1580849,Success,Ethiopia,Ethio Telecom Ethiopia,Transguard Group LLC,API User,BHETET55310
2022-02-15 07:38,72365971,281.0960,261.4960,20.00 AED,20.00,19.6000,0.4000,564116000,1580854,Success,United Arab Emirates,DU UAE,Transguard Group LLC,API User,E6AEAE12938
2022-02-15 07:38,72365979,261.4960,256.5960,05.00 AED,5.00,4.9000,0.1000,564116013,1580856,Success,United Arab Emirates,DU UAE,Transguard Group LLC,API User,E6AEAE17361
2022-02-15 07:39,72366021,256.5960,251.6960,05.00 AED,5.00,4.9000,0.1000,564116096,1580860,Success,United Arab Emirates,DU UAE,Transguard Group LLC,API User,E6AEAE17361
2022-02-15 07:40,72366083,251.6960,241.8960,10.00 AED,10.00,9.8000,0.2000,564116234,1580865,Success,United Arab Emirates,DU UAE,Transguard Group LLC,API User,E6AEAE22430
2022-02-15 07:42,72366206,241.8960,232.0960,10.00 AED,10.00,9.8000,0.2000,564116495,1580875,Success,United Arab Emirates,DU UAE,Transguard Group LLC,API User,E6AEAE22430
2022-02-15 07:47,72366422,232.0960,222.2960,10.00 AED,10.00,9.8000,0.2000,564117001,1580884,Success,United Arab Emirates,DU UAE,Transguard Group LLC,API User,E6AEAE22430
2022-02-15 07:49,72366519,222.2960,212.4960,10.00 AED,10.00,9.8000,0.2000,564117227,1580887,Success,United Arab Emirates,DU UAE,Transguard Group LLC,API User,E6AEAE22430
2022-02-15 07:54,72366777,212.4960,207.5960,05.00 AED,5.00,4.9000,0.1000,564117778,1580894,Success,United Arab Emirates,DU UAE,Transguard Group LLC,API User,E6AEAE17361
2022-02-15 07:58,72366978,207.5960,197.7960,10.00 AED,10.00,9.8000,0.2000,564118241,1580897,Success,United Arab Emirates,DU UAE,Transguard Group LLC,API User,E6AEAE22430
2022-02-15 07:59,72367031,197.7960,192.8960,05.00 AED,5.00,4.9000,0.1000,564118355,1580900,Success,United Arab Emirates,DU UAE,Transguard Group LLC,API User,E6AEAE17361
2022-02-15 08:02,72367156,192.8960,183.0960,10.00 AED,10.00,9.8000,0.2000,564118650,1580909,Success,United Arab Emirates,DU UAE,Transguard Group LLC,API User,E6AEAE22430
2022-02-15 08:11,72367611,183.0960,178.1960,05.00 AED,5.00,4.9000,0.1000,564119665,1580920,Success,United Arab Emirates,DU UAE,Transguard Group LLC,API User,E6AEAE17361
2022-02-15 08:13,72367696,178.1960,173.2960,05.00 AED,5.00,4.9000,0.1000,564119847,1580932,Success,United Arab Emirates,DU UAE,Transguard Group LLC,API User,E6AEAE17361
2022-02-15 08:15,72367801,173.2960,163.4960,10.00 AED,10.00,9.8000,0.2000,564120076,1580942,Success,United Arab Emirates,DU UAE,Transguard Group LLC,API User,E6AEAE22430
2022-02-15 08:16,72367812,163.4960,153.6960,10.00 AED,10.00,9.8000,0.2000,564120099,1580945,Success,United Arab Emirates,DU UAE,Transguard Group LLC,API User,E6AEAE22430
2022-02-15 08:18,72367933,153.6960,148.7960,05.00 AED,5.00,4.9000,0.1000,564120349,1580953,Success,United Arab Emirates,DU UAE,Transguard Group LLC,API User,E6AEAE17361
2022-02-15 08:18,72367945,148.7960,138.9960,10.00 AED,10.00,9.8000,0.2000,564120369,1580955,Success,United Arab Emirates,DU UAE,Transguard Group LLC,API User,E6AEAE22430
2022-02-15 08:18,72367957,138.9960,134.0960,05.00 AED,5.00,4.9000,0.1000,564120404,1580957,Success,United Arab Emirates,DU UAE,Transguard Group LLC,API User,E6AEAE17361
2022-02-15 08:20,72368021,134.0960,129.1960,05.00 AED,5.00,4.9000,0.1000,564120565,1580961,Success,United Arab Emirates,DU UAE,Transguard Group LLC,API User,E6AEAE17361
2022-02-15 08:24,72368180,129.1960,124.2960,05.00 AED,5.00,4.9000,0.1000,564120897,1580976,Success,United Arab Emirates,DU UAE,Transguard Group LLC,API User,E6AEAE17361
2022-02-15 08:24,72368192,124.2960,114.4960,10.00 AED,10.00,9.8000,0.2000,564120916,1580978,Success,United Arab Emirates,DU UAE,Transguard Group LLC,API User,E6AEAE22430
2022-02-15 08:29,72368420,114.4960,109.5960,05.00 AED,5.00,4.9000,0.1000,564121416,1580991,Success,United Arab Emirates,DU UAE,Transguard Group LLC,API User,E6AEAE17361
2022-02-15 08:31,72368539,109.5960,99.7960,10.00 AED,10.00,9.8000,0.2000,564121660,1581000,Success,United Arab Emirates,DU UAE,Transguard Group LLC,API User,E6AEAE22430
2022-02-15 08:33,72368639,99.7960,89.9960,10.00 AED,10.00,9.8000,0.2000,564121857,1581008,Success,United Arab Emirates,DU UAE,Transguard Group LLC,API User,E6AEAE22430
2022-02-15 08:35,72368757,89.9960,85.0960,05.00 AED,5.00,4.9000,0.1000,564122110,1581012,Success,United Arab Emirates,DU UAE,Transguard Group LLC,API User,E6AEAE17361
2022-02-15 08:40,72368953,85.0960,76.7360,100.00 PHP,9.50,8.3600,1.1400,564122586,1581017,Success,Philippines,Smart (SunCellular) Philippines,Transguard Group LLC,API User,PH_SM_TopUp_100.00
2022-02-15 08:42,72369036,76.7360,71.8360,05.00 AED,5.00,4.9000,0.1000,564122772,1581022,Success,United Arab Emirates,DU UAE,Transguard Group LLC,API User,E6AEAE17361
2022-02-15 08:47,72369262,71.8360,66.9360,05.00 AED,5.00,4.9000,0.1000,564123299,1581030,Success,United Arab Emirates,DU UAE,Transguard Group LLC,API User,E6AEAE17361
2022-02-15 08:48,72369301,66.9360,62.0360,05.00 AED,5.00,4.9000,0.1000,564123389,1581034,Success,United Arab Emirates,DU UAE,Transguard Group LLC,API User,E6AEAE17361
2022-02-15 08:49,72369358,62.0360,57.1360,05.00 AED,5.00,4.9000,0.1000,564123513,1581038,Success,United Arab Emirates,DU UAE,Transguard Group LLC,API User,E6AEAE17361
2022-02-15 08:50,72369404,57.1360,47.3360,10.00 AED,10.00,9.8000,0.2000,564123621,1581041,Success,United Arab Emirates,DU UAE,Transguard Group LLC,API User,E6AEAE22430
2022-02-15 08:51,72369467,47.3360,42.4360,05.00 AED,5.00,4.9000,0.1000,564123762,1581048,Success,United Arab Emirates,DU UAE,Transguard Group LLC,API User,E6AEAE17361
2022-02-15 08:57,72369701,42.4360,32.6360,10.00 AED,10.00,9.8000,0.2000,564124323,1581063,Success,United Arab Emirates,DU UAE,Transguard Group LLC,API User,E6AEAE22430
2022-02-15 08:57,72369714,32.6360,27.7360,05.00 AED,5.00,4.9000,0.1000,564124345,1581065,Success,United Arab Emirates,DU UAE,Transguard Group LLC,API User,E6AEAE17361
2022-02-15 09:01,72369857,27.7360,17.9360,10.00 AED,10.00,9.8000,0.2000,564124681,72369857,Success,United Arab Emirates,DU UAE,Transguard Group LLC,mohammed.arafath@transguardgroup.com,E6AEAE22430
2022-02-15 09:01,72369878,17.9360,8.1360,10.00 AED,10.00,9.8000,0.2000,564124738,1581073,Success,United Arab Emirates,DU UAE,Transguard Group LLC,API User,E6AEAE22430
2022-02-15 09:03,72369933,8.1360,3.2360,05.00 AED,5.00,4.9000,0.1000,564124876,1581076,Success,United Arab Emirates,DU UAE,Transguard Group LLC,API User,E6AEAE17361
2022-02-15 10:21,72372953,"21,737.7460","21,727.9460",10.00 AED,10.00,9.8000,0.2000,564131966,1581331,Success,United Arab Emirates,DU UAE,Transguard Group LLC,API User,E6AEAE22430
2022-02-15 10:23,72373022,"21,727.9460","21,718.1460",10.00 AED,10.00,9.8000,0.2000,564132143,1581337,Success,United Arab Emirates,DU UAE,Transguard Group LLC,API User,E6AEAE22430
2022-02-15 10:23,72373026,"21,718.1460","21,713.2460",05.00 AED,5.00,4.9000,0.1000,564132155,1581338,Success,United Arab Emirates,DU UAE,Transguard Group LLC,API User,E6AEAE17361
2022-02-15 10:24,72373061,"21,713.2460","21,708.3460",05.00 AED,5.00,4.9000,0.1000,564132242,1581344,Success,United Arab Emirates,DU UAE,Transguard Group LLC,API User,E6AEAE17361
2022-02-15 10:29,72373234,"21,708.3460","21,703.4460",05.00 AED,5.00,4.9000,0.1000,564132636,1581354,Success,United Arab Emirates,DU UAE,Transguard Group LLC,API User,E6AEAE17361
2022-02-15 10:33,72373372,"21,703.4460","21,693.6460",10.00 AED,10.00,9.8000,0.2000,564133004,1581362,Success,United Arab Emirates,DU UAE,Transguard Group LLC,API User,E6AEAE22430
2022-02-15 10:34,72373420,"21,693.6460","21,688.7460",05.00 AED,5.00,4.9000,0.1000,564133116,1581366,Success,United Arab Emirates,DU UAE,Transguard Group LLC,API User,E6AEAE17361
2022-02-15 10:51,72374070,"21,688.7460","21,683.8460",05.00 AED,5.00,4.9000,0.1000,564134662,1581397,Success,United Arab Emirates,DU UAE,Transguard Group LLC,API User,E6AEAE17361
2022-02-15 10:54,72374142,"21,683.8460","21,678.9460",05.00 AED,5.00,4.9000,0.1000,564134850,1581400,Success,United Arab Emirates,DU UAE,Transguard Group LLC,API User,E6AEAE17361
2022-02-15 10:57,72374305,"21,678.9460","21,674.0460",05.00 AED,5.00,4.9000,0.1000,564135173,1581410,Success,United Arab Emirates,DU UAE,Transguard Group LLC,API User,E6AEAE17361
2022-02-15 10:57,72374308,"21,674.0460","21,664.2460",10.00 AED,10.00,9.8000,0.2000,564135178,1581411,Success,United Arab Emirates,DU UAE,Transguard Group LLC,API User,E6AEAE22430
2022-02-15 10:57,72374325,"21,664.2460","21,654.4460",10.00 AED,10.00,9.8000,0.2000,564135218,1581414,Success,United Arab Emirates,DU UAE,Transguard Group LLC,API User,E6AEAE22430
2022-02-15 10:58,72374365,"21,654.4460","21,649.5460",05.00 AED,5.00,4.9000,0.1000,564135304,1581418,Success,United Arab Emirates,DU UAE,Transguard Group LLC,API User,E6AEAE17361
2022-02-15 11:02,72374483,"21,649.5460","21,644.6460",05.00 AED,5.00,4.9000,0.1000,564135614,1581433,Success,United Arab Emirates,DU UAE,Transguard Group LLC,API User,E6AEAE17361
2022-02-15 11:02,72374489,"21,644.6460","21,634.8460",10.00 AED,10.00,9.8000,0.2000,564135632,1581434,Success,United Arab Emirates,DU UAE,Transguard Group LLC,API User,E6AEAE22430
2022-02-15 11:03,72374540,"21,634.8460","21,625.0460",10.00 AED,10.00,9.8000,0.2000,564135739,1581438,Success,United Arab Emirates,DU UAE,Transguard Group LLC,API User,E6AEAE22430
2022-02-15 11:04,72374564,"21,625.0460","21,620.1460",05.00 AED,5.00,4.9000,0.1000,564135811,1581443,Success,United Arab Emirates,DU UAE,Transguard Group LLC,API User,E6AEAE17361
2022-02-15 11:04,72374568,"21,620.1460","21,616.4060",100.00 NPR,4.25,3.7400,0.5100,564135820,1581444,Success,Nepal,Ncell Nepal,Transguard Group LLC,API User,NP_NC_TopUp_100.00
2022-02-15 11:06,72374650,"21,616.4060","21,611.5060",05.00 AED,5.00,4.9000,0.1000,564136010,1581447,Success,United Arab Emirates,DU UAE,Transguard Group LLC,API User,E6AEAE17361
2022-02-15 11:10,72374812,"21,611.5060","21,606.6060",05.00 AED,5.00,4.9000,0.1000,564136344,1581451,Success,United Arab Emirates,DU UAE,Transguard Group LLC,API User,E6AEAE17361
2022-02-15 11:10,72374829,"21,606.6060","21,596.8060",10.00 AED,10.00,9.8000,0.2000,564136391,1581457,Success,United Arab Emirates,DU UAE,Transguard Group LLC,API User,E6AEAE22430
2022-02-15 11:13,72374918,"21,596.8060","21,591.9060",05.00 AED,5.00,4.9000,0.1000,564136635,1581463,Success,United Arab Emirates,DU UAE,Transguard Group LLC,API User,E6AEAE17361
2022-02-15 11:13,72374927,"21,591.9060","21,587.0060",05.00 AED,5.00,4.9000,0.1000,564136650,1581465,Success,United Arab Emirates,DU UAE,Transguard Group LLC,API User,E6AEAE17361
2022-02-15 11:15,72374976,"21,587.0060","21,582.1060",05.00 AED,5.00,4.9000,0.1000,564136787,1581471,Success,United Arab Emirates,DU UAE,Transguard Group LLC,API User,E6AEAE17361
2022-02-15 11:16,72375004,"21,582.1060","21,572.3060",10.00 AED,10.00,9.8000,0.2000,564136849,1581474,Success,United Arab Emirates,DU UAE,Transguard Group LLC,API User,E6AEAE22430
2022-02-15 11:18,72375091,"21,572.3060","21,567.4060",05.00 AED,5.00,4.9000,0.1000,564137060,1581479,Success,United Arab Emirates,DU UAE,Transguard Group LLC,API User,E6AEAE17361
2022-02-15 11:19,72375104,"21,567.4060","21,562.5060",05.00 AED,5.00,4.9000,0.1000,564137102,1581481,Success,United Arab Emirates,DU UAE,Transguard Group LLC,API User,E6AEAE17361
2022-02-15 11:25,72375338,"21,562.5060","21,552.7060",10.00 AED,10.00,9.8000,0.2000,564137646,1581491,Success,United Arab Emirates,DU UAE,Transguard Group LLC,API User,E6AEAE22430
2022-02-15 11:31,72375585,"21,552.7060","21,542.9060",10.00 AED,10.00,9.8000,0.2000,564138213,1581499,Success,United Arab Emirates,DU UAE,Transguard Group LLC,API User,E6AEAE22430
2022-02-15 11:31,72375591,"21,542.9060","21,538.0060",05.00 AED,5.00,4.9000,0.1000,564138228,1581502,Success,United Arab Emirates,DU UAE,Transguard Group LLC,API User,E6AEAE17361
2022-02-15 11:32,72375628,"21,538.0060","21,533.1060",05.00 AED,5.00,4.9000,0.1000,564138341,1581508,Success,United Arab Emirates,DU UAE,Transguard Group LLC,API User,E6AEAE17361
2022-02-15 11:32,72375634,"21,533.1060","21,523.3060",10.00 AED,10.00,9.8000,0.2000,564138349,1581510,Success,United Arab Emirates,DU UAE,Transguard Group LLC,API User,E6AEAE22430
2022-02-15 11:33,72375664,"21,523.3060","21,518.4060",05.00 AED,5.00,4.9000,0.1000,564138426,1581516,Success,United Arab Emirates,DU UAE,Transguard Group LLC,API User,E6AEAE17361
2022-02-15 11:33,72375666,"21,518.4060","21,514.2260",150.00 PKR,4.75,4.1800,0.5700,564138428,1581518,Success,Pakistan,Zong Pakistan,Transguard Group LLC,API User,ZNPKPK65621
2022-02-15 11:34,72375681,"21,514.2260","21,509.3260",05.00 AED,5.00,4.9000,0.1000,564138462,1581520,Success,United Arab Emirates,DU UAE,Transguard Group LLC,API User,E6AEAE17361
2022-02-15 11:35,72375739,"21,509.3260","21,504.4260",05.00 AED,5.00,4.9000,0.1000,564138579,1581529,Success,United Arab Emirates,DU UAE,Transguard Group LLC,API User,E6AEAE17361
2022-02-15 11:35,72375741,"21,504.4260","21,494.6260",10.00 AED,10.00,9.8000,0.2000,564138583,1581530,Success,United Arab Emirates,DU UAE,Transguard Group LLC,API User,E6AEAE22430
2022-02-15 11:35,72375759,"21,494.6260","21,484.8260",10.00 AED,10.00,9.8000,0.2000,564138611,1581533,Success,United Arab Emirates,DU UAE,Transguard Group LLC,API User,E6AEAE22430
2022-02-15 11:35,72375772,"21,484.8260","21,479.9260",05.00 AED,5.00,4.9000,0.1000,564138634,1581535,Success,United Arab Emirates,DU UAE,Transguard Group LLC,API User,E6AEAE17361
2022-02-15 11:36,72375809,"21,479.9260","21,465.2260",15.00 AED,15.00,14.7000,0.3000,564138727,1581541,Success,United Arab Emirates,DU UAE,Transguard Group LLC,API User,E6AEAE8527
2022-02-15 11:37,72375818,"21,465.2260","21,460.3260",05.00 AED,5.00,4.9000,0.1000,564138755,1581543,Success,United Arab Emirates,DU UAE,Transguard Group LLC,API User,E6AEAE17361
2022-02-15 11:40,72375963,"21,460.3260","21,455.4260",05.00 AED,5.00,4.9000,0.1000,564139086,1581550,Success,United Arab Emirates,DU UAE,Transguard Group LLC,API User,E6AEAE17361
2022-02-15 11:41,72375991,"21,455.4260","21,450.5260",05.00 AED,5.00,4.9000,0.1000,564139152,1581553,Success,United Arab Emirates,DU UAE,Transguard Group LLC,API User,E6AEAE17361
2022-02-15 11:41,72376017,"21,450.5260","21,445.6260",05.00 AED,5.00,4.9000,0.1000,564139208,1581561,Success,United Arab Emirates,DU UAE,Transguard Group LLC,API User,E6AEAE17361
2022-02-15 11:41,72376020,"21,445.6260","21,435.8260",10.00 AED,10.00,9.8000,0.2000,564139211,1581562,Success,United Arab Emirates,DU UAE,Transguard Group LLC,API User,E6AEAE22430
2022-02-15 11:41,72376021,"21,435.8260","21,430.9260",05.00 AED,5.00,4.9000,0.1000,564139212,1581563,Success,United Arab Emirates,DU UAE,Transguard Group LLC,API User,E6AEAE17361
2022-02-15 11:44,72376151,"21,430.9260","21,421.1260",10.00 AED,10.00,9.8000,0.2000,564139503,1581570,Success,United Arab Emirates,DU UAE,Transguard Group LLC,API User,E6AEAE22430
2022-02-15 11:47,72376244,"21,421.1260","21,416.2260",05.00 AED,5.00,4.9000,0.1000,564139719,1581573,Success,United Arab Emirates,DU UAE,Transguard Group LLC,API User,E6AEAE17361
2022-02-15 11:48,72376279,"21,416.2260","21,411.3260",05.00 AED,5.00,4.9000,0.1000,564139818,1581576,Success,United Arab Emirates,DU UAE,Transguard Group LLC,API User,E6AEAE17361
2022-02-15 11:53,72376435,"21,411.3260","21,401.5260",10.00 AED,10.00,9.8000,0.2000,564140207,1581589,Success,United Arab Emirates,DU UAE,Transguard Group LLC,API User,E6AEAE22430
2022-02-15 11:55,72376533,"21,401.5260","21,396.6260",05.00 AED,5.00,4.9000,0.1000,564140434,1581599,Success,United Arab Emirates,DU UAE,Transguard Group LLC,API User,E6AEAE17361
2022-02-15 11:55,72376534,"21,396.6260","21,386.8260",10.00 AED,10.00,9.8000,0.2000,564140437,1581600,Success,United Arab Emirates,DU UAE,Transguard Group LLC,API User,E6AEAE22430
2022-02-15 11:57,72376581,"21,386.8260","21,378.0260",13.20 GHS,10.00,8.8000,1.2000,564140571,1581609,Success,Ghana,MTN Ghana,Transguard Group LLC,API User,GH_MT_TopUp
2022-02-15 11:58,72376637,"21,378.0260","21,373.1260",05.00 AED,5.00,4.9000,0.1000,564140699,1581614,Success,United Arab Emirates,DU UAE,Transguard Group LLC,API User,E6AEAE17361
2022-02-15 12:00,72376701,"21,373.1260","21,368.2260",05.00 AED,5.00,4.9000,0.1000,564140859,1581619,Success,United Arab Emirates,DU UAE,Transguard Group LLC,API User,E6AEAE17361
2022-02-15 12:04,72376840,"21,368.2260","21,358.4260",10.00 AED,10.00,9.8000,0.2000,564141152,1581627,Success,United Arab Emirates,DU UAE,Transguard Group LLC,API User,E6AEAE22430
2022-02-15 12:05,72376886,"21,358.4260","21,353.5260",05.00 AED,5.00,4.9000,0.1000,564141269,1581630,Success,United Arab Emirates,DU UAE,Transguard Group LLC,API User,E6AEAE17361
2022-02-15 12:07,72376932,"21,353.5260","21,348.6260",05.00 AED,5.00,4.9000,0.1000,564141397,1581635,Success,United Arab Emirates,DU UAE,Transguard Group LLC,API User,E6AEAE17361
2022-02-15 12:08,72376967,"21,348.6260","21,338.8260",10.00 AED,10.00,9.8000,0.2000,564141497,1581641,Success,United Arab Emirates,DU UAE,Transguard Group LLC,API User,E6AEAE22430
2022-02-15 12:08,72376993,"21,338.8260","21,333.9260",05.00 AED,5.00,4.9000,0.1000,564141552,1581643,Success,United Arab Emirates,DU UAE,Transguard Group LLC,API User,E6AEAE17361
2022-02-15 12:11,72377100,"21,333.9260","21,329.0260",05.00 AED,5.00,4.9000,0.1000,564141784,1581654,Success,United Arab Emirates,DU UAE,Transguard Group LLC,API User,E6AEAE17361
2022-02-15 12:11,72377108,"21,329.0260","21,324.1260",05.00 AED,5.00,4.9000,0.1000,564141797,1581655,Success,United Arab Emirates,DU UAE,Transguard Group LLC,API User,E6AEAE17361
2022-02-15 12:16,72377322,"21,324.1260","21,314.3260",10.00 AED,10.00,9.8000,0.2000,564142238,1581670,Success,United Arab Emirates,DU UAE,Transguard Group LLC,API User,E6AEAE22430
2022-02-15 12:17,72377388,"21,314.3260","21,309.4260",05.00 AED,5.00,4.9000,0.1000,564142411,1581679,Success,United Arab Emirates,DU UAE,Transguard Group LLC,API User,E6AEAE17361
2022-02-15 12:18,72377437,"21,309.4260","21,299.6260",10.00 AED,10.00,9.8000,0.2000,564142529,1581684,Success,United Arab Emirates,DU UAE,Transguard Group LLC,API User,E6AEAE22430
2022-02-15 12:19,72377453,"21,299.6260","21,289.8260",10.00 AED,10.00,9.8000,0.2000,564142554,1581687,Success,United Arab Emirates,DU UAE,Transguard Group LLC,API User,E6AEAE22430
2022-02-15 12:20,72377495,"21,289.8260","21,284.9260",05.00 AED,5.00,4.9000,0.1000,564142659,1581695,Success,United Arab Emirates,DU UAE,Transguard Group LLC,API User,E6AEAE17361
2022-02-15 12:22,72377580,"21,284.9260","21,280.0260",05.00 AED,5.00,4.9000,0.1000,564142893,1581699,Success,United Arab Emirates,DU UAE,Transguard Group LLC,API User,E6AEAE17361
2022-02-15 12:23,72377609,"21,280.0260","21,275.1260",05.00 AED,5.00,4.9000,0.1000,564142961,1581704,Success,United Arab Emirates,DU UAE,Transguard Group LLC,API User,E6AEAE17361
2022-02-15 12:23,72377631,"21,275.1260","21,270.2260",05.00 AED,5.00,4.9000,0.1000,564143017,1581708,Success,United Arab Emirates,DU UAE,Transguard Group LLC,API User,E6AEAE17361
2022-02-15 12:23,72377641,"21,270.2260","21,260.4260",10.00 AED,10.00,9.8000,0.2000,564143041,1581712,Success,United Arab Emirates,DU UAE,Transguard Group LLC,API User,E6AEAE22430
2022-02-15 12:24,72377671,"21,260.4260","21,226.1260",35.00 AED,35.00,34.3000,0.7000,564143105,1581716,Success,United Arab Emirates,DU UAE,Transguard Group LLC,API User,E6AEAE73954
2022-02-15 12:24,72377677,"21,226.1260","21,221.2260",05.00 AED,5.00,4.9000,0.1000,564143126,1581717,Success,United Arab Emirates,DU UAE,Transguard Group LLC,API User,E6AEAE17361
2022-02-15 12:25,72377697,"21,221.2260","21,211.4260",10.00 AED,10.00,9.8000,0.2000,564143181,1581720,Success,United Arab Emirates,DU UAE,Transguard Group LLC,API User,E6AEAE22430
2022-02-15 12:25,72377734,"21,211.4260","21,206.5260",05.00 AED,5.00,4.9000,0.1000,564143263,1581723,Success,United Arab Emirates,DU UAE,Transguard Group LLC,API User,E6AEAE17361
2022-02-15 12:30,72377930,"21,206.5260","21,201.6260",05.00 AED,5.00,4.9000,0.1000,564143715,1581728,Success,United Arab Emirates,DU UAE,Transguard Group LLC,API User,E6AEAE17361
2022-02-15 12:31,72377954,"21,201.6260","21,191.8260",10.00 AED,10.00,9.8000,0.2000,564143788,1581731,Success,United Arab Emirates,DU UAE,Transguard Group LLC,API User,E6AEAE22430
2022-02-15 12:32,72377991,"21,191.8260","21,186.9260",05.00 AED,5.00,4.9000,0.1000,564143886,1581735,Success,United Arab Emirates,DU UAE,Transguard Group LLC,API User,E6AEAE17361
2022-02-15 12:34,72378037,"21,186.9260","21,177.1260",10.00 AED,10.00,9.8000,0.2000,564143977,1581738,Success,United Arab Emirates,DU UAE,Transguard Group LLC,API User,E6AEAE22430
2022-02-15 12:35,72378075,"21,177.1260","21,172.2260",05.00 AED,5.00,4.9000,0.1000,564144079,1581741,Success,United Arab Emirates,DU UAE,Transguard Group LLC,API User,E6AEAE17361
2022-02-15 12:35,72378092,"21,172.2260","21,167.3260",05.00 AED,5.00,4.9000,0.1000,564144119,1581744,Success,United Arab Emirates,DU UAE,Transguard Group LLC,API User,E6AEAE17361
2022-02-15 12:38,72378231,"21,167.3260","21,147.7260",20.00 AED,20.00,19.6000,0.4000,564144413,1581748,Success,United Arab Emirates,DU UAE,Transguard Group LLC,API User,E6AEAE12938
2022-02-15 12:46,72378540,"21,147.7260","21,128.1260",20.00 AED,20.00,19.6000,0.4000,564145157,1581764,Success,United Arab Emirates,DU UAE,Transguard Group LLC,API User,E6AEAE12938
2022-02-15 12:46,72378545,"21,128.1260","21,123.2260",05.00 AED,5.00,4.9000,0.1000,564145163,1581765,Success,United Arab Emirates,DU UAE,Transguard Group LLC,API User,E6AEAE17361
2022-02-15 12:47,72378587,"21,123.2260","21,117.2860",100.00 INR,6.75,5.9400,0.8100,564145264,1581768,Success,India,Airtel India,Transguard Group LLC,API User,AIININ36410
2022-02-15 12:48,72378624,"21,117.2860","21,076.5860",500.00 PHP,46.25,40.7000,5.5500,564145346,1581771,Success,Philippines,Smart (SunCellular) Philippines,Transguard Group LLC,API User,PH_SM_TopUp_500.00
2022-02-15 12:50,72378729,"21,076.5860","21,071.6860",05.00 AED,5.00,4.9000,0.1000,564145592,1581777,Success,United Arab Emirates,DU UAE,Transguard Group LLC,API User,E6AEAE17361
2022-02-15 12:51,72378758,"21,071.6860","21,022.6860",50.00 AED,50.00,49.0000,1.0000,564145673,72378758,Success,United Arab Emirates,DU UAE,Transguard Group LLC,mohammed.arafath@transguardgroup.com,E6AEAE17155
2022-02-15 12:52,72378771,"21,022.6860","21,017.7860",05.00 AED,5.00,4.9000,0.1000,564145707,1581783,Success,United Arab Emirates,DU UAE,Transguard Group LLC,API User,E6AEAE17361
2022-02-15 12:54,72378893,"21,017.7860","21,012.8860",05.00 AED,5.00,4.9000,0.1000,564145982,1581795,Success,United Arab Emirates,DU UAE,Transguard Group LLC,API User,E6AEAE17361
2022-02-15 12:58,72379053,"21,012.8860","21,007.9860",05.00 AED,5.00,4.9000,0.1000,564146370,1581801,Success,United Arab Emirates,DU UAE,Transguard Group LLC,API User,E6AEAE17361
2022-02-15 13:00,72379152,"21,007.9860","21,003.0860",05.00 AED,5.00,4.9000,0.1000,564146617,1581811,Success,United Arab Emirates,DU UAE,Transguard Group LLC,API User,E6AEAE17361
2022-02-15 13:03,72379263,"21,003.0860","20,983.4860",20.00 AED,20.00,19.6000,0.4000,564146896,1581826,Success,United Arab Emirates,DU UAE,Transguard Group LLC,API User,E6AEAE12938
2022-02-15 13:10,72379537,"20,983.4860","20,978.5860",05.00 AED,5.00,4.9000,0.1000,564147579,1581839,Success,United Arab Emirates,DU UAE,Transguard Group LLC,API User,E6AEAE17361
2022-02-15 13:20,72380022,"20,978.5860","20,973.6860",05.00 AED,5.00,4.9000,0.1000,564148676,1581856,Success,United Arab Emirates,DU UAE,Transguard Group LLC,API User,E6AEAE17361
2022-02-15 13:24,72380177,"20,973.6860","20,968.7860",05.00 AED,5.00,4.9000,0.1000,564149032,1581861,Success,United Arab Emirates,DU UAE,Transguard Group LLC,API User,E6AEAE17361
2022-02-15 13:25,72380224,"20,968.7860","20,963.8860",05.00 AED,5.00,4.9000,0.1000,564149131,1581865,Success,United Arab Emirates,DU UAE,Transguard Group LLC,API User,E6AEAE17361
2022-02-15 13:26,72380267,"20,963.8860","20,958.9860",05.00 AED,5.00,4.9000,0.1000,564149242,1581869,Success,United Arab Emirates,DU UAE,Transguard Group LLC,API User,E6AEAE17361
2022-02-15 13:36,72380713,"20,958.9860","20,954.0860",05.00 AED,5.00,4.9000,0.1000,564150326,1581877,Success,United Arab Emirates,DU UAE,Transguard Group LLC,API User,E6AEAE17361
2022-02-15 13:37,72380765,"20,954.0860","20,949.1860",05.00 AED,5.00,4.9000,0.1000,564150480,1581883,Success,United Arab Emirates,DU UAE,Transguard Group LLC,API User,E6AEAE17361
2022-02-15 13:38,72380784,"20,949.1860","20,945.0060",150.00 PKR,4.75,4.1800,0.5700,564150518,1581886,Success,Pakistan,Jazz Pakistan,Transguard Group LLC,API User,MBPKPK20699
2022-02-15 13:38,72380803,"20,945.0060","20,915.6060",30.00 AED,30.00,29.4000,0.6000,564150563,1581888,Success,United Arab Emirates,DU UAE,Transguard Group LLC,API User,E6AEAE46146
2022-02-15 13:39,72380834,"20,915.6060","20,910.7060",05.00 AED,5.00,4.9000,0.1000,564150628,1581893,Success,United Arab Emirates,DU UAE,Transguard Group LLC,API User,E6AEAE17361
2022-02-15 13:44,72381071,"20,910.7060","20,905.8060",05.00 AED,5.00,4.9000,0.1000,564151173,1581909,Success,United Arab Emirates,DU UAE,Transguard Group LLC,API User,E6AEAE17361
2022-02-15 13:46,72381158,"20,905.8060","20,900.9060",05.00 AED,5.00,4.9000,0.1000,564151355,1581912,Success,United Arab Emirates,DU UAE,Transguard Group LLC,API User,E6AEAE17361
2022-02-15 13:49,72381343,"20,900.9060","20,896.0060",05.00 AED,5.00,4.9000,0.1000,564151763,1581921,Success,United Arab Emirates,DU UAE,Transguard Group LLC,API User,E6AEAE17361
2022-02-15 13:53,72381502,"20,896.0060","20,886.2060",10.00 AED,10.00,9.8000,0.2000,564152153,1581928,Success,United Arab Emirates,DU UAE,Transguard Group LLC,API User,E6AEAE22430
2022-02-15 13:55,72381591,"20,886.2060","20,878.9460",200.00 NPR,8.25,7.2600,0.9900,564152404,1581931,Success,Nepal,Nepal Telecom Nepal,Transguard Group LLC,API User,NP_NE_TopUp_200.00
2022-02-15 13:59,72381779,"20,878.9460","20,874.0460",05.00 AED,5.00,4.9000,0.1000,564152869,1581939,Success,United Arab Emirates,DU UAE,Transguard Group LLC,API User,E6AEAE17361
2022-02-15 14:03,72381934,"20,874.0460","20,869.1460",05.00 AED,5.00,4.9000,0.1000,564153278,1581960,Success,United Arab Emirates,DU UAE,Transguard Group LLC,API User,E6AEAE17361
2022-02-15 14:05,72382008,"20,869.1460","20,864.2460",05.00 AED,5.00,4.9000,0.1000,564153451,1581967,Success,United Arab Emirates,DU UAE,Transguard Group LLC,API User,E6AEAE17361
2022-02-15 14:12,72382307,"20,864.2460","20,859.3460",05.00 AED,5.00,4.9000,0.1000,564154286,1581981,Success,United Arab Emirates,DU UAE,Transguard Group LLC,API User,E6AEAE17361
2022-02-15 14:15,72382424,"20,859.3460","20,854.4460",05.00 AED,5.00,4.9000,0.1000,564154566,1581988,Success,United Arab Emirates,DU UAE,Transguard Group LLC,API User,E6AEAE17361
2022-02-15 14:21,72382676,"20,854.4460","20,849.5460",05.00 AED,5.00,4.9000,0.1000,564155238,1581994,Success,United Arab Emirates,DU UAE,Transguard Group LLC,API User,E6AEAE17361
2022-02-15 14:26,72382854,"20,849.5460","20,844.6460",05.00 AED,5.00,4.9000,0.1000,564155716,1581999,Success,United Arab Emirates,DU UAE,Transguard Group LLC,API User,E6AEAE17361
2022-02-15 14:28,72382970,"20,844.6460","20,805.4460",40.00 AED,40.00,39.2000,0.8000,564155999,1582004,Success,United Arab Emirates,DU UAE,Transguard Group LLC,API User,E6AEAE64011
2022-02-15 14:32,72383159,"20,805.4460","20,800.5460",05.00 AED,5.00,4.9000,0.1000,564156486,1582009,Success,United Arab Emirates,DU UAE,Transguard Group LLC,API User,E6AEAE17361
2022-02-15 14:36,72383327,"20,800.5460","20,780.9460",20.00 AED,20.00,19.6000,0.4000,564156908,1582013,Success,United Arab Emirates,DU UAE,Transguard Group LLC,API User,E6AEAE12938
2022-02-15 14:38,72383432,"20,780.9460","20,776.0460",05.00 AED,5.00,4.9000,0.1000,564157179,1582019,Success,United Arab Emirates,DU UAE,Transguard Group LLC,API User,E6AEAE17361
2022-02-15 14:42,72383618,"20,776.0460","20,736.8460",40.00 AED,40.00,39.2000,0.8000,564157645,1582028,Success,United Arab Emirates,DU UAE,Transguard Group LLC,API User,E6AEAE64011
2022-02-15 14:43,72383642,"20,736.8460","20,727.0460",10.00 AED,10.00,9.8000,0.2000,564157714,1582031,Success,United Arab Emirates,DU UAE,Transguard Group LLC,API User,E6AEAE22430
2022-02-15 14:45,72383707,"20,727.0460","20,707.4460",20.00 AED,20.00,19.6000,0.4000,564157879,1582036,Success,United Arab Emirates,DU UAE,Transguard Group LLC,API User,E6AEAE12938
2022-02-15 14:46,72383743,"20,707.4460","20,702.5460",05.00 AED,5.00,4.9000,0.1000,564157967,1582039,Success,United Arab Emirates,DU UAE,Transguard Group LLC,API User,E6AEAE17361
2022-02-15 14:48,72383844,"20,702.5460","20,692.7460",10.00 AED,10.00,9.8000,0.2000,564158193,1582044,Success,United Arab Emirates,DU UAE,Transguard Group LLC,API User,E6AEAE22430
2022-02-15 14:49,72383941,"20,692.7460","20,684.3860",300.00 PKR,9.50,8.3600,1.1400,564158476,1582047,Success,Pakistan,Jazz Pakistan,Transguard Group LLC,API User,PK_MB_TopUp_300.00
2022-02-15 14:57,72384212,"20,684.3860","20,674.5860",10.00 AED,10.00,9.8000,0.2000,564159225,1582056,Success,United Arab Emirates,DU UAE,Transguard Group LLC,API User,E6AEAE22430
2022-02-15 15:00,72384361,"20,674.5860","20,664.7860",10.00 AED,10.00,9.8000,0.2000,564159664,1582060,Success,United Arab Emirates,DU UAE,Transguard Group LLC,API User,E6AEAE22430
2022-02-15 15:02,72384449,"20,664.7860","20,654.9860",10.00 AED,10.00,9.8000,0.2000,564159915,1582064,Success,United Arab Emirates,DU UAE,Transguard Group LLC,API User,E6AEAE22430
2022-02-15 15:05,72384535,"20,654.9860","20,645.1860",10.00 AED,10.00,9.8000,0.2000,564160156,1582069,Success,United Arab Emirates,DU UAE,Transguard Group LLC,API User,E6AEAE22430
2022-02-15 15:07,72384637,"20,645.1860","20,635.3860",10.00 AED,10.00,9.8000,0.2000,564160445,1582075,Success,United Arab Emirates,DU UAE,Transguard Group LLC,API User,E6AEAE22430
2022-02-15 15:16,72385080,"20,635.3860","20,625.5860",10.00 AED,10.00,9.8000,0.2000,564161622,1582091,Success,United Arab Emirates,DU UAE,Transguard Group LLC,API User,E6AEAE22430
2022-02-15 15:20,72385218,"20,625.5860","20,620.6860",05.00 AED,5.00,4.9000,0.1000,564162024,1582097,Success,United Arab Emirates,DU UAE,Transguard Group LLC,API User,E6AEAE17361
2022-02-15 15:21,72385284,"20,620.6860","20,601.0860",20.00 AED,20.00,19.6000,0.4000,564162219,1582102,Success,United Arab Emirates,DU UAE,Transguard Group LLC,API User,E6AEAE12938
2022-02-15 15:25,72385452,"20,601.0860","20,596.1860",05.00 AED,5.00,4.9000,0.1000,564162659,1582108,Success,United Arab Emirates,DU UAE,Transguard Group LLC,API User,E6AEAE17361
2022-02-15 15:25,72385453,"20,596.1860","20,591.2860",05.00 AED,5.00,4.9000,0.1000,564162660,1582109,Success,United Arab Emirates,DU UAE,Transguard Group LLC,API User,E6AEAE17361
2022-02-15 15:26,72385502,"20,591.2860","20,587.5460",100.00 NPR,4.25,3.7400,0.5100,564162799,1582111,Success,Nepal,Ncell Nepal,Transguard Group LLC,API User,NP_NC_TopUp_100.00
2022-02-15 15:27,72385591,"20,587.5460","20,582.6460",05.00 AED,5.00,4.9000,0.1000,564163012,1582122,Success,United Arab Emirates,DU UAE,Transguard Group LLC,API User,E6AEAE17361
2022-02-15 15:28,72385614,"20,582.6460","20,577.7460",05.00 AED,5.00,4.9000,0.1000,564163084,1582124,Success,United Arab Emirates,DU UAE,Transguard Group LLC,API User,E6AEAE17361
2022-02-15 15:31,72385789,"20,577.7460","20,572.8460",05.00 AED,5.00,4.9000,0.1000,564163582,1582128,Failure,United Arab Emirates,DU UAE,Transguard Group LLC,API User,E6AEAE17361
2022-02-15 15:31,72385789,"20,572.8460","20,567.9460",05.00 AED,5.00,4.9000,0.1000,564163582,1582128,Failure,United Arab Emirates,DU UAE,Transguard Group LLC,API User,E6AEAE17361
2022-02-15 15:32,72385811,"20,577.7460","20,572.8460",05.00 AED,5.00,4.9000,0.1000,564163625,1582130,Success,United Arab Emirates,DU UAE,Transguard Group LLC,API User,E6AEAE17361
2022-02-15 15:34,72385914,"20,572.8460","20,567.9460",05.00 AED,5.00,4.9000,0.1000,564163921,1582135,Success,United Arab Emirates,DU UAE,Transguard Group LLC,API User,E6AEAE17361
2022-02-15 15:37,72386038,"20,567.9460","20,563.0460",05.00 AED,5.00,4.9000,0.1000,564164259,1582142,Success,United Arab Emirates,DU UAE,Transguard Group LLC,API User,E6AEAE17361
2022-02-15 15:37,72386057,"20,563.0460","20,543.4460",20.00 AED,20.00,19.6000,0.4000,564164304,1582144,Success,United Arab Emirates,DU UAE,Transguard Group LLC,API User,E6AEAE12938
2022-02-15 15:38,72386096,"20,543.4460","20,523.8460",20.00 AED,20.00,19.6000,0.4000,564164384,1582147,Success,United Arab Emirates,DU UAE,Transguard Group LLC,API User,E6AEAE12938
2022-02-15 15:40,72386202,"20,523.8460","20,497.4460",06.27 USD,30.00,26.4000,3.6000,564164654,1582154,Success,Liberia,Orange Liberia,Transguard Group LLC,API User,LR_CM_TopUp
2022-02-15 15:47,72386600,"20,497.4460","20,492.5460",05.00 AED,5.00,4.9000,0.1000,564165652,1582166,Success,United Arab Emirates,DU UAE,Transguard Group LLC,API User,E6AEAE17361
2022-02-15 15:49,72386738,"20,492.5460","20,487.6460",05.00 AED,5.00,4.9000,0.1000,564165986,1582176,Success,United Arab Emirates,DU UAE,Transguard Group LLC,API User,E6AEAE17361
2022-02-15 15:49,72386740,"20,487.6460","20,477.8460",10.00 AED,10.00,9.8000,0.2000,564165993,1582177,Success,United Arab Emirates,DU UAE,Transguard Group LLC,API User,E6AEAE22430
2022-02-15 15:56,72387105,"20,477.8460","20,458.2460",20.00 AED,20.00,19.6000,0.4000,564166981,1582190,Success,United Arab Emirates,DU UAE,Transguard Group LLC,API User,E6AEAE12938
2022-02-15 15:58,72387173,"20,458.2460","20,448.4460",10.00 AED,10.00,9.8000,0.2000,564167160,1582192,Success,United Arab Emirates,DU UAE,Transguard Group LLC,API User,E6AEAE22430
2022-02-15 15:59,72387236,"20,448.4460","20,438.6460",10.00 AED,10.00,9.8000,0.2000,564167337,1582196,Success,United Arab Emirates,DU UAE,Transguard Group LLC,API User,E6AEAE22430
2022-02-15 16:00,72387271,"20,438.6460","20,422.5860",575.00 PKR,18.25,16.0600,2.1900,564167449,1582200,Success,Pakistan,Jazz Pakistan,Transguard Group LLC,API User,MBPKPK68304
2022-02-15 16:05,72387526,"20,422.5860","20,412.7860",10.00 AED,10.00,9.8000,0.2000,564168159,1582214,Success,United Arab Emirates,DU UAE,Transguard Group LLC,API User,E6AEAE22430
2022-02-15 16:16,72388172,"20,412.7860","20,407.8860",05.00 AED,5.00,4.9000,0.1000,564169808,1582224,Success,United Arab Emirates,DU UAE,Transguard Group LLC,API User,E6AEAE17361
2022-02-15 16:17,72388204,"20,407.8860","20,402.9860",05.00 AED,5.00,4.9000,0.1000,564169889,1582227,Success,United Arab Emirates,DU UAE,Transguard Group LLC,API User,E6AEAE17361
2022-02-15 16:19,72388351,"20,402.9860","20,398.0860",05.00 AED,5.00,4.9000,0.1000,564170236,1582230,Success,United Arab Emirates,DU UAE,Transguard Group LLC,API User,E6AEAE17361
2022-02-15 16:22,72388509,"20,398.0860","20,388.2860",10.00 AED,10.00,9.8000,0.2000,564170722,1582235,Success,United Arab Emirates,DU UAE,Transguard Group LLC,API User,E6AEAE22430
2022-02-15 16:25,72388742,"20,388.2860","20,378.4860",10.00 AED,10.00,9.8000,0.2000,564171311,1582243,Success,United Arab Emirates,DU UAE,Transguard Group LLC,API User,E6AEAE22430
2022-02-15 16:32,72389147,"20,378.4860","20,373.5860",05.00 AED,5.00,4.9000,0.1000,564172359,1582262,Success,United Arab Emirates,DU UAE,Transguard Group LLC,API User,E6AEAE17361
2022-02-15 16:33,72389186,"20,373.5860","20,363.7860",10.00 AED,10.00,9.8000,0.2000,564172453,1582264,Success,United Arab Emirates,DU UAE,Transguard Group LLC,API User,E6AEAE22430
2022-02-15 16:35,72389362,"20,363.7860","20,354.9860",13.20 GHS,10.00,8.8000,1.2000,564172916,1582269,Success,Ghana,MTN Ghana,Transguard Group LLC,API User,GH_MT_TopUp
2022-02-15 16:36,72389391,"20,354.9860","20,350.0860",05.00 AED,5.00,4.9000,0.1000,564173006,1582275,Success,United Arab Emirates,DU UAE,Transguard Group LLC,API User,E6AEAE17361
2022-02-15 16:43,72389801,"20,350.0860","20,335.3860",15.00 AED,15.00,14.7000,0.3000,564174102,1582286,Success,United Arab Emirates,DU UAE,Transguard Group LLC,API User,E6AEAE8527
2022-02-15 16:45,72389901,"20,335.3860","20,330.4860",05.00 AED,5.00,4.9000,0.1000,564174362,1582291,Success,United Arab Emirates,DU UAE,Transguard Group LLC,API User,E6AEAE17361
2022-02-15 16:45,72389932,"20,330.4860","20,320.6860",10.00 AED,10.00,9.8000,0.2000,564174450,1582294,Success,United Arab Emirates,DU UAE,Transguard Group LLC,API User,E6AEAE22430
2022-02-15 16:47,72390067,"20,320.6860","20,315.7860",05.00 AED,5.00,4.9000,0.1000,564174792,1582297,Success,United Arab Emirates,DU UAE,Transguard Group LLC,API User,E6AEAE17361
2022-02-15 16:48,72390151,"20,315.7860","20,305.9860",10.00 AED,10.00,9.8000,0.2000,564174988,1582301,Success,United Arab Emirates,DU UAE,Transguard Group LLC,API User,E6AEAE22430
2022-02-15 16:49,72390178,"20,305.9860","20,301.0860",05.00 AED,5.00,4.9000,0.1000,564175058,1582303,Success,United Arab Emirates,DU UAE,Transguard Group LLC,API User,E6AEAE17361
2022-02-15 16:50,72390236,"20,301.0860","20,296.1860",05.00 AED,5.00,4.9000,0.1000,564175224,1582309,Success,United Arab Emirates,DU UAE,Transguard Group LLC,API User,E6AEAE17361
2022-02-15 16:50,72390275,"20,296.1860","20,291.2860",05.00 AED,5.00,4.9000,0.1000,564175325,1582311,Success,United Arab Emirates,DU UAE,Transguard Group LLC,API User,E6AEAE17361
2022-02-15 16:53,72390490,"20,291.2860","20,286.3860",05.00 AED,5.00,4.9000,0.1000,564175804,1582324,Success,United Arab Emirates,DU UAE,Transguard Group LLC,API User,E6AEAE17361
2022-02-15 17:00,72390950,"20,286.3860","20,266.7860",20.00 AED,20.00,19.6000,0.4000,564176994,1582337,Success,United Arab Emirates,DU UAE,Transguard Group LLC,API User,E6AEAE12938
2022-02-15 17:01,72391015,"20,266.7860","20,256.9860",10.00 AED,10.00,9.8000,0.2000,564177175,1582342,Success,United Arab Emirates,DU UAE,Transguard Group LLC,API User,E6AEAE22430
2022-02-15 17:02,72391073,"20,256.9860","20,252.0860",05.00 AED,5.00,4.9000,0.1000,564177299,1582348,Success,United Arab Emirates,DU UAE,Transguard Group LLC,API User,E6AEAE17361
2022-02-15 17:03,72391128,"20,252.0860","20,247.1860",05.00 AED,5.00,4.9000,0.1000,564177440,1582353,Success,United Arab Emirates,DU UAE,Transguard Group LLC,API User,E6AEAE17361
2022-02-15 17:05,72391275,"20,247.1860","20,242.2860",05.00 AED,5.00,4.9000,0.1000,564177821,1582364,Success,United Arab Emirates,DU UAE,Transguard Group LLC,API User,E6AEAE17361
2022-02-15 17:05,72391314,"20,242.2860","20,232.4860",10.00 AED,10.00,9.8000,0.2000,564177901,1582367,Success,United Arab Emirates,DU UAE,Transguard Group LLC,API User,E6AEAE22430
2022-02-15 17:10,72391620,"20,232.4860","20,222.6860",10.00 AED,10.00,9.8000,0.2000,564178615,1582375,Success,United Arab Emirates,DU UAE,Transguard Group LLC,API User,E6AEAE22430
2022-02-15 17:10,72391631,"20,222.6860","20,212.8860",10.00 AED,10.00,9.8000,0.2000,564178643,1582377,Success,United Arab Emirates,DU UAE,Transguard Group LLC,API User,E6AEAE22430
2022-02-15 17:12,72391773,"20,212.8860","20,207.9860",05.00 AED,5.00,4.9000,0.1000,564179018,1582384,Success,United Arab Emirates,DU UAE,Transguard Group LLC,API User,E6AEAE17361
2022-02-15 17:15,72391987,"20,207.9860","20,203.8060",150.00 PKR,4.75,4.1800,0.5700,564179617,1582393,Success,Pakistan,Zong Pakistan,Transguard Group LLC,API User,ZNPKPK65621
2022-02-15 17:15,72392020,"20,203.8060","20,198.9060",05.00 AED,5.00,4.9000,0.1000,564179702,1582396,Success,United Arab Emirates,DU UAE,Transguard Group LLC,API User,E6AEAE17361
2022-02-15 17:16,72392067,"20,198.9060","20,194.0060",05.00 AED,5.00,4.9000,0.1000,564179796,1582398,Success,United Arab Emirates,DU UAE,Transguard Group LLC,API User,E6AEAE17361
2022-02-15 17:24,72392732,"20,194.0060","20,184.2060",10.00 AED,10.00,9.8000,0.2000,564181400,1582403,Success,United Arab Emirates,DU UAE,Transguard Group LLC,API User,E6AEAE22430
2022-02-15 17:29,72393119,"20,184.2060","20,179.3060",05.00 AED,5.00,4.9000,0.1000,564182393,1582407,Success,United Arab Emirates,DU UAE,Transguard Group LLC,API User,E6AEAE17361
2022-02-15 17:31,72393209,"20,179.3060","20,174.4060",05.00 AED,5.00,4.9000,0.1000,564182684,1582416,Success,United Arab Emirates,DU UAE,Transguard Group LLC,API User,E6AEAE17361
2022-02-15 17:31,72393211,"20,174.4060","20,169.5060",05.00 AED,5.00,4.9000,0.1000,564182690,1582417,Success,United Arab Emirates,DU UAE,Transguard Group LLC,API User,E6AEAE17361
2022-02-15 17:31,72393220,"20,169.5060","20,164.6060",05.00 AED,5.00,4.9000,0.1000,564182712,1582419,Success,United Arab Emirates,DU UAE,Transguard Group LLC,API User,E6AEAE17361
2022-02-15 17:31,72393227,"20,164.6060","20,154.8060",10.00 AED,10.00,9.8000,0.2000,564182735,1582421,Success,United Arab Emirates,DU UAE,Transguard Group LLC,API User,E6AEAE22430
2022-02-15 17:32,72393339,"20,154.8060","20,146.4460",100.00 PHP,9.50,8.3600,1.1400,564183027,1582426,Success,Philippines,Smart (SunCellular) Philippines,Transguard Group LLC,API User,PH_SM_TopUp_100.00
2022-02-15 17:32,72393348,"20,146.4460","20,126.8460",20.00 AED,20.00,19.6000,0.4000,564183039,1582427,Success,United Arab Emirates,DU UAE,Transguard Group LLC,API User,E6AEAE12938
2022-02-15 17:33,72393429,"20,126.8460","20,117.0460",10.00 AED,10.00,9.8000,0.2000,564183227,1582432,Success,United Arab Emirates,DU UAE,Transguard Group LLC,API User,E6AEAE22430
2022-02-15 17:34,72393474,"20,117.0460","20,107.2460",10.00 AED,10.00,9.8000,0.2000,564183363,1582437,Success,United Arab Emirates,DU UAE,Transguard Group LLC,API User,E6AEAE22430
2022-02-15 17:34,72393518,"20,107.2460","20,102.3460",05.00 AED,5.00,4.9000,0.1000,564183476,1582441,Success,United Arab Emirates,DU UAE,Transguard Group LLC,API User,E6AEAE17361
2022-02-15 17:35,72393557,"20,102.3460","20,063.1460",40.00 AED,40.00,39.2000,0.8000,564183597,1582445,Success,United Arab Emirates,DU UAE,Transguard Group LLC,API User,E6AEAE64011
2022-02-15 17:35,72393581,"20,063.1460","20,054.3460",100.00 PHP,10.00,8.8000,1.2000,564183660,1582447,Success,Philippines,BS_Globe Philippines,Transguard Group LLC,API User,PH_GB_TopUp_100.00
2022-02-15 17:37,72393680,"20,054.3460","20,044.5460",10.00 AED,10.00,9.8000,0.2000,564183895,1582454,Success,United Arab Emirates,DU UAE,Transguard Group LLC,API User,E6AEAE22430
2022-02-15 17:37,72393695,"20,044.5460","20,040.1460",50.00 PHP,5.00,4.4000,0.6000,564183965,1582456,Success,Philippines,BS_Globe Philippines,Transguard Group LLC,API User,PH_GB_TopUp_50.00
2022-02-15 17:42,72394166,"20,040.1460","20,035.2460",05.00 AED,5.00,4.9000,0.1000,564185094,1582464,Success,United Arab Emirates,DU UAE,Transguard Group LLC,API User,E6AEAE17361
2022-02-15 17:46,72394513,"20,035.2460","20,025.4460",10.00 AED,10.00,9.8000,0.2000,564185969,1582471,Success,United Arab Emirates,DU UAE,Transguard Group LLC,API User,E6AEAE22430
2022-02-15 17:49,72394787,"20,025.4460","20,020.5460",05.00 AED,5.00,4.9000,0.1000,564186571,1582480,Success,United Arab Emirates,DU UAE,Transguard Group LLC,API User,E6AEAE17361
2022-02-15 17:50,72394887,"20,020.5460","20,015.6460",05.00 AED,5.00,4.9000,0.1000,564186804,1582487,Success,United Arab Emirates,DU UAE,Transguard Group LLC,API User,E6AEAE17361
2022-02-15 17:52,72395027,"20,015.6460","20,010.7460",05.00 AED,5.00,4.9000,0.1000,564187104,1582498,Success,United Arab Emirates,DU UAE,Transguard Group LLC,API User,E6AEAE17361
2022-02-15 17:52,72395028,"20,010.7460","20,000.9460",10.00 AED,10.00,9.8000,0.2000,564187105,1582499,Success,United Arab Emirates,DU UAE,Transguard Group LLC,API User,E6AEAE22430
2022-02-15 17:54,72395189,"20,000.9460","19,996.0460",05.00 AED,5.00,4.9000,0.1000,564187520,1582507,Success,United Arab Emirates,DU UAE,Transguard Group LLC,API User,E6AEAE17361
2022-02-15 17:54,72395257,"19,996.0460","19,991.1460",05.00 AED,5.00,4.9000,0.1000,564187681,1582515,Success,United Arab Emirates,DU UAE,Transguard Group LLC,API User,E6AEAE17361
2022-02-15 17:59,72395605,"19,991.1460","19,986.2460",05.00 AED,5.00,4.9000,0.1000,564188587,1582525,Success,United Arab Emirates,DU UAE,Transguard Group LLC,API User,E6AEAE17361
2022-02-15 18:02,72395881,"19,986.2460","19,942.1460",45.00 AED,45.00,44.1000,0.9000,564189314,1582530,Success,United Arab Emirates,DU UAE,Transguard Group LLC,API User,E6AEAE35243
2022-02-15 18:03,72395957,"19,942.1460","19,937.2460",05.00 AED,5.00,4.9000,0.1000,564189483,1582535,Success,United Arab Emirates,DU UAE,Transguard Group LLC,API User,E6AEAE17361
2022-02-15 18:03,72395962,"19,937.2460","19,932.3460",05.00 AED,5.00,4.9000,0.1000,564189490,1582536,Success,United Arab Emirates,DU UAE,Transguard Group LLC,API User,E6AEAE17361
2022-02-15 18:04,72396101,"19,932.3460","19,922.5460",10.00 AED,10.00,9.8000,0.2000,564189858,1582544,Success,United Arab Emirates,DU UAE,Transguard Group LLC,API User,E6AEAE22430
2022-02-15 18:04,72396109,"19,922.5460","19,912.7460",10.00 AED,10.00,9.8000,0.2000,564189879,1582546,Success,United Arab Emirates,DU UAE,Transguard Group LLC,API User,E6AEAE22430
2022-02-15 18:06,72396280,"19,912.7460","19,907.8460",05.00 AED,5.00,4.9000,0.1000,564190306,1582549,Success,United Arab Emirates,DU UAE,Transguard Group LLC,API User,E6AEAE17361
2022-02-15 18:07,72396381,"19,907.8460","19,902.9460",05.00 AED,5.00,4.9000,0.1000,564190511,1582557,Success,United Arab Emirates,DU UAE,Transguard Group LLC,API User,E6AEAE17361
2022-02-15 18:08,72396399,"19,902.9460","19,898.0460",05.00 AED,5.00,4.9000,0.1000,564190537,1582559,Success,United Arab Emirates,DU UAE,Transguard Group LLC,API User,E6AEAE17361
2022-02-15 18:08,72396449,"19,898.0460","19,893.1460",05.00 AED,5.00,4.9000,0.1000,564190650,1582563,Success,United Arab Emirates,DU UAE,Transguard Group LLC,API User,E6AEAE17361
2022-02-15 18:09,72396504,"19,893.1460","19,888.2460",05.00 AED,5.00,4.9000,0.1000,564190770,1582566,Success,United Arab Emirates,DU UAE,Transguard Group LLC,API User,E6AEAE17361
2022-02-15 18:10,72396659,"19,888.2460","19,883.3460",05.00 AED,5.00,4.9000,0.1000,564191104,1582571,Success,United Arab Emirates,DU UAE,Transguard Group LLC,API User,E6AEAE17361
2022-02-15 18:14,72397055,"19,883.3460","19,873.5460",10.00 AED,10.00,9.8000,0.2000,564192058,1582580,Success,United Arab Emirates,DU UAE,Transguard Group LLC,API User,E6AEAE22430
2022-02-15 18:16,72397224,"19,873.5460","19,863.7460",10.00 AED,10.00,9.8000,0.2000,564192446,1582585,Success,United Arab Emirates,DU UAE,Transguard Group LLC,API User,E6AEAE22430
2022-02-15 18:25,72398000,"19,863.7460","19,858.8460",05.00 AED,5.00,4.9000,0.1000,564194518,1582618,Success,United Arab Emirates,DU UAE,Transguard Group LLC,API User,E6AEAE17361
2022-02-15 18:25,72398008,"19,858.8460","19,853.9460",05.00 AED,5.00,4.9000,0.1000,564194547,1582620,Success,United Arab Emirates,DU UAE,Transguard Group LLC,API User,E6AEAE17361
2022-02-15 18:26,72398036,"19,853.9460","19,849.0460",05.00 AED,5.00,4.9000,0.1000,564194625,1582622,Success,United Arab Emirates,DU UAE,Transguard Group LLC,API User,E6AEAE17361
2022-02-15 18:29,72398293,"19,849.0460","19,839.2460",10.00 AED,10.00,9.8000,0.2000,564195285,1582629,Success,United Arab Emirates,DU UAE,Transguard Group LLC,API User,E6AEAE22430
2022-02-15 18:32,72398613,"19,839.2460","19,834.3460",05.00 AED,5.00,4.9000,0.1000,564196114,1582640,Success,United Arab Emirates,DU UAE,Transguard Group LLC,API User,E6AEAE17361
2022-02-15 18:32,72398632,"19,834.3460","19,824.5460",10.00 AED,10.00,9.8000,0.2000,564196152,1582642,Success,United Arab Emirates,DU UAE,Transguard Group LLC,API User,E6AEAE22430
2022-02-15 18:37,72399120,"19,824.5460","19,814.7460",10.00 AED,10.00,9.8000,0.2000,564197325,1582662,Success,United Arab Emirates,DU UAE,Transguard Group LLC,API User,E6AEAE22430
2022-02-15 18:38,72399174,"19,814.7460","19,809.8460",05.00 AED,5.00,4.9000,0.1000,564197458,1582667,Success,United Arab Emirates,DU UAE,Transguard Group LLC,API User,E6AEAE17361
2022-02-15 18:38,72399191,"19,809.8460","19,804.9460",05.00 AED,5.00,4.9000,0.1000,564197493,1582669,Success,United Arab Emirates,DU UAE,Transguard Group LLC,API User,E6AEAE17361
2022-02-15 18:39,72399336,"19,804.9460","19,795.1460",10.00 AED,10.00,9.8000,0.2000,564197818,1582677,Success,United Arab Emirates,DU UAE,Transguard Group LLC,API User,E6AEAE22430
2022-02-15 18:42,72399562,"19,795.1460","19,790.2460",05.00 AED,5.00,4.9000,0.1000,564198405,1582692,Success,United Arab Emirates,DU UAE,Transguard Group LLC,API User,E6AEAE17361
2022-02-15 18:42,72399602,"19,790.2460","19,785.3460",05.00 AED,5.00,4.9000,0.1000,564198501,1582695,Success,United Arab Emirates,DU UAE,Transguard Group LLC,API User,E6AEAE17361
2022-02-15 18:42,72399618,"19,785.3460","19,781.6060",100.00 NPR,4.25,3.7400,0.5100,564198530,1582697,Success,Nepal,Ncell Nepal,Transguard Group LLC,API User,NP_NC_TopUp_100.00
2022-02-15 18:43,72399711,"19,781.6060","19,776.7060",05.00 AED,5.00,4.9000,0.1000,564198727,1582703,Success,United Arab Emirates,DU UAE,Transguard Group LLC,API User,E6AEAE17361
2022-02-15 18:43,72399722,"19,776.7060","19,772.9660",100.00 NPR,4.25,3.7400,0.5100,564198756,1582706,Success,Nepal,Ncell Nepal,Transguard Group LLC,API User,NP_NC_TopUp_100.00
2022-02-15 18:46,72399985,"19,772.9660","19,763.1660",10.00 AED,10.00,9.8000,0.2000,564199416,1582722,Success,United Arab Emirates,DU UAE,Transguard Group LLC,API User,E6AEAE22430
2022-02-15 18:49,72400400,"19,763.1660","19,753.3660",10.00 AED,10.00,9.8000,0.2000,564200368,1582729,Success,United Arab Emirates,DU UAE,Transguard Group LLC,API User,E6AEAE22430
2022-02-15 18:51,72400519,"19,753.3660","19,748.4660",05.00 AED,5.00,4.9000,0.1000,564200666,1582733,Success,United Arab Emirates,DU UAE,Transguard Group LLC,API User,E6AEAE17361
2022-02-15 18:51,72400542,"19,748.4660","19,743.5660",05.00 AED,5.00,4.9000,0.1000,564200747,1582737,Success,United Arab Emirates,DU UAE,Transguard Group LLC,API User,E6AEAE17361
2022-02-15 18:53,72400749,"19,743.5660","19,738.6660",05.00 AED,5.00,4.9000,0.1000,564201225,1582745,Success,United Arab Emirates,DU UAE,Transguard Group LLC,API User,E6AEAE17361
2022-02-15 18:55,72400970,"19,738.6660","19,728.8660",10.00 AED,10.00,9.8000,0.2000,564201716,1582752,Success,United Arab Emirates,DU UAE,Transguard Group LLC,API User,E6AEAE22430
2022-02-15 19:00,72401485,"19,728.8660","19,723.9660",05.00 AED,5.00,4.9000,0.1000,564202865,1582762,Success,United Arab Emirates,DU UAE,Transguard Group LLC,API User,E6AEAE17361
2022-02-15 19:02,72401726,"19,723.9660","19,719.0660",05.00 AED,5.00,4.9000,0.1000,564203408,1582772,Success,United Arab Emirates,DU UAE,Transguard Group LLC,API User,E6AEAE17361
2022-02-15 19:03,72401858,"19,719.0660","19,714.1660",05.00 AED,5.00,4.9000,0.1000,564203704,1582778,Success,United Arab Emirates,DU UAE,Transguard Group LLC,API User,E6AEAE17361
2022-02-15 19:05,72402045,"19,714.1660","19,704.3660",10.00 AED,10.00,9.8000,0.2000,564204140,1582783,Success,United Arab Emirates,DU UAE,Transguard Group LLC,API User,E6AEAE22430
2022-02-15 19:08,72402413,"19,704.3660","19,699.4660",05.00 AED,5.00,4.9000,0.1000,564204986,1582793,Success,United Arab Emirates,DU UAE,Transguard Group LLC,API User,E6AEAE17361
2022-02-15 19:10,72402712,"19,699.4660","19,679.8660",20.00 AED,20.00,19.6000,0.4000,564205717,1582800,Success,United Arab Emirates,DU UAE,Transguard Group LLC,API User,E6AEAE12938
2022-02-15 19:11,72402786,"19,679.8660","19,674.9660",05.00 AED,5.00,4.9000,0.1000,564205903,1582805,Success,United Arab Emirates,DU UAE,Transguard Group LLC,API User,E6AEAE17361
2022-02-15 19:12,72402873,"19,674.9660","19,670.0660",05.00 AED,5.00,4.9000,0.1000,564206073,1582808,Success,United Arab Emirates,DU UAE,Transguard Group LLC,API User,E6AEAE17361
2022-02-15 19:12,72402934,"19,670.0660","19,665.1660",05.00 AED,5.00,4.9000,0.1000,564206219,1582811,Success,United Arab Emirates,DU UAE,Transguard Group LLC,API User,E6AEAE17361
2022-02-15 19:14,72403116,"19,665.1660","19,655.3660",10.00 AED,10.00,9.8000,0.2000,564206663,1582820,Success,United Arab Emirates,DU UAE,Transguard Group LLC,API User,E6AEAE22430
2022-02-15 19:14,72403125,"19,655.3660","19,645.5660",10.00 AED,10.00,9.8000,0.2000,564206682,1582822,Success,United Arab Emirates,DU UAE,Transguard Group LLC,API User,E6AEAE22430
2022-02-15 19:14,72403201,"19,645.5660","19,640.6660",05.00 AED,5.00,4.9000,0.1000,564206857,1582828,Success,United Arab Emirates,DU UAE,Transguard Group LLC,API User,E6AEAE17361
2022-02-15 19:15,72403359,"19,640.6660","19,611.2660",30.00 AED,30.00,29.4000,0.6000,564207243,1582833,Success,United Arab Emirates,DU UAE,Transguard Group LLC,API User,E6AEAE46146
2022-02-15 19:18,72403571,"19,611.2660","19,606.3660",05.00 AED,5.00,4.9000,0.1000,564207755,1582837,Success,United Arab Emirates,DU UAE,Transguard Group LLC,API User,E6AEAE17361
2022-02-15 19:19,72403679,"19,606.3660","19,601.4660",05.00 AED,5.00,4.9000,0.1000,564208013,1582844,Success,United Arab Emirates,DU UAE,Transguard Group LLC,API User,E6AEAE17361
2022-02-15 19:19,72403690,"19,601.4660","19,596.5660",05.00 AED,5.00,4.9000,0.1000,564208040,1582845,Success,United Arab Emirates,DU UAE,Transguard Group LLC,API User,E6AEAE17361
2022-02-15 19:20,72403816,"19,596.5660","19,591.6660",05.00 AED,5.00,4.9000,0.1000,564208393,1582849,Success,United Arab Emirates,DU UAE,Transguard Group LLC,API User,E6AEAE17361
2022-02-15 19:20,72403850,"19,591.6660","19,586.7660",05.00 AED,5.00,4.9000,0.1000,564208470,1582853,Success,United Arab Emirates,DU UAE,Transguard Group LLC,API User,E6AEAE17361
2022-02-15 19:21,72403952,"19,586.7660","19,581.8660",05.00 AED,5.00,4.9000,0.1000,564208698,1582856,Success,United Arab Emirates,DU UAE,Transguard Group LLC,API User,E6AEAE17361
2022-02-15 19:22,72404037,"19,581.8660","19,576.9660",05.00 AED,5.00,4.9000,0.1000,564208931,1582860,Success,United Arab Emirates,DU UAE,Transguard Group LLC,API User,E6AEAE17361
2022-02-15 19:23,72404095,"19,576.9660","19,572.5660",50.00 PHP,5.00,4.4000,0.6000,564209060,1582867,Success,Philippines,BS_Globe Philippines,Transguard Group LLC,API User,PH_GB_TopUp_50.00
2022-02-15 19:23,72404125,"19,572.5660","19,562.7660",10.00 AED,10.00,9.8000,0.2000,564209143,1582871,Success,United Arab Emirates,DU UAE,Transguard Group LLC,API User,E6AEAE22430
2022-02-15 19:23,72404144,"19,562.7660","19,552.9660",10.00 AED,10.00,9.8000,0.2000,564209176,1582872,Success,United Arab Emirates,DU UAE,Transguard Group LLC,API User,E6AEAE22430
2022-02-15 19:24,72404282,"19,552.9660","19,533.3660",20.00 AED,20.00,19.6000,0.4000,564209531,1582880,Success,United Arab Emirates,DU UAE,Transguard Group LLC,API User,E6AEAE12938
2022-02-15 19:25,72404330,"19,533.3660","19,524.5660",100.00 PHP,10.00,8.8000,1.2000,564209644,1582882,Success,Philippines,BS_Globe Philippines,Transguard Group LLC,API User,PH_GB_TopUp_100.00
2022-02-15 19:28,72404674,"19,524.5660","19,519.6660",05.00 AED,5.00,4.9000,0.1000,564210506,1582898,Success,United Arab Emirates,DU UAE,Transguard Group LLC,API User,E6AEAE17361
2022-02-15 19:30,72404879,"19,519.6660","19,514.7660",05.00 AED,5.00,4.9000,0.1000,564211025,1582908,Success,United Arab Emirates,DU UAE,Transguard Group LLC,API User,E6AEAE17361
2022-02-15 19:31,72405020,"19,514.7660","19,509.8660",05.00 AED,5.00,4.9000,0.1000,564211362,1582915,Success,United Arab Emirates,DU UAE,Transguard Group LLC,API User,E6AEAE17361
2022-02-15 19:31,72405042,"19,509.8660","19,480.4660",30.00 AED,30.00,29.4000,0.6000,564211427,1582917,Success,United Arab Emirates,DU UAE,Transguard Group LLC,API User,E6AEAE46146
2022-02-15 19:33,72405156,"19,480.4660","19,465.7660",15.00 AED,15.00,14.7000,0.3000,564211697,1582926,Success,United Arab Emirates,DU UAE,Transguard Group LLC,API User,E6AEAE8527
2022-02-15 19:33,72405177,"19,465.7660","19,455.9660",10.00 AED,10.00,9.8000,0.2000,564211747,1582927,Success,United Arab Emirates,DU UAE,Transguard Group LLC,API User,E6AEAE22430
2022-02-15 19:34,72405289,"19,455.9660","19,451.0660",05.00 AED,5.00,4.9000,0.1000,564212039,1582932,Success,United Arab Emirates,DU UAE,Transguard Group LLC,API User,E6AEAE17361
2022-02-15 19:38,72405704,"19,451.0660","19,441.2660",10.00 AED,10.00,9.8000,0.2000,564213040,1582948,Success,United Arab Emirates,DU UAE,Transguard Group LLC,API User,E6AEAE22430
2022-02-15 19:39,72405858,"19,441.2660","19,436.3660",05.00 AED,5.00,4.9000,0.1000,564213407,1582957,Success,United Arab Emirates,DU UAE,Transguard Group LLC,API User,E6AEAE17361
2022-02-15 19:39,72405864,"19,436.3660","19,431.4660",05.00 AED,5.00,4.9000,0.1000,564213427,1582958,Success,United Arab Emirates,DU UAE,Transguard Group LLC,API User,E6AEAE17361
2022-02-15 19:41,72406045,"19,431.4660","19,426.5660",05.00 AED,5.00,4.9000,0.1000,564213915,1582969,Success,United Arab Emirates,DU UAE,Transguard Group LLC,API User,E6AEAE17361
2022-02-15 19:41,72406077,"19,426.5660","19,416.7660",10.00 AED,10.00,9.8000,0.2000,564214007,1582971,Success,United Arab Emirates,DU UAE,Transguard Group LLC,API User,E6AEAE22430
2022-02-15 19:42,72406183,"19,416.7660","19,411.8660",05.00 AED,5.00,4.9000,0.1000,564214270,1582981,Success,United Arab Emirates,DU UAE,Transguard Group LLC,API User,E6AEAE17361
2022-02-15 19:43,72406241,"19,411.8660","19,394.9260",470.00 NPR,19.25,16.9400,2.3100,564214413,1582983,Success,Nepal,Ncell Nepal,Transguard Group LLC,API User,NCNPNP37643
2022-02-15 19:44,72406325,"19,394.9260","19,390.9660",500.00 XAF,4.50,3.9600,0.5400,564214628,1582987,Success,Cameroon,MTN Cameroon,Transguard Group LLC,API User,CM_MT_TopUp_500.00
2022-02-15 19:45,72406469,"19,390.9660","19,386.0660",05.00 AED,5.00,4.9000,0.1000,564214973,1582991,Success,United Arab Emirates,DU UAE,Transguard Group LLC,API User,E6AEAE17361
2022-02-15 19:49,72406903,"19,386.0660","19,376.2660",10.00 AED,10.00,9.8000,0.2000,564216108,1582994,Success,United Arab Emirates,DU UAE,Transguard Group LLC,API User,E6AEAE22430
2022-02-15 19:55,72407515,"19,376.2660","19,371.3660",05.00 AED,5.00,4.9000,0.1000,564217718,1583017,Success,United Arab Emirates,DU UAE,Transguard Group LLC,API User,E6AEAE17361
2022-02-15 19:56,72407528,"19,371.3660","19,366.4660",05.00 AED,5.00,4.9000,0.1000,564217745,1583019,Success,United Arab Emirates,DU UAE,Transguard Group LLC,API User,E6AEAE17361
2022-02-15 19:56,72407565,"19,366.4660","19,356.6660",10.00 AED,10.00,9.8000,0.2000,564217827,1583022,Success,United Arab Emirates,DU UAE,Transguard Group LLC,API User,E6AEAE22430
2022-02-15 19:57,72407713,"19,356.6660","19,351.7660",05.00 AED,5.00,4.9000,0.1000,564218221,1583037,Success,United Arab Emirates,DU UAE,Transguard Group LLC,API User,E6AEAE17361
2022-02-15 19:57,72407722,"19,351.7660","19,341.9660",10.00 AED,10.00,9.8000,0.2000,564218250,1583040,Success,United Arab Emirates,DU UAE,Transguard Group LLC,API User,E6AEAE22430
2022-02-15 19:59,72407848,"19,341.9660","19,332.1660",10.00 AED,10.00,9.8000,0.2000,564218563,1583050,Success,United Arab Emirates,DU UAE,Transguard Group LLC,API User,E6AEAE22430
2022-02-15 19:59,72407870,"19,332.1660","19,327.2660",05.00 AED,5.00,4.9000,0.1000,564218629,1583052,Success,United Arab Emirates,DU UAE,Transguard Group LLC,API User,E6AEAE17361
2022-02-15 20:00,72407979,"19,327.2660","19,322.3660",05.00 AED,5.00,4.9000,0.1000,564218916,1583059,Success,United Arab Emirates,DU UAE,Transguard Group LLC,API User,E6AEAE17361
2022-02-15 20:02,72408154,"19,322.3660","19,302.7660",20.00 AED,20.00,19.6000,0.4000,564219350,1583067,Success,United Arab Emirates,DU UAE,Transguard Group LLC,API User,E6AEAE12938
2022-02-15 20:04,72408385,"19,302.7660","19,297.8660",05.00 AED,5.00,4.9000,0.1000,564219903,1583085,Success,United Arab Emirates,DU UAE,Transguard Group LLC,API User,E6AEAE17361
2022-02-15 20:05,72408536,"19,297.8660","19,293.6860",150.00 PKR,4.75,4.1800,0.5700,564220347,1583092,Success,Pakistan,Jazz Pakistan,Transguard Group LLC,API User,MBPKPK20699
2022-02-15 20:06,72408626,"19,293.6860","19,288.7860",05.00 AED,5.00,4.9000,0.1000,564220562,1583098,Success,United Arab Emirates,DU UAE,Transguard Group LLC,API User,E6AEAE17361
2022-02-15 20:06,72408662,"19,288.7860","19,283.8860",05.00 AED,5.00,4.9000,0.1000,564220656,1583102,Success,United Arab Emirates,DU UAE,Transguard Group LLC,API User,E6AEAE17361
2022-02-15 20:07,72408698,"19,283.8860","19,274.0860",10.00 AED,10.00,9.8000,0.2000,564220749,1583107,Success,United Arab Emirates,DU UAE,Transguard Group LLC,API User,E6AEAE22430
2022-02-15 20:07,72408705,"19,274.0860","19,269.1860",05.00 AED,5.00,4.9000,0.1000,564220780,1583109,Success,United Arab Emirates,DU UAE,Transguard Group LLC,API User,E6AEAE17361
2022-02-15 20:07,72408734,"19,269.1860","19,259.3860",10.00 AED,10.00,9.8000,0.2000,564220831,1583111,Success,United Arab Emirates,DU UAE,Transguard Group LLC,API User,E6AEAE22430
2022-02-15 20:08,72408787,"19,259.3860","19,254.4860",05.00 AED,5.00,4.9000,0.1000,564220961,1583117,Success,United Arab Emirates,DU UAE,Transguard Group LLC,API User,E6AEAE17361
2022-02-15 20:10,72409007,"19,254.4860","19,249.5860",05.00 AED,5.00,4.9000,0.1000,564221544,1583123,Success,United Arab Emirates,DU UAE,Transguard Group LLC,API User,E6AEAE17361
2022-02-15 20:11,72409152,"19,249.5860","19,229.9860",20.00 AED,20.00,19.6000,0.4000,564221963,1583131,Success,United Arab Emirates,DU UAE,Transguard Group LLC,API User,E6AEAE12938
2022-02-15 20:12,72409267,"19,229.9860","19,190.7860",40.00 AED,40.00,39.2000,0.8000,564222239,1583133,Success,United Arab Emirates,DU UAE,Transguard Group LLC,API User,E6AEAE64011
2022-02-15 20:13,72409356,"19,190.7860","19,185.8860",05.00 AED,5.00,4.9000,0.1000,564222446,1583136,Success,United Arab Emirates,DU UAE,Transguard Group LLC,API User,E6AEAE17361
2022-02-15 20:15,72409536,"19,185.8860","19,176.0860",10.00 AED,10.00,9.8000,0.2000,564222948,1583140,Success,United Arab Emirates,DU UAE,Transguard Group LLC,API User,E6AEAE22430
2022-02-15 20:16,72409610,"19,176.0860","19,171.1860",05.00 AED,5.00,4.9000,0.1000,564223185,1583145,Success,United Arab Emirates,DU UAE,Transguard Group LLC,API User,E6AEAE17361
2022-02-15 20:21,72410115,"19,171.1860","19,166.2860",05.00 AED,5.00,4.9000,0.1000,564224507,1583168,Success,United Arab Emirates,DU UAE,Transguard Group LLC,API User,E6AEAE17361
2022-02-15 20:21,72410120,"19,166.2860","19,161.3860",05.00 AED,5.00,4.9000,0.1000,564224532,1583169,Success,United Arab Emirates,DU UAE,Transguard Group LLC,API User,E6AEAE17361
2022-02-15 20:23,72410295,"19,161.3860","19,156.4860",05.00 AED,5.00,4.9000,0.1000,564224992,1583175,Success,United Arab Emirates,DU UAE,Transguard Group LLC,API User,E6AEAE17361
2022-02-15 20:23,72410309,"19,156.4860","19,146.6860",10.00 AED,10.00,9.8000,0.2000,564225003,1583176,Success,United Arab Emirates,DU UAE,Transguard Group LLC,API User,E6AEAE22430
2022-02-15 20:25,72410478,"19,146.6860","19,141.7860",05.00 AED,5.00,4.9000,0.1000,564225439,1583180,Success,United Arab Emirates,DU UAE,Transguard Group LLC,API User,E6AEAE17361
2022-02-15 20:25,72410539,"19,141.7860","19,131.9860",10.00 AED,10.00,9.8000,0.2000,564225604,1583184,Success,United Arab Emirates,DU UAE,Transguard Group LLC,API User,E6AEAE22430
2022-02-15 20:27,72410764,"19,131.9860","19,122.1860",10.00 AED,10.00,9.8000,0.2000,564226149,1583193,Success,United Arab Emirates,DU UAE,Transguard Group LLC,API User,E6AEAE22430
2022-02-15 20:27,72410788,"19,122.1860","19,117.2860",05.00 AED,5.00,4.9000,0.1000,564226215,1583195,Success,United Arab Emirates,DU UAE,Transguard Group LLC,API User,E6AEAE17361
2022-02-15 20:28,72410824,"19,117.2860","19,107.4860",10.00 AED,10.00,9.8000,0.2000,564226334,1583197,Success,United Arab Emirates,DU UAE,Transguard Group LLC,API User,E6AEAE22430
2022-02-15 20:28,72410848,"19,107.4860","19,102.5860",05.00 AED,5.00,4.9000,0.1000,564226410,1583203,Success,United Arab Emirates,DU UAE,Transguard Group LLC,API User,E6AEAE17361
2022-02-15 20:31,72411096,"19,102.5860","19,087.8860",15.00 AED,15.00,14.7000,0.3000,564227126,1583220,Success,United Arab Emirates,DU UAE,Transguard Group LLC,API User,E6AEAE8527
2022-02-15 20:32,72411254,"19,087.8860","19,068.2860",20.00 AED,20.00,19.6000,0.4000,564227565,1583225,Success,United Arab Emirates,DU UAE,Transguard Group LLC,API User,E6AEAE12938
2022-02-15 20:36,72411624,"19,068.2860","19,063.3860",05.00 AED,5.00,4.9000,0.1000,564228590,1583231,Success,United Arab Emirates,DU UAE,Transguard Group LLC,API User,E6AEAE17361
2022-02-15 20:39,72411944,"19,063.3860","19,058.4860",05.00 AED,5.00,4.9000,0.1000,564229472,1583239,Success,United Arab Emirates,DU UAE,Transguard Group LLC,API User,E6AEAE17361
2022-02-15 20:43,72412287,"19,058.4860","19,053.5860",05.00 AED,5.00,4.9000,0.1000,564230394,1583250,Success,United Arab Emirates,DU UAE,Transguard Group LLC,API User,E6AEAE17361
2022-02-15 20:44,72412401,"19,053.5860","19,043.7860",10.00 AED,10.00,9.8000,0.2000,564230723,1583254,Success,United Arab Emirates,DU UAE,Transguard Group LLC,API User,E6AEAE22430
2022-02-15 20:44,72412433,"19,043.7860","19,033.9860",10.00 AED,10.00,9.8000,0.2000,564230793,1583258,Success,United Arab Emirates,DU UAE,Transguard Group LLC,API User,E6AEAE22430
2022-02-15 20:45,72412500,"19,033.9860","19,029.0860",05.00 AED,5.00,4.9000,0.1000,564230982,1583265,Success,United Arab Emirates,DU UAE,Transguard Group LLC,API User,E6AEAE17361
2022-02-15 20:45,72412533,"19,029.0860","19,020.2860",13.20 GHS,10.00,8.8000,1.2000,564231050,1583266,Success,Ghana,MTN Ghana,Transguard Group LLC,API User,GH_MT_TopUp
2022-02-15 20:46,72412578,"19,020.2860","19,010.4860",10.00 AED,10.00,9.8000,0.2000,564231200,1583272,Success,United Arab Emirates,DU UAE,Transguard Group LLC,API User,E6AEAE22430
2022-02-15 20:46,72412612,"19,010.4860","19,005.5860",05.00 AED,5.00,4.9000,0.1000,564231297,1583276,Success,United Arab Emirates,DU UAE,Transguard Group LLC,API User,E6AEAE17361
2022-02-15 20:46,72412628,"19,005.5860","19,000.6860",05.00 AED,5.00,4.9000,0.1000,564231335,1583278,Success,United Arab Emirates,DU UAE,Transguard Group LLC,API User,E6AEAE17361
2022-02-15 20:48,72412824,"19,000.6860","18,996.2860",06.60 GHS,5.00,4.4000,0.6000,564231728,1583285,Success,Ghana,MTN Ghana,Transguard Group LLC,API User,GH_MT_TopUp
2022-02-15 20:48,72412847,"18,996.2860","18,991.3860",05.00 AED,5.00,4.9000,0.1000,564231887,1583294,Success,United Arab Emirates,DU UAE,Transguard Group LLC,API User,E6AEAE17361
2022-02-15 20:48,72412853,"18,991.3860","18,981.5860",10.00 AED,10.00,9.8000,0.2000,564231909,1583295,Success,United Arab Emirates,DU UAE,Transguard Group LLC,API User,E6AEAE22430
2022-02-15 20:51,72413091,"18,981.5860","18,976.6860",05.00 AED,5.00,4.9000,0.1000,564232512,1583307,Success,United Arab Emirates,DU UAE,Transguard Group LLC,API User,E6AEAE17361
2022-02-15 20:51,72413112,"18,976.6860","18,971.7860",05.00 AED,5.00,4.9000,0.1000,564232562,1583309,Success,United Arab Emirates,DU UAE,Transguard Group LLC,API User,E6AEAE17361
2022-02-15 20:51,72413120,"18,971.7860","18,966.8860",05.00 AED,5.00,4.9000,0.1000,564232577,1583310,Success,United Arab Emirates,DU UAE,Transguard Group LLC,API User,E6AEAE17361
2022-02-15 20:54,72413353,"18,966.8860","18,961.9860",05.00 AED,5.00,4.9000,0.1000,564233211,1583317,Success,United Arab Emirates,DU UAE,Transguard Group LLC,API User,E6AEAE17361
2022-02-15 20:54,72413412,"18,961.9860","18,957.0860",05.00 AED,5.00,4.9000,0.1000,564233386,1583320,Success,United Arab Emirates,DU UAE,Transguard Group LLC,API User,E6AEAE17361
2022-02-15 20:56,72413617,"18,957.0860","18,947.2860",10.00 AED,10.00,9.8000,0.2000,564233939,1583329,Success,United Arab Emirates,DU UAE,Transguard Group LLC,API User,E6AEAE22430
2022-02-15 20:57,72413674,"18,947.2860","18,943.5460",100.00 NPR,4.25,3.7400,0.5100,564234096,1583332,Success,Nepal,Ncell Nepal,Transguard Group LLC,API User,NP_NC_TopUp_100.00
2022-02-15 20:58,72413767,"18,943.5460","18,938.6460",05.00 AED,5.00,4.9000,0.1000,564234344,1583338,Success,United Arab Emirates,DU UAE,Transguard Group LLC,API User,E6AEAE17361
2022-02-15 21:00,72413981,"18,938.6460","18,925.8860",460.00 PKR,14.50,12.7600,1.7400,564234913,1583341,Success,Pakistan,Jazz Pakistan,Transguard Group LLC,API User,MBPKPK49413
2022-02-15 21:05,72414431,"18,925.8860","18,920.9860",05.00 AED,5.00,4.9000,0.1000,564236154,1583363,Success,United Arab Emirates,DU UAE,Transguard Group LLC,API User,E6AEAE17361
2022-02-15 21:06,72414502,"18,920.9860","18,911.1860",10.00 AED,10.00,9.8000,0.2000,564236305,1583365,Success,United Arab Emirates,DU UAE,Transguard Group LLC,API User,E6AEAE22430
2022-02-15 21:06,72414562,"18,911.1860","18,901.3860",10.00 AED,10.00,9.8000,0.2000,564236472,1583372,Success,United Arab Emirates,DU UAE,Transguard Group LLC,API User,E6AEAE22430
2022-02-15 21:06,72414576,"18,901.3860","18,896.4860",05.00 AED,5.00,4.9000,0.1000,564236488,1583373,Success,United Arab Emirates,DU UAE,Transguard Group LLC,API User,E6AEAE17361
2022-02-15 21:08,72414783,"18,896.4860","18,876.8860",20.00 AED,20.00,19.6000,0.4000,564237042,1583384,Success,United Arab Emirates,DU UAE,Transguard Group LLC,API User,E6AEAE12938
2022-02-15 21:09,72414848,"18,876.8860","18,867.0860",10.00 AED,10.00,9.8000,0.2000,564237218,1583391,Success,United Arab Emirates,DU UAE,Transguard Group LLC,API User,E6AEAE22430
2022-02-15 21:10,72414920,"18,867.0860","18,862.1860",05.00 AED,5.00,4.9000,0.1000,564237433,1583395,Success,United Arab Emirates,DU UAE,Transguard Group LLC,API User,E6AEAE17361
2022-02-15 21:11,72415028,"18,862.1860","18,842.5860",20.00 AED,20.00,19.6000,0.4000,564237714,1583399,Success,United Arab Emirates,DU UAE,Transguard Group LLC,API User,E6AEAE12938
2022-02-15 21:12,72415147,"18,842.5860","18,837.6860",05.00 AED,5.00,4.9000,0.1000,564238013,1583405,Success,United Arab Emirates,DU UAE,Transguard Group LLC,API User,E6AEAE17361
2022-02-15 21:14,72415276,"18,837.6860","18,832.7860",05.00 AED,5.00,4.9000,0.1000,564238374,1583414,Success,United Arab Emirates,DU UAE,Transguard Group LLC,API User,E6AEAE17361
2022-02-15 21:14,72415288,"18,832.7860","18,793.5860",40.00 AED,40.00,39.2000,0.8000,564238406,1583416,Success,United Arab Emirates,DU UAE,Transguard Group LLC,API User,E6AEAE64011
2022-02-15 21:15,72415333,"18,793.5860","18,788.6860",05.00 AED,5.00,4.9000,0.1000,564238566,1583421,Success,United Arab Emirates,DU UAE,Transguard Group LLC,API User,E6AEAE17361
2022-02-15 21:15,72415381,"18,788.6860","18,769.0860",20.00 AED,20.00,19.6000,0.4000,564238709,1583425,Success,United Arab Emirates,DU UAE,Transguard Group LLC,API User,E6AEAE12938
2022-02-15 21:16,72415467,"18,769.0860","18,765.3460",100.00 NPR,4.25,3.7400,0.5100,564238989,1583435,Success,Nepal,Ncell Nepal,Transguard Group LLC,API User,NP_NC_TopUp_100.00
2022-02-15 21:17,72415585,"18,765.3460","18,755.5460",10.00 AED,10.00,9.8000,0.2000,564239298,1583442,Success,United Arab Emirates,DU UAE,Transguard Group LLC,API User,E6AEAE22430
2022-02-15 21:18,72415646,"18,755.5460","18,745.7460",10.00 AED,10.00,9.8000,0.2000,564239482,1583449,Success,United Arab Emirates,DU UAE,Transguard Group LLC,API User,E6AEAE22430
2022-02-15 21:18,72415652,"18,745.7460","18,731.0460",15.00 AED,15.00,14.7000,0.3000,564239501,1583451,Success,United Arab Emirates,DU UAE,Transguard Group LLC,API User,E6AEAE8527
2022-02-15 21:19,72415678,"18,731.0460","18,726.1460",05.00 AED,5.00,4.9000,0.1000,564239573,1583453,Success,United Arab Emirates,DU UAE,Transguard Group LLC,API User,E6AEAE17361
2022-02-15 21:19,72415750,"18,726.1460","18,721.2460",05.00 AED,5.00,4.9000,0.1000,564239776,1583458,Success,United Arab Emirates,DU UAE,Transguard Group LLC,API User,E6AEAE17361
2022-02-15 21:20,72415801,"18,721.2460","18,711.4460",10.00 AED,10.00,9.8000,0.2000,564239950,1583468,Success,United Arab Emirates,DU UAE,Transguard Group LLC,API User,E6AEAE22430
2022-02-15 21:21,72415904,"18,711.4460","18,706.5460",05.00 AED,5.00,4.9000,0.1000,564240261,1583478,Success,United Arab Emirates,DU UAE,Transguard Group LLC,API User,E6AEAE17361
2022-02-15 21:21,72415905,"18,706.5460","18,667.3460",40.00 AED,40.00,39.2000,0.8000,564240262,1583479,Success,United Arab Emirates,DU UAE,Transguard Group LLC,API User,E6AEAE64011
2022-02-15 21:21,72415916,"18,667.3460","18,657.5460",10.00 AED,10.00,9.8000,0.2000,564240280,1583481,Success,United Arab Emirates,DU UAE,Transguard Group LLC,API User,E6AEAE22430
2022-02-15 21:22,72415951,"18,657.5460","18,647.7460",10.00 AED,10.00,9.8000,0.2000,564240361,1583482,Success,United Arab Emirates,DU UAE,Transguard Group LLC,API User,E6AEAE22430
2022-02-15 21:24,72416190,"18,647.7460","18,642.8460",05.00 AED,5.00,4.9000,0.1000,564240967,1583491,Success,United Arab Emirates,DU UAE,Transguard Group LLC,API User,E6AEAE17361
2022-02-15 21:24,72416203,"18,642.8460","18,613.4460",30.00 AED,30.00,29.4000,0.6000,564240993,1583492,Success,United Arab Emirates,DU UAE,Transguard Group LLC,API User,E6AEAE46146
2022-02-15 21:25,72416285,"18,613.4460","18,593.8460",20.00 AED,20.00,19.6000,0.4000,564241259,1583495,Success,United Arab Emirates,DU UAE,Transguard Group LLC,API User,E6AEAE12938
2022-02-15 21:26,72416369,"18,593.8460","18,569.3460",25.00 AED,25.00,24.5000,0.5000,564241506,1583504,Success,United Arab Emirates,DU UAE,Transguard Group LLC,API User,E6AEAE17343
2022-02-15 21:27,72416386,"18,569.3460","18,549.7460",20.00 AED,20.00,19.6000,0.4000,564241563,1583506,Success,United Arab Emirates,DU UAE,Transguard Group LLC,API User,E6AEAE12938
2022-02-15 21:27,72416427,"18,549.7460","18,545.3460","3,675.41 UGX",5.00,4.4000,0.6000,564241697,1583512,Success,Uganda,MTN Uganda,Transguard Group LLC,API User,UG_MT_TopUp
2022-02-15 21:27,72416452,"18,545.3460","18,535.5460",10.00 AED,10.00,9.8000,0.2000,564241739,1583514,Success,United Arab Emirates,DU UAE,Transguard Group LLC,API User,E6AEAE22430
2022-02-15 21:28,72416536,"18,535.5460","18,525.7460",10.00 AED,10.00,9.8000,0.2000,564241982,1583519,Success,United Arab Emirates,DU UAE,Transguard Group LLC,API User,E6AEAE22430
2022-02-15 21:30,72416673,"18,525.7460","18,515.9460",10.00 AED,10.00,9.8000,0.2000,564242369,1583524,Success,United Arab Emirates,DU UAE,Transguard Group LLC,API User,E6AEAE22430
2022-02-15 21:31,72416782,"18,515.9460","18,511.0460",05.00 AED,5.00,4.9000,0.1000,564242635,1583533,Success,United Arab Emirates,DU UAE,Transguard Group LLC,API User,E6AEAE17361
2022-02-15 21:32,72416901,"18,511.0460","18,502.2460","7,350.82 UGX",10.00,8.8000,1.2000,564242953,1583540,Success,Uganda,MTN Uganda,Transguard Group LLC,API User,UG_MT_TopUp
2022-02-15 21:33,72417031,"18,502.2460","18,497.3460",05.00 AED,5.00,4.9000,0.1000,564243283,1583548,Success,United Arab Emirates,DU UAE,Transguard Group LLC,API User,E6AEAE17361
2022-02-15 21:34,72417045,"18,497.3460","18,492.4460",05.00 AED,5.00,4.9000,0.1000,564243330,1583550,Success,United Arab Emirates,DU UAE,Transguard Group LLC,API User,E6AEAE17361
2022-02-15 21:34,72417078,"18,492.4460","18,487.5460",05.00 AED,5.00,4.9000,0.1000,564243408,1583553,Success,United Arab Emirates,DU UAE,Transguard Group LLC,API User,E6AEAE17361
2022-02-15 21:35,72417136,"18,487.5460","18,482.6460",05.00 AED,5.00,4.9000,0.1000,564243577,1583556,Success,United Arab Emirates,DU UAE,Transguard Group LLC,API User,E6AEAE17361
2022-02-15 21:37,72417324,"18,482.6460","18,472.8460",10.00 AED,10.00,9.8000,0.2000,564244102,1583562,Success,United Arab Emirates,DU UAE,Transguard Group LLC,API User,E6AEAE22430
2022-02-15 21:39,72417519,"18,472.8460","18,463.0460",10.00 AED,10.00,9.8000,0.2000,564244616,1583570,Success,United Arab Emirates,DU UAE,Transguard Group LLC,API User,E6AEAE22430
2022-02-15 21:39,72417566,"18,463.0460","18,458.1460",05.00 AED,5.00,4.9000,0.1000,564244726,1583574,Success,United Arab Emirates,DU UAE,Transguard Group LLC,API User,E6AEAE17361
2022-02-15 21:40,72417624,"18,458.1460","18,453.2460",05.00 AED,5.00,4.9000,0.1000,564244918,1583577,Success,United Arab Emirates,DU UAE,Transguard Group LLC,API User,E6AEAE17361
2022-02-15 21:41,72417737,"18,453.2460","18,448.3460",05.00 AED,5.00,4.9000,0.1000,564245215,1583584,Success,United Arab Emirates,DU UAE,Transguard Group LLC,API User,E6AEAE17361
2022-02-15 21:42,72417784,"18,448.3460","18,443.4460",05.00 AED,5.00,4.9000,0.1000,564245318,1583588,Success,United Arab Emirates,DU UAE,Transguard Group LLC,API User,E6AEAE17361
2022-02-15 21:44,72417945,"18,443.4460","18,433.6460",10.00 AED,10.00,9.8000,0.2000,564245763,1583597,Success,United Arab Emirates,DU UAE,Transguard Group LLC,API User,E6AEAE22430
2022-02-15 21:44,72418003,"18,433.6460","18,423.8460",10.00 AED,10.00,9.8000,0.2000,564245931,1583602,Success,United Arab Emirates,DU UAE,Transguard Group LLC,API User,E6AEAE22430
2022-02-15 21:45,72418057,"18,423.8460","18,414.0460",10.00 AED,10.00,9.8000,0.2000,564246079,1583606,Success,United Arab Emirates,DU UAE,Transguard Group LLC,API User,E6AEAE22430
2022-02-15 21:45,72418061,"18,414.0460","18,384.6460",30.00 AED,30.00,29.4000,0.6000,564246086,1583607,Success,United Arab Emirates,DU UAE,Transguard Group LLC,API User,E6AEAE46146
2022-02-15 21:45,72418077,"18,384.6460","18,379.7460",05.00 AED,5.00,4.9000,0.1000,564246126,1583608,Success,United Arab Emirates,DU UAE,Transguard Group LLC,API User,E6AEAE17361
2022-02-15 21:46,72418172,"18,379.7460","18,369.9460",10.00 AED,10.00,9.8000,0.2000,564246395,1583615,Success,United Arab Emirates,DU UAE,Transguard Group LLC,API User,E6AEAE22430
2022-02-15 21:46,72418200,"18,369.9460","18,365.0460",05.00 AED,5.00,4.9000,0.1000,564246453,1583616,Success,United Arab Emirates,DU UAE,Transguard Group LLC,API User,E6AEAE17361
2022-02-15 21:48,72418403,"18,365.0460","18,355.2460",10.00 AED,10.00,9.8000,0.2000,564246951,1583624,Success,United Arab Emirates,DU UAE,Transguard Group LLC,API User,E6AEAE22430
2022-02-15 21:50,72418536,"18,355.2460","18,350.3460",05.00 AED,5.00,4.9000,0.1000,564247347,1583631,Success,United Arab Emirates,DU UAE,Transguard Group LLC,API User,E6AEAE17361
2022-02-15 21:50,72418599,"18,350.3460","18,340.5460",10.00 AED,10.00,9.8000,0.2000,564247501,1583633,Success,United Arab Emirates,DU UAE,Transguard Group LLC,API User,E6AEAE22430
2022-02-15 21:51,72418651,"18,340.5460","18,330.7460",10.00 AED,10.00,9.8000,0.2000,564247664,1583636,Success,United Arab Emirates,DU UAE,Transguard Group LLC,API User,E6AEAE22430
2022-02-15 21:52,72418698,"18,330.7460","18,325.8460",05.00 AED,5.00,4.9000,0.1000,564247776,1583640,Success,United Arab Emirates,DU UAE,Transguard Group LLC,API User,E6AEAE17361
2022-02-15 21:52,72418726,"18,325.8460","18,316.0460",10.00 AED,10.00,9.8000,0.2000,564247860,1583642,Success,United Arab Emirates,DU UAE,Transguard Group LLC,API User,E6AEAE22430
2022-02-15 21:53,72418826,"18,316.0460","18,311.1460",05.00 AED,5.00,4.9000,0.1000,564248122,1583645,Success,United Arab Emirates,DU UAE,Transguard Group LLC,API User,E6AEAE17361
2022-02-15 21:56,72419053,"18,311.1460","18,306.2460",05.00 AED,5.00,4.9000,0.1000,564248769,1583650,Success,United Arab Emirates,DU UAE,Transguard Group LLC,API User,E6AEAE17361
2022-02-15 22:01,72419508,"18,306.2460","18,301.3460",05.00 AED,5.00,4.9000,0.1000,564250039,1583656,Success,United Arab Emirates,DU UAE,Transguard Group LLC,API User,E6AEAE17361
2022-02-15 22:01,72419521,"18,301.3460","18,296.4460",05.00 AED,5.00,4.9000,0.1000,564250073,1583657,Success,United Arab Emirates,DU UAE,Transguard Group LLC,API User,E6AEAE17361
2022-02-15 22:04,72419715,"18,296.4460","18,291.5460",05.00 AED,5.00,4.9000,0.1000,564250663,1583662,Success,United Arab Emirates,DU UAE,Transguard Group LLC,API User,E6AEAE17361
2022-02-15 22:06,72419892,"18,291.5460","18,286.6460",05.00 AED,5.00,4.9000,0.1000,564251156,1583667,Success,United Arab Emirates,DU UAE,Transguard Group LLC,API User,E6AEAE17361
2022-02-15 22:07,72419928,"18,286.6460","18,281.7460",05.00 AED,5.00,4.9000,0.1000,564251244,1583670,Success,United Arab Emirates,DU UAE,Transguard Group LLC,API User,E6AEAE17361
2022-02-15 22:08,72420024,"18,281.7460","18,276.8460",05.00 AED,5.00,4.9000,0.1000,564251508,1583678,Success,United Arab Emirates,DU UAE,Transguard Group LLC,API User,E6AEAE17361
2022-02-15 22:09,72420097,"18,276.8460","18,271.9460",05.00 AED,5.00,4.9000,0.1000,564251691,1583685,Success,United Arab Emirates,DU UAE,Transguard Group LLC,API User,E6AEAE17361
2022-02-15 22:09,72420117,"18,271.9460","18,267.0460",05.00 AED,5.00,4.9000,0.1000,564251751,1583688,Success,United Arab Emirates,DU UAE,Transguard Group LLC,API User,E6AEAE17361
2022-02-15 22:09,72420135,"18,267.0460","18,239.5460","1,000.00 PKR",31.25,27.5000,3.7500,564251820,1583691,Success,Pakistan,Ufone Pakistan,Transguard Group LLC,API User,PK_UF_TopUp_1000.00
2022-02-15 22:10,72420215,"18,239.5460","18,229.7460",10.00 AED,10.00,9.8000,0.2000,564252076,1583697,Success,United Arab Emirates,DU UAE,Transguard Group LLC,API User,E6AEAE22430
2022-02-15 22:11,72420280,"18,229.7460","18,224.8460",05.00 AED,5.00,4.9000,0.1000,564252323,1583705,Success,United Arab Emirates,DU UAE,Transguard Group LLC,API User,E6AEAE17361
2022-02-15 22:11,72420286,"18,224.8460","18,219.9460",05.00 AED,5.00,4.9000,0.1000,564252337,1583706,Success,United Arab Emirates,DU UAE,Transguard Group LLC,API User,E6AEAE17361
2022-02-15 22:12,72420341,"18,219.9460","18,216.2060",100.00 NPR,4.25,3.7400,0.5100,564252478,1583709,Success,Nepal,Ncell Nepal,Transguard Group LLC,API User,NP_NC_TopUp_100.00
2022-02-15 22:15,72420544,"18,216.2060","18,211.3060",05.00 AED,5.00,4.9000,0.1000,564253144,1583714,Success,United Arab Emirates,DU UAE,Transguard Group LLC,API User,E6AEAE17361
2022-02-15 22:16,72420634,"18,211.3060","18,201.5060",10.00 AED,10.00,9.8000,0.2000,564253414,1583717,Success,United Arab Emirates,DU UAE,Transguard Group LLC,API User,E6AEAE22430
2022-02-15 22:19,72420888,"18,201.5060","18,191.7060",10.00 AED,10.00,9.8000,0.2000,564254117,1583720,Success,United Arab Emirates,DU UAE,Transguard Group LLC,API User,E6AEAE22430
2022-02-15 22:23,72421194,"18,191.7060","18,181.9060",10.00 AED,10.00,9.8000,0.2000,564254996,1583727,Success,United Arab Emirates,DU UAE,Transguard Group LLC,API User,E6AEAE22430
2022-02-15 22:24,72421269,"18,181.9060","18,177.0060",05.00 AED,5.00,4.9000,0.1000,564255199,1583730,Success,United Arab Emirates,DU UAE,Transguard Group LLC,API User,E6AEAE17361
2022-02-15 22:26,72421401,"18,177.0060","18,172.1060",05.00 AED,5.00,4.9000,0.1000,564255574,1583733,Success,United Arab Emirates,DU UAE,Transguard Group LLC,API User,E6AEAE17361
2022-02-15 22:28,72421505,"18,172.1060","18,167.2060",05.00 AED,5.00,4.9000,0.1000,564255850,1583737,Success,United Arab Emirates,DU UAE,Transguard Group LLC,API User,E6AEAE17361
2022-02-15 22:30,72421701,"18,167.2060","18,162.3060",05.00 AED,5.00,4.9000,0.1000,564256460,1583745,Success,United Arab Emirates,DU UAE,Transguard Group LLC,API User,E6AEAE17361
2022-02-15 22:30,72421702,"18,162.3060","18,152.5060",10.00 AED,10.00,9.8000,0.2000,564256462,1583746,Success,United Arab Emirates,DU UAE,Transguard Group LLC,API User,E6AEAE22430
2022-02-15 22:32,72421825,"18,152.5060","18,142.7060",10.00 AED,10.00,9.8000,0.2000,564256859,1583758,Success,United Arab Emirates,DU UAE,Transguard Group LLC,API User,E6AEAE22430
2022-02-15 22:32,72421829,"18,142.7060","18,137.8060",05.00 AED,5.00,4.9000,0.1000,564256874,1583759,Success,United Arab Emirates,DU UAE,Transguard Group LLC,API User,E6AEAE17361
2022-02-15 22:33,72421845,"18,137.8060","18,130.5460",200.00 NPR,8.25,7.2600,0.9900,564256908,1583762,Success,Nepal,Nepal Telecom Nepal,Transguard Group LLC,API User,NP_NE_TopUp_200.00
2022-02-15 22:33,72421880,"18,130.5460","18,125.6460",05.00 AED,5.00,4.9000,0.1000,564257001,1583763,Success,United Arab Emirates,DU UAE,Transguard Group LLC,API User,E6AEAE17361
2022-02-15 22:40,72422356,"18,125.6460","18,120.7460",05.00 AED,5.00,4.9000,0.1000,564258412,1583770,Success,United Arab Emirates,DU UAE,Transguard Group LLC,API User,E6AEAE17361
2022-02-15 22:43,72422632,"18,120.7460","18,115.8460",05.00 AED,5.00,4.9000,0.1000,564259144,1583780,Success,United Arab Emirates,DU UAE,Transguard Group LLC,API User,E6AEAE17361
2022-02-15 22:51,72423114,"18,115.8460","18,110.9460",05.00 AED,5.00,4.9000,0.1000,564260626,1583786,Success,United Arab Emirates,DU UAE,Transguard Group LLC,API User,E6AEAE17361
2022-02-15 22:52,72423221,"18,110.9460","18,071.7460",40.00 AED,40.00,39.2000,0.8000,564260898,1583793,Success,United Arab Emirates,DU UAE,Transguard Group LLC,API User,E6AEAE64011
2022-02-15 22:53,72423301,"18,071.7460","18,052.1460",20.00 AED,20.00,19.6000,0.4000,564261158,1583797,Success,United Arab Emirates,DU UAE,Transguard Group LLC,API User,E6AEAE12938
2022-02-15 22:55,72423403,"18,052.1460","18,047.2460",05.00 AED,5.00,4.9000,0.1000,564261450,1583800,Success,United Arab Emirates,DU UAE,Transguard Group LLC,API User,E6AEAE17361
2022-02-15 22:56,72423461,"18,047.2460","18,042.3460",05.00 AED,5.00,4.9000,0.1000,564261602,1583805,Success,United Arab Emirates,DU UAE,Transguard Group LLC,API User,E6AEAE17361
2022-02-15 22:59,72423696,"18,042.3460","18,032.5460",10.00 AED,10.00,9.8000,0.2000,564262296,1583813,Success,United Arab Emirates,DU UAE,Transguard Group LLC,API User,E6AEAE22430
2022-02-15 23:00,72423777,"18,032.5460","18,022.7460",10.00 AED,10.00,9.8000,0.2000,564262562,1583816,Success,United Arab Emirates,DU UAE,Transguard Group LLC,API User,E6AEAE22430
2022-02-15 23:02,72423913,"18,022.7460","18,012.9460",10.00 AED,10.00,9.8000,0.2000,564262922,1583822,Success,United Arab Emirates,DU UAE,Transguard Group LLC,API User,E6AEAE22430
2022-02-15 23:03,72423939,"18,012.9460","18,003.1460",10.00 AED,10.00,9.8000,0.2000,564262995,1583826,Success,United Arab Emirates,DU UAE,Transguard Group LLC,API User,E6AEAE22430
2022-02-15 23:03,72423956,"18,003.1460","17,998.2460",05.00 AED,5.00,4.9000,0.1000,564263033,1583828,Success,United Arab Emirates,DU UAE,Transguard Group LLC,API User,E6AEAE17361
2022-02-15 23:03,72423993,"17,998.2460","17,993.3460",05.00 AED,5.00,4.9000,0.1000,564263140,1583832,Success,United Arab Emirates,DU UAE,Transguard Group LLC,API User,E6AEAE17361
2022-02-15 23:04,72424018,"17,993.3460","17,988.4460",05.00 AED,5.00,4.9000,0.1000,564263211,1583836,Success,United Arab Emirates,DU UAE,Transguard Group LLC,API User,E6AEAE17361
2022-02-15 23:06,72424133,"17,988.4460","17,978.6460",10.00 AED,10.00,9.8000,0.2000,564263587,1583847,Success,United Arab Emirates,DU UAE,Transguard Group LLC,API User,E6AEAE22430
2022-02-15 23:06,72424188,"17,978.6460","17,954.1460",25.00 AED,25.00,24.5000,0.5000,564263761,1583849,Failure,United Arab Emirates,DU UAE,Transguard Group LLC,API User,E6AEAE25659
2022-02-15 23:06,72424188,"17,954.1460","17,929.6460",25.00 AED,25.00,24.5000,0.5000,564263761,1583849,Failure,United Arab Emirates,DU UAE,Transguard Group LLC,API User,E6AEAE25659
2022-02-15 23:07,72424233,"17,978.6460","17,973.7460",05.00 AED,5.00,4.9000,0.1000,564263865,1583854,Success,United Arab Emirates,DU UAE,Transguard Group LLC,API User,E6AEAE17361
2022-02-15 23:07,72424243,"17,973.7460","17,963.9460",10.00 AED,10.00,9.8000,0.2000,564263886,1583856,Success,United Arab Emirates,DU UAE,Transguard Group LLC,API User,E6AEAE22430
2022-02-15 23:07,72424278,"17,963.9460","17,959.0460",05.00 AED,5.00,4.9000,0.1000,564263955,1583858,Success,United Arab Emirates,DU UAE,Transguard Group LLC,API User,E6AEAE17361
2022-02-15 23:11,72424475,"17,959.0460","17,954.1460",05.00 AED,5.00,4.9000,0.1000,564264568,1583865,Success,United Arab Emirates,DU UAE,Transguard Group LLC,API User,E6AEAE17361
2022-02-15 23:15,72424706,"17,954.1460","17,944.3460",10.00 AED,10.00,9.8000,0.2000,564265297,1583874,Success,United Arab Emirates,DU UAE,Transguard Group LLC,API User,E6AEAE22430
2022-02-15 23:18,72424884,"17,944.3460","17,939.4460",05.00 AED,5.00,4.9000,0.1000,564265884,1583878,Success,United Arab Emirates,DU UAE,Transguard Group LLC,API User,E6AEAE17361
2022-02-15 23:27,72425412,"17,939.4460","17,931.0860",300.00 PKR,9.50,8.3600,1.1400,564267514,1583895,Success,Pakistan,Jazz Pakistan,Transguard Group LLC,API User,PK_MB_TopUp_300.00
2022-02-15 23:28,72425447,"17,931.0860","17,926.1860",05.00 AED,5.00,4.9000,0.1000,564267645,1583897,Success,United Arab Emirates,DU UAE,Transguard Group LLC,API User,E6AEAE17361
2022-02-15 23:29,72425552,"17,926.1860","17,916.3860",10.00 AED,10.00,9.8000,0.2000,564267977,1583901,Success,United Arab Emirates,DU UAE,Transguard Group LLC,API User,E6AEAE22430
2022-02-15 23:30,72425607,"17,916.3860","17,911.4860",05.00 AED,5.00,4.9000,0.1000,564268146,1583905,Success,United Arab Emirates,DU UAE,Transguard Group LLC,API User,E6AEAE17361
2022-02-15 23:35,72425862,"17,911.4860","17,906.5860",05.00 AED,5.00,4.9000,0.1000,564268880,1583913,Success,United Arab Emirates,DU UAE,Transguard Group LLC,API User,E6AEAE17361
2022-02-15 23:35,72425893,"17,906.5860","17,901.6860",05.00 AED,5.00,4.9000,0.1000,564268978,1583916,Success,United Arab Emirates,DU UAE,Transguard Group LLC,API User,E6AEAE17361
2022-02-15 23:36,72425945,"17,901.6860","17,896.7860",05.00 AED,5.00,4.9000,0.1000,564269114,1583920,Success,United Arab Emirates,DU UAE,Transguard Group LLC,API User,E6AEAE17361
2022-02-15 23:36,72425991,"17,896.7860","17,891.8860",05.00 AED,5.00,4.9000,0.1000,564269232,1583922,Success,United Arab Emirates,DU UAE,Transguard Group LLC,API User,E6AEAE17361
2022-02-15 23:37,72426041,"17,891.8860","17,886.9860",05.00 AED,5.00,4.9000,0.1000,564269437,1583925,Success,United Arab Emirates,DU UAE,Transguard Group LLC,API User,E6AEAE17361
2022-02-15 23:38,72426097,"17,886.9860","17,882.0860",05.00 AED,5.00,4.9000,0.1000,564269564,1583928,Success,United Arab Emirates,DU UAE,Transguard Group LLC,API User,E6AEAE17361
2022-02-15 23:46,72426573,"17,882.0860","17,877.1860",05.00 AED,5.00,4.9000,0.1000,564270928,1583942,Success,United Arab Emirates,DU UAE,Transguard Group LLC,API User,E6AEAE17361
2022-02-15 23:46,72426596,"17,877.1860","17,867.3860",10.00 AED,10.00,9.8000,0.2000,564270973,1583943,Success,United Arab Emirates,DU UAE,Transguard Group LLC,API User,E6AEAE22430
2022-02-15 23:49,72426835,"17,867.3860","17,862.4860",05.00 AED,5.00,4.9000,0.1000,564271594,1583946,Success,United Arab Emirates,DU UAE,Transguard Group LLC,API User,E6AEAE17361
2022-02-15 23:55,72427200,"17,862.4860","17,852.6860",10.00 AED,10.00,9.8000,0.2000,564272528,1583951,Success,United Arab Emirates,DU UAE,Transguard Group LLC,API User,E6AEAE22430
2022-02-15 23:56,72427256,"17,852.6860","17,847.7860",05.00 AED,5.00,4.9000,0.1000,564272690,1583954,Success,United Arab Emirates,DU UAE,Transguard Group LLC,API User,E6AEAE17361
2022-02-16 00:01,72427547,"17,847.7860","17,842.8860",05.00 AED,5.00,4.9000,0.1000,564273521,1583964,Success,United Arab Emirates,DU UAE,Transguard Group LLC,API User,E6AEAE17361
2022-02-16 00:03,72427645,"17,842.8860","17,837.9860",05.00 AED,5.00,4.9000,0.1000,564273811,1583967,Success,United Arab Emirates,DU UAE,Transguard Group LLC,API User,E6AEAE17361
2022-02-16 00:06,72427836,"17,837.9860","17,828.1860",10.00 AED,10.00,9.8000,0.2000,564274321,1583976,Success,United Arab Emirates,DU UAE,Transguard Group LLC,API User,E6AEAE22430
2022-02-16 00:09,72428021,"17,828.1860","17,818.3860",10.00 AED,10.00,9.8000,0.2000,564274846,1583980,Success,United Arab Emirates,DU UAE,Transguard Group LLC,API User,E6AEAE22430
2022-02-16 00:11,72428132,"17,818.3860","17,813.4860",05.00 AED,5.00,4.9000,0.1000,564275164,1583987,Success,United Arab Emirates,DU UAE,Transguard Group LLC,API User,E6AEAE17361
2022-02-16 00:11,72428141,"17,813.4860","17,803.6860",10.00 AED,10.00,9.8000,0.2000,564275196,1583989,Success,United Arab Emirates,DU UAE,Transguard Group LLC,API User,E6AEAE22430
2022-02-16 00:12,72428173,"17,803.6860","17,798.7860",05.00 AED,5.00,4.9000,0.1000,564275282,1583991,Success,United Arab Emirates,DU UAE,Transguard Group LLC,API User,E6AEAE17361
2022-02-16 00:13,72428249,"17,798.7860","17,793.8860",05.00 AED,5.00,4.9000,0.1000,564275521,1583995,Success,United Arab Emirates,DU UAE,Transguard Group LLC,API User,E6AEAE17361
2022-02-16 00:14,72428294,"17,793.8860","17,788.9860",05.00 AED,5.00,4.9000,0.1000,564275650,1583997,Success,United Arab Emirates,DU UAE,Transguard Group LLC,API User,E6AEAE17361
2022-02-16 00:17,72428461,"17,788.9860","17,784.0860",05.00 AED,5.00,4.9000,0.1000,564276167,1584008,Success,United Arab Emirates,DU UAE,Transguard Group LLC,API User,E6AEAE17361
2022-02-16 00:18,72428527,"17,784.0860","17,779.1860",05.00 AED,5.00,4.9000,0.1000,564276311,1584013,Success,United Arab Emirates,DU UAE,Transguard Group LLC,API User,E6AEAE17361
2022-02-16 00:20,72428592,"17,779.1860","17,774.2860",05.00 AED,5.00,4.9000,0.1000,564276490,1584016,Success,United Arab Emirates,DU UAE,Transguard Group LLC,API User,E6AEAE17361
2022-02-16 00:26,72428980,"17,774.2860","17,764.4860",10.00 AED,10.00,9.8000,0.2000,564277586,1584024,Success,United Arab Emirates,DU UAE,Transguard Group LLC,API User,E6AEAE22430
2022-02-16 00:29,72429119,"17,764.4860","17,725.2860",40.00 AED,40.00,39.2000,0.8000,564278007,1584031,Success,United Arab Emirates,DU UAE,Transguard Group LLC,API User,E6AEAE64011
2022-02-16 00:30,72429195,"17,725.2860","17,715.4860",10.00 AED,10.00,9.8000,0.2000,564278196,1584035,Success,United Arab Emirates,DU UAE,Transguard Group LLC,API User,E6AEAE22430
2022-02-16 00:34,72429419,"17,715.4860","17,710.5860",05.00 AED,5.00,4.9000,0.1000,564278800,1584040,Success,United Arab Emirates,DU UAE,Transguard Group LLC,API User,E6AEAE17361
2022-02-16 00:36,72429535,"17,710.5860","17,700.7860",10.00 AED,10.00,9.8000,0.2000,564279096,1584048,Success,United Arab Emirates,DU UAE,Transguard Group LLC,API User,E6AEAE22430
2022-02-16 00:37,72429560,"17,700.7860","17,695.8860",05.00 AED,5.00,4.9000,0.1000,564279169,1584049,Success,United Arab Emirates,DU UAE,Transguard Group LLC,API User,E6AEAE17361
2022-02-16 00:41,72429773,"17,695.8860","17,690.9860",05.00 AED,5.00,4.9000,0.1000,564279835,1584055,Success,United Arab Emirates,DU UAE,Transguard Group LLC,API User,E6AEAE17361
2022-02-16 00:41,72429783,"17,690.9860","17,686.0860",05.00 AED,5.00,4.9000,0.1000,564279872,1584057,Success,United Arab Emirates,DU UAE,Transguard Group LLC,API User,E6AEAE17361
2022-02-16 00:42,72429864,"17,686.0860","17,681.1860",05.00 AED,5.00,4.9000,0.1000,564280083,1584061,Success,United Arab Emirates,DU UAE,Transguard Group LLC,API User,E6AEAE17361
2022-02-16 00:44,72429939,"17,681.1860","17,676.2860",05.00 AED,5.00,4.9000,0.1000,564280282,1584064,Success,United Arab Emirates,DU UAE,Transguard Group LLC,API User,E6AEAE17361
2022-02-16 00:55,72430506,"17,676.2860","17,666.4860",10.00 AED,10.00,9.8000,0.2000,564281998,1584072,Success,United Arab Emirates,DU UAE,Transguard Group LLC,API User,E6AEAE22430
2022-02-16 01:09,72431256,"17,666.4860","17,661.5860",05.00 AED,5.00,4.9000,0.1000,564284105,1584084,Success,United Arab Emirates,DU UAE,Transguard Group LLC,API User,E6AEAE17361
2022-02-16 01:14,72431508,"17,661.5860","17,656.6860",05.00 AED,5.00,4.9000,0.1000,564284801,1584090,Success,United Arab Emirates,DU UAE,Transguard Group LLC,API User,E6AEAE17361
2022-02-16 01:20,72431815,"17,656.6860","17,646.8860",10.00 AED,10.00,9.8000,0.2000,564285682,1584098,Success,United Arab Emirates,DU UAE,Transguard Group LLC,API User,E6AEAE22430
2022-02-16 01:22,72431900,"17,646.8860","17,641.9860",05.00 AED,5.00,4.9000,0.1000,564285959,1584101,Success,United Arab Emirates,DU UAE,Transguard Group LLC,API User,E6AEAE17361
2022-02-16 01:23,72431964,"17,641.9860","17,622.3860",20.00 AED,20.00,19.6000,0.4000,564286129,1584104,Success,United Arab Emirates,DU UAE,Transguard Group LLC,API User,E6AEAE12938
2022-02-16 01:25,72432081,"17,622.3860","17,612.5860",10.00 AED,10.00,9.8000,0.2000,564286491,1584107,Success,United Arab Emirates,DU UAE,Transguard Group LLC,API User,E6AEAE22430
2022-02-16 01:32,72432450,"17,612.5860","17,607.6860",05.00 AED,5.00,4.9000,0.1000,564287533,1584116,Success,United Arab Emirates,DU UAE,Transguard Group LLC,API User,E6AEAE17361
2022-02-16 01:33,72432507,"17,607.6860","17,581.2860",710.00 KES,30.00,26.4000,3.6000,564287729,1584119,Success,Kenya,Safaricom Kenya (Airtime Recharge),Transguard Group LLC,API User,KE_SA_TopUp
2022-02-16 01:52,72433512,"17,581.2860","17,571.4860",10.00 AED,10.00,9.8000,0.2000,564290525,1584123,Success,United Arab Emirates,DU UAE,Transguard Group LLC,API User,E6AEAE22430
2022-02-16 02:23,72435242,"17,571.4860","17,566.5860",05.00 AED,5.00,4.9000,0.1000,564295067,1584142,Success,United Arab Emirates,DU UAE,Transguard Group LLC,API User,E6AEAE17361
2022-02-16 02:35,72435955,"17,566.5860","17,546.9860",20.00 AED,20.00,19.6000,0.4000,564296914,1584145,Success,United Arab Emirates,DU UAE,Transguard Group LLC,API User,E6AEAE12938
2022-02-16 02:41,72436302,"17,546.9860","17,542.0860",05.00 AED,5.00,4.9000,0.1000,564297819,1584150,Success,United Arab Emirates,DU UAE,Transguard Group LLC,API User,E6AEAE17361
2022-02-16 02:43,72436446,"17,542.0860","17,537.1860",05.00 AED,5.00,4.9000,0.1000,564298180,1584155,Success,United Arab Emirates,DU UAE,Transguard Group LLC,API User,E6AEAE17361
2022-02-16 03:03,72437540,"17,537.1860","17,532.2860",05.00 AED,5.00,4.9000,0.1000,564301060,1584161,Success,United Arab Emirates,DU UAE,Transguard Group LLC,API User,E6AEAE17361
2022-02-16 03:09,72437898,"17,532.2860","17,527.3860",05.00 AED,5.00,4.9000,0.1000,564301957,1584164,Success,United Arab Emirates,DU UAE,Transguard Group LLC,API User,E6AEAE17361
2022-02-16 03:29,72439186,"17,527.3860","17,522.4860",05.00 AED,5.00,4.9000,0.1000,564305149,1584172,Success,United Arab Emirates,DU UAE,Transguard Group LLC,API User,E6AEAE17361
2022-02-16 03:30,72439259,"17,522.4860","17,512.6860",10.00 AED,10.00,9.8000,0.2000,564305328,1584175,Success,United Arab Emirates,DU UAE,Transguard Group LLC,API User,E6AEAE22430
2022-02-16 04:14,72441999,"17,512.6860","17,507.7860",05.00 AED,5.00,4.9000,0.1000,564312219,1584185,Success,United Arab Emirates,DU UAE,Transguard Group LLC,API User,E6AEAE17361
2022-02-16 04:15,72442028,"17,507.7860","17,502.8860",05.00 AED,5.00,4.9000,0.1000,564312292,1584188,Success,United Arab Emirates,DU UAE,Transguard Group LLC,API User,E6AEAE17361
2022-02-16 04:31,72443085,"17,502.8860","17,497.9860",05.00 AED,5.00,4.9000,0.1000,564314894,1584195,Success,United Arab Emirates,DU UAE,Transguard Group LLC,API User,E6AEAE17361
2022-02-16 04:33,72443239,"17,497.9860","17,494.2460",100.00 NPR,4.25,3.7400,0.5100,564315234,1584198,Success,Nepal,Ncell Nepal,Transguard Group LLC,API User,NP_NC_TopUp_100.00
2022-02-16 04:35,72443311,"17,494.2460","17,489.3460",05.00 AED,5.00,4.9000,0.1000,564315412,1584204,Success,United Arab Emirates,DU UAE,Transguard Group LLC,API User,E6AEAE17361
2022-02-16 04:36,72443379,"17,489.3460","17,479.5460",10.00 AED,10.00,9.8000,0.2000,564315588,1584207,Success,United Arab Emirates,DU UAE,Transguard Group LLC,API User,E6AEAE22430
2022-02-16 04:42,72443789,"17,479.5460","17,474.6460",05.00 AED,5.00,4.9000,0.1000,564316541,1584214,Success,United Arab Emirates,DU UAE,Transguard Group LLC,API User,E6AEAE17361
2022-02-16 04:44,72443953,"17,474.6460","17,464.8460",10.00 AED,10.00,9.8000,0.2000,564316904,1584219,Success,United Arab Emirates,DU UAE,Transguard Group LLC,API User,E6AEAE22430
2022-02-16 04:47,72444166,"17,464.8460","17,459.9460",05.00 AED,5.00,4.9000,0.1000,564317397,1584224,Success,United Arab Emirates,DU UAE,Transguard Group LLC,API User,E6AEAE17361
2022-02-16 04:52,72444477,"17,459.9460","17,450.1460",10.00 AED,10.00,9.8000,0.2000,564318114,1584227,Success,United Arab Emirates,DU UAE,Transguard Group LLC,API User,E6AEAE22430
2022-02-16 04:54,72444632,"17,450.1460","17,440.3460",10.00 AED,10.00,9.8000,0.2000,564318462,1584235,Success,United Arab Emirates,DU UAE,Transguard Group LLC,API User,E6AEAE22430
2022-02-16 05:01,72445107,"17,440.3460","17,430.5460",10.00 AED,10.00,9.8000,0.2000,564319500,1584242,Success,United Arab Emirates,DU UAE,Transguard Group LLC,API User,E6AEAE22430
2022-02-16 05:03,72445295,"17,430.5460","17,420.7460",10.00 AED,10.00,9.8000,0.2000,564319907,1584255,Success,United Arab Emirates,DU UAE,Transguard Group LLC,API User,E6AEAE22430
2022-02-16 05:06,72445474,"17,420.7460","17,410.9460",10.00 AED,10.00,9.8000,0.2000,564320343,1584263,Success,United Arab Emirates,DU UAE,Transguard Group LLC,API User,E6AEAE22430
2022-02-16 05:14,72446004,"17,410.9460","17,406.0460",05.00 AED,5.00,4.9000,0.1000,564321482,1584270,Success,United Arab Emirates,DU UAE,Transguard Group LLC,API User,E6AEAE17361
2022-02-16 05:18,72446303,"17,406.0460","17,401.1460",05.00 AED,5.00,4.9000,0.1000,564322148,1584275,Success,United Arab Emirates,DU UAE,Transguard Group LLC,API User,E6AEAE17361
2022-02-16 05:19,72446366,"17,401.1460","17,396.2460",05.00 AED,5.00,4.9000,0.1000,564322302,1584282,Success,United Arab Emirates,DU UAE,Transguard Group LLC,API User,E6AEAE17361
2022-02-16 05:23,72446606,"17,396.2460","17,391.3460",05.00 AED,5.00,4.9000,0.1000,564322858,1584289,Success,United Arab Emirates,DU UAE,Transguard Group LLC,API User,E6AEAE17361
2022-02-16 05:26,72446805,"17,391.3460","17,386.4460",05.00 AED,5.00,4.9000,0.1000,564323325,1584292,Success,United Arab Emirates,DU UAE,Transguard Group LLC,API User,E6AEAE17361
2022-02-16 05:29,72446991,"17,386.4460","17,381.5460",05.00 AED,5.00,4.9000,0.1000,564323741,1584297,Success,United Arab Emirates,DU UAE,Transguard Group LLC,API User,E6AEAE17361
2022-02-16 05:38,72447579,"17,381.5460","17,376.6460",05.00 AED,5.00,4.9000,0.1000,564325078,1584306,Success,United Arab Emirates,DU UAE,Transguard Group LLC,API User,E6AEAE17361
2022-02-16 05:48,72448252,"17,376.6460","17,371.7460",05.00 AED,5.00,4.9000,0.1000,564326505,1584311,Success,United Arab Emirates,DU UAE,Transguard Group LLC,API User,E6AEAE17361
2022-02-16 05:52,72448562,"17,371.7460","17,366.8460",05.00 AED,5.00,4.9000,0.1000,564327219,1584320,Success,United Arab Emirates,DU UAE,Transguard Group LLC,API User,E6AEAE17361
2022-02-16 05:53,72448606,"17,366.8460","17,361.9460",05.00 AED,5.00,4.9000,0.1000,564327339,1584323,Success,United Arab Emirates,DU UAE,Transguard Group LLC,API User,E6AEAE17361
2022-02-16 05:56,72448748,"17,361.9460","17,357.0460",05.00 AED,5.00,4.9000,0.1000,564327689,1584326,Success,United Arab Emirates,DU UAE,Transguard Group LLC,API User,E6AEAE17361
2022-02-16 05:57,72448865,"17,357.0460","17,352.1460",05.00 AED,5.00,4.9000,0.1000,564327943,1584331,Success,United Arab Emirates,DU UAE,Transguard Group LLC,API User,E6AEAE17361
2022-02-16 05:59,72448954,"17,352.1460","17,347.2460",05.00 AED,5.00,4.9000,0.1000,564328149,1584335,Success,United Arab Emirates,DU UAE,Transguard Group LLC,API User,E6AEAE17361
2022-02-16 05:59,72448982,"17,347.2460","17,342.3460",05.00 AED,5.00,4.9000,0.1000,564328230,1584338,Success,United Arab Emirates,DU UAE,Transguard Group LLC,API User,E6AEAE17361
2022-02-16 06:08,72449510,"17,342.3460","17,332.5460",10.00 AED,10.00,9.8000,0.2000,564329450,1584347,Success,United Arab Emirates,DU UAE,Transguard Group LLC,API User,E6AEAE22430
2022-02-16 06:12,72449778,"17,332.5460","17,327.6460",05.00 AED,5.00,4.9000,0.1000,564330020,1584356,Success,United Arab Emirates,DU UAE,Transguard Group LLC,API User,E6AEAE17361
2022-02-16 06:12,72449783,"17,327.6460","17,319.7260",220.00 NPR,9.00,7.9200,1.0800,564330028,1584358,Success,Nepal,Ncell Nepal,Transguard Group LLC,API User,NCNPNP79518
2022-02-16 06:13,72449845,"17,319.7260","17,314.8260",05.00 AED,5.00,4.9000,0.1000,564330223,1584364,Success,United Arab Emirates,DU UAE,Transguard Group LLC,API User,E6AEAE17361
2022-02-16 06:13,72449847,"17,314.8260","17,309.9260",05.00 AED,5.00,4.9000,0.1000,564330226,1584365,Success,United Arab Emirates,DU UAE,Transguard Group LLC,API User,E6AEAE17361
2022-02-16 06:20,72450268,"17,309.9260","17,300.1260",10.00 AED,10.00,9.8000,0.2000,564331149,1584376,Success,United Arab Emirates,DU UAE,Transguard Group LLC,API User,E6AEAE22430
2022-02-16 06:20,72450269,"17,300.1260","17,295.2260",05.00 AED,5.00,4.9000,0.1000,564331153,1584377,Success,United Arab Emirates,DU UAE,Transguard Group LLC,API User,E6AEAE17361
2022-02-16 06:20,72450314,"17,295.2260","17,279.1660",575.00 PKR,18.25,16.0600,2.1900,564331237,1584380,Success,Pakistan,Jazz Pakistan,Transguard Group LLC,API User,MBPKPK68304
2022-02-16 06:23,72450470,"17,279.1660","17,274.2660",05.00 AED,5.00,4.9000,0.1000,564331629,1584385,Success,United Arab Emirates,DU UAE,Transguard Group LLC,API User,E6AEAE17361
2022-02-16 06:23,72450503,"17,274.2660","17,269.3660",05.00 AED,5.00,4.9000,0.1000,564331690,1584388,Success,United Arab Emirates,DU UAE,Transguard Group LLC,API User,E6AEAE17361
2022-02-16 06:24,72450517,"17,269.3660","17,259.5660",10.00 AED,10.00,9.8000,0.2000,564331728,1584393,Success,United Arab Emirates,DU UAE,Transguard Group LLC,API User,E6AEAE22430
2022-02-16 06:25,72450565,"17,259.5660","17,249.7660",10.00 AED,10.00,9.8000,0.2000,564331813,1584399,Success,United Arab Emirates,DU UAE,Transguard Group LLC,API User,E6AEAE22430
2022-02-16 06:25,72450594,"17,249.7660","17,244.8660",05.00 AED,5.00,4.9000,0.1000,564331889,1584402,Success,United Arab Emirates,DU UAE,Transguard Group LLC,API User,E6AEAE17361
2022-02-16 06:26,72450653,"17,244.8660","17,239.9660",05.00 AED,5.00,4.9000,0.1000,564332044,1584407,Success,United Arab Emirates,DU UAE,Transguard Group LLC,API User,E6AEAE17361
2022-02-16 06:28,72450769,"17,239.9660","17,205.6660",35.00 AED,35.00,34.3000,0.7000,564332304,1584413,Success,United Arab Emirates,DU UAE,Transguard Group LLC,API User,E6AEAE73954
2022-02-16 06:30,72450855,"17,205.6660","17,200.7660",05.00 AED,5.00,4.9000,0.1000,564332507,1584417,Success,United Arab Emirates,DU UAE,Transguard Group LLC,API User,E6AEAE17361
2022-02-16 06:32,72450950,"17,200.7660","17,197.0260",130.00 PKR,4.25,3.7400,0.5100,564332744,1584422,Success,Pakistan,Telenor Pakistan,Transguard Group LLC,API User,TPPKPK26966
2022-02-16 06:33,72451006,"17,197.0260","17,177.4260",20.00 AED,20.00,19.6000,0.4000,564332867,1584426,Success,United Arab Emirates,DU UAE,Transguard Group LLC,API User,E6AEAE12938
2022-02-16 06:37,72451266,"17,177.4260","17,167.6260",10.00 AED,10.00,9.8000,0.2000,564333456,1584439,Success,United Arab Emirates,DU UAE,Transguard Group LLC,API User,E6AEAE22430
2022-02-16 06:38,72451319,"17,167.6260","17,162.7260",05.00 AED,5.00,4.9000,0.1000,564333555,1584444,Success,United Arab Emirates,DU UAE,Transguard Group LLC,API User,E6AEAE17361
2022-02-16 06:44,72451651,"17,162.7260","17,157.8260",05.00 AED,5.00,4.9000,0.1000,564334272,1584454,Success,United Arab Emirates,DU UAE,Transguard Group LLC,API User,E6AEAE17361
2022-02-16 06:44,72451653,"17,157.8260","17,148.0260",10.00 AED,10.00,9.8000,0.2000,564334274,1584455,Success,United Arab Emirates,DU UAE,Transguard Group LLC,API User,E6AEAE22430
2022-02-16 06:47,72451853,"17,148.0260","17,138.2260",10.00 AED,10.00,9.8000,0.2000,564334739,1584459,Success,United Arab Emirates,DU UAE,Transguard Group LLC,API User,E6AEAE22430
2022-02-16 06:52,72452106,"17,138.2260","17,133.3260",05.00 AED,5.00,4.9000,0.1000,564335360,1584473,Success,United Arab Emirates,DU UAE,Transguard Group LLC,API User,E6AEAE17361
2022-02-16 06:52,72452126,"17,133.3260","17,128.4260",05.00 AED,5.00,4.9000,0.1000,564335398,1584476,Success,United Arab Emirates,DU UAE,Transguard Group LLC,API User,E6AEAE17361
2022-02-16 06:52,72452131,"17,128.4260","17,108.8260",20.00 AED,20.00,19.6000,0.4000,564335413,1584478,Success,United Arab Emirates,DU UAE,Transguard Group LLC,API User,E6AEAE12938
2022-02-16 06:57,72452387,"17,108.8260","17,103.9260",05.00 AED,5.00,4.9000,0.1000,564335970,1584489,Success,United Arab Emirates,DU UAE,Transguard Group LLC,API User,E6AEAE17361
2022-02-16 06:57,72452425,"17,103.9260","17,094.1260",10.00 AED,10.00,9.8000,0.2000,564336065,1584495,Success,United Arab Emirates,DU UAE,Transguard Group LLC,API User,E6AEAE22430
2022-02-16 06:58,72452431,"17,094.1260","17,089.2260",05.00 AED,5.00,4.9000,0.1000,564336087,1584498,Success,United Arab Emirates,DU UAE,Transguard Group LLC,API User,E6AEAE17361
2022-02-16 06:58,72452443,"17,089.2260","17,084.3260",05.00 AED,5.00,4.9000,0.1000,564336102,1584499,Success,United Arab Emirates,DU UAE,Transguard Group LLC,API User,E6AEAE17361
2022-02-16 06:59,72452526,"17,084.3260","17,078.3860",100.00 INR,6.75,5.9400,0.8100,564336289,1584508,Success,India,Airtel India,Transguard Group LLC,API User,AIININ36410
2022-02-16 07:00,72452537,"17,078.3860","17,058.7860",20.00 AED,20.00,19.6000,0.4000,564336317,1584511,Success,United Arab Emirates,DU UAE,Transguard Group LLC,API User,E6AEAE12938
2022-02-16 07:01,72452643,"17,058.7860","17,048.9860",10.00 AED,10.00,9.8000,0.2000,564336558,1584520,Success,United Arab Emirates,DU UAE,Transguard Group LLC,API User,E6AEAE22430
2022-02-16 07:05,72452808,"17,048.9860","17,044.0860",05.00 AED,5.00,4.9000,0.1000,564336931,1584532,Success,United Arab Emirates,DU UAE,Transguard Group LLC,API User,E6AEAE17361
2022-02-16 07:06,72452888,"17,044.0860","17,039.1860",05.00 AED,5.00,4.9000,0.1000,564337121,1584540,Success,United Arab Emirates,DU UAE,Transguard Group LLC,API User,E6AEAE17361
2022-02-16 07:07,72452917,"17,039.1860","17,034.2860",05.00 AED,5.00,4.9000,0.1000,564337174,1584543,Success,United Arab Emirates,DU UAE,Transguard Group LLC,API User,E6AEAE17361
2022-02-16 07:07,72452932,"17,034.2860","17,029.3860",05.00 AED,5.00,4.9000,0.1000,564337202,1584545,Success,United Arab Emirates,DU UAE,Transguard Group LLC,API User,E6AEAE17361
2022-02-16 07:08,72452959,"17,029.3860","17,019.5860",10.00 AED,10.00,9.8000,0.2000,564337285,1584548,Success,United Arab Emirates,DU UAE,Transguard Group LLC,API User,E6AEAE22430
2022-02-16 07:08,72452982,"17,019.5860","17,009.7860",10.00 AED,10.00,9.8000,0.2000,564337331,1584551,Success,United Arab Emirates,DU UAE,Transguard Group LLC,API User,E6AEAE22430
2022-02-16 07:11,72453114,"17,009.7860","17,004.8860",05.00 AED,5.00,4.9000,0.1000,564337605,1584557,Success,United Arab Emirates,DU UAE,Transguard Group LLC,API User,E6AEAE17361
2022-02-16 07:15,72453349,"17,004.8860","16,995.0860",10.00 AED,10.00,9.8000,0.2000,564338114,1584565,Success,United Arab Emirates,DU UAE,Transguard Group LLC,API User,E6AEAE22430
2022-02-16 07:18,72453506,"16,995.0860","16,987.1660",220.00 NPR,9.00,7.9200,1.0800,564338490,1584578,Success,Nepal,Ncell Nepal,Transguard Group LLC,API User,NCNPNP79518
2022-02-16 07:21,72453599,"16,987.1660","16,977.3660",10.00 AED,10.00,9.8000,0.2000,564338768,1584585,Success,United Arab Emirates,DU UAE,Transguard Group LLC,API User,E6AEAE22430
2022-02-16 07:21,72453608,"16,977.3660","16,972.4660",05.00 AED,5.00,4.9000,0.1000,564338783,1584587,Success,United Arab Emirates,DU UAE,Transguard Group LLC,API User,E6AEAE17361
2022-02-16 07:24,72453754,"16,972.4660","16,962.6660",10.00 AED,10.00,9.8000,0.2000,564339120,1584598,Success,United Arab Emirates,DU UAE,Transguard Group LLC,API User,E6AEAE22430
2022-02-16 07:25,72453774,"16,962.6660","16,952.8660",10.00 AED,10.00,9.8000,0.2000,564339151,1584600,Success,United Arab Emirates,DU UAE,Transguard Group LLC,API User,E6AEAE22430
2022-02-16 07:26,72453842,"16,952.8660","16,944.9460",220.00 NPR,9.00,7.9200,1.0800,564339319,1584605,Success,Nepal,Ncell Nepal,Transguard Group LLC,API User,NCNPNP79518
2022-02-16 07:27,72453878,"16,944.9460","16,941.2060",100.00 NPR,4.25,3.7400,0.5100,564339394,1584609,Success,Nepal,Nepal Telecom Nepal,Transguard Group LLC,API User,NP_NE_TopUp_100.00
2022-02-16 07:29,72453982,"16,941.2060","16,936.3060",05.00 AED,5.00,4.9000,0.1000,564339651,1584616,Success,United Arab Emirates,DU UAE,Transguard Group LLC,API User,E6AEAE17361
2022-02-16 07:31,72454050,"16,936.3060","16,926.5060",10.00 AED,10.00,9.8000,0.2000,564339813,1584622,Success,United Arab Emirates,DU UAE,Transguard Group LLC,API User,E6AEAE22430
2022-02-16 07:31,72454064,"16,926.5060","16,887.3060",40.00 AED,40.00,39.2000,0.8000,564339831,1584623,Success,United Arab Emirates,DU UAE,Transguard Group LLC,API User,E6AEAE64011
2022-02-16 07:31,72454074,"16,887.3060","16,882.4060",05.00 AED,5.00,4.9000,0.1000,564339858,1584627,Success,United Arab Emirates,DU UAE,Transguard Group LLC,API User,E6AEAE17361
2022-02-16 07:31,72454084,"16,882.4060","16,862.8060",20.00 AED,20.00,19.6000,0.4000,564339878,1584629,Success,United Arab Emirates,DU UAE,Transguard Group LLC,API User,E6AEAE12938
2022-02-16 07:32,72454133,"16,862.8060","16,853.0060",10.00 AED,10.00,9.8000,0.2000,564339961,1584633,Success,United Arab Emirates,DU UAE,Transguard Group LLC,API User,E6AEAE22430
2022-02-16 07:33,72454167,"16,853.0060","16,844.6460",100.00 PHP,9.50,8.3600,1.1400,564340032,1584636,Success,Philippines,Smart (SunCellular) Philippines,Transguard Group LLC,API User,PH_SM_TopUp_100.00
2022-02-16 07:43,72454618,"16,844.6460","16,834.8460",10.00 AED,10.00,9.8000,0.2000,564341097,1584666,Success,United Arab Emirates,DU UAE,Transguard Group LLC,API User,E6AEAE22430
2022-02-16 07:43,72454620,"16,834.8460","16,829.9460",05.00 AED,5.00,4.9000,0.1000,564341099,1584667,Success,United Arab Emirates,DU UAE,Transguard Group LLC,API User,E6AEAE17361
2022-02-16 07:43,72454646,"16,829.9460","16,825.0460",05.00 AED,5.00,4.9000,0.1000,564341154,1584670,Success,United Arab Emirates,DU UAE,Transguard Group LLC,API User,E6AEAE17361
2022-02-16 07:44,72454700,"16,825.0460","16,805.4460",20.00 AED,20.00,19.6000,0.4000,564341280,1584675,Success,United Arab Emirates,DU UAE,Transguard Group LLC,API User,E6AEAE12938
2022-02-16 07:45,72454748,"16,805.4460","16,795.6460",10.00 AED,10.00,9.8000,0.2000,564341373,1584680,Success,United Arab Emirates,DU UAE,Transguard Group LLC,API User,E6AEAE22430
2022-02-16 07:47,72454828,"16,795.6460","16,790.7460",05.00 AED,5.00,4.9000,0.1000,564341546,1584686,Success,United Arab Emirates,DU UAE,Transguard Group LLC,API User,E6AEAE17361
2022-02-16 07:47,72454855,"16,790.7460","16,785.8460",05.00 AED,5.00,4.9000,0.1000,564341613,1584690,Success,United Arab Emirates,DU UAE,Transguard Group LLC,API User,E6AEAE17361
2022-02-16 07:48,72454921,"16,785.8460","16,780.9460",05.00 AED,5.00,4.9000,0.1000,564341754,1584696,Success,United Arab Emirates,DU UAE,Transguard Group LLC,API User,E6AEAE17361
2022-02-16 07:49,72454928,"16,780.9460","16,771.1460",10.00 AED,10.00,9.8000,0.2000,564341764,1584698,Success,United Arab Emirates,DU UAE,Transguard Group LLC,API User,E6AEAE22430
2022-02-16 07:49,72454962,"16,771.1460","16,766.2460",05.00 AED,5.00,4.9000,0.1000,564341834,1584703,Success,United Arab Emirates,DU UAE,Transguard Group LLC,API User,E6AEAE17361
2022-02-16 07:51,72455026,"16,766.2460","16,756.4460",10.00 AED,10.00,9.8000,0.2000,564342002,1584709,Success,United Arab Emirates,DU UAE,Transguard Group LLC,API User,E6AEAE22430
2022-02-16 07:52,72455061,"16,756.4460","16,717.2460",40.00 AED,40.00,39.2000,0.8000,564342080,1584711,Success,United Arab Emirates,DU UAE,Transguard Group LLC,API User,E6AEAE64011
2022-02-16 07:53,72455135,"16,717.2460","16,707.4460",10.00 AED,10.00,9.8000,0.2000,564342247,1584720,Success,United Arab Emirates,DU UAE,Transguard Group LLC,API User,E6AEAE22430
2022-02-16 07:53,72455144,"16,707.4460","16,697.6460",10.00 AED,10.00,9.8000,0.2000,564342266,1584721,Success,United Arab Emirates,DU UAE,Transguard Group LLC,API User,E6AEAE22430
2022-02-16 07:53,72455151,"16,697.6460","16,687.8460",10.00 AED,10.00,9.8000,0.2000,564342285,1584723,Success,United Arab Emirates,DU UAE,Transguard Group LLC,API User,E6AEAE22430
2022-02-16 07:54,72455195,"16,687.8460","16,682.9460",05.00 AED,5.00,4.9000,0.1000,564342360,1584728,Success,United Arab Emirates,DU UAE,Transguard Group LLC,API User,E6AEAE17361
2022-02-16 07:57,72455321,"16,682.9460","16,678.0460",05.00 AED,5.00,4.9000,0.1000,564342643,1584741,Success,United Arab Emirates,DU UAE,Transguard Group LLC,API User,E6AEAE17361
2022-02-16 07:58,72455390,"16,678.0460","16,668.2460",10.00 AED,10.00,9.8000,0.2000,564342788,1584749,Success,United Arab Emirates,DU UAE,Transguard Group LLC,API User,E6AEAE22430
2022-02-16 07:59,72455451,"16,668.2460","16,663.8460",50.00 PHP,5.00,4.4000,0.6000,564342913,1584753,Success,Philippines,BS_Globe Philippines,Transguard Group LLC,API User,PH_GB_TopUp_50.00
2022-02-16 08:01,72455526,"16,663.8460","16,658.9460",05.00 AED,5.00,4.9000,0.1000,564343081,1584756,Success,United Arab Emirates,DU UAE,Transguard Group LLC,API User,E6AEAE17361
2022-02-16 08:02,72455569,"16,658.9460","16,654.0460",05.00 AED,5.00,4.9000,0.1000,564343161,1584761,Success,United Arab Emirates,DU UAE,Transguard Group LLC,API User,E6AEAE17361
2022-02-16 08:05,72455753,"16,654.0460","16,614.8460",40.00 AED,40.00,39.2000,0.8000,564343547,1584772,Success,United Arab Emirates,DU UAE,Transguard Group LLC,API User,E6AEAE64011
2022-02-16 08:06,72455791,"16,614.8460","16,605.0460",10.00 AED,10.00,9.8000,0.2000,564343651,1584777,Success,United Arab Emirates,DU UAE,Transguard Group LLC,API User,E6AEAE22430
2022-02-16 08:06,72455795,"16,605.0460","16,580.5460",25.00 AED,25.00,24.5000,0.5000,564343669,1584778,Success,United Arab Emirates,DU UAE,Transguard Group LLC,API User,E6AEAE17343
2022-02-16 08:10,72455957,"16,580.5460","16,575.6460",05.00 AED,5.00,4.9000,0.1000,564344062,1584785,Success,United Arab Emirates,DU UAE,Transguard Group LLC,API User,E6AEAE17361
2022-02-16 08:14,72456131,"16,575.6460","16,558.7060",470.00 NPR,19.25,16.9400,2.3100,564344485,1584793,Success,Nepal,Ncell Nepal,Transguard Group LLC,API User,NCNPNP37643
2022-02-16 08:16,72456196,"16,558.7060","16,553.8060",05.00 AED,5.00,4.9000,0.1000,564344633,1584800,Success,United Arab Emirates,DU UAE,Transguard Group LLC,API User,E6AEAE17361
2022-02-16 08:18,72456296,"16,553.8060","16,548.9060",05.00 AED,5.00,4.9000,0.1000,564344872,1584805,Success,United Arab Emirates,DU UAE,Transguard Group LLC,API User,E6AEAE17361
2022-02-16 08:19,72456343,"16,548.9060","16,544.0060",05.00 AED,5.00,4.9000,0.1000,564344963,1584813,Success,United Arab Emirates,DU UAE,Transguard Group LLC,API User,E6AEAE17361
2022-02-16 08:20,72456392,"16,544.0060","16,535.2060",315.00 PKR,10.00,8.8000,1.2000,564345088,1584819,Success,Pakistan,Telenor Pakistan,Transguard Group LLC,API User,TPPKPK75105
2022-02-16 08:21,72456412,"16,535.2060","16,525.4060",10.00 AED,10.00,9.8000,0.2000,564345119,1584822,Success,United Arab Emirates,DU UAE,Transguard Group LLC,API User,E6AEAE22430
2022-02-16 08:24,72456558,"16,525.4060","16,486.2060",40.00 AED,40.00,39.2000,0.8000,564345469,1584828,Success,United Arab Emirates,DU UAE,Transguard Group LLC,API User,E6AEAE64011
2022-02-16 08:26,72456620,"16,486.2060","16,481.3060",05.00 AED,5.00,4.9000,0.1000,564345613,1584835,Success,United Arab Emirates,DU UAE,Transguard Group LLC,API User,E6AEAE17361
2022-02-16 08:26,72456623,"16,481.3060","16,442.1060",40.00 AED,40.00,39.2000,0.8000,564345615,1584836,Success,United Arab Emirates,DU UAE,Transguard Group LLC,API User,E6AEAE64011
2022-02-16 08:26,72456654,"16,442.1060","16,422.5060",20.00 AED,20.00,19.6000,0.4000,564345687,1584839,Success,United Arab Emirates,DU UAE,Transguard Group LLC,API User,E6AEAE12938
2022-02-16 08:27,72456670,"16,422.5060","16,412.7060",10.00 AED,10.00,9.8000,0.2000,564345718,1584843,Success,United Arab Emirates,DU UAE,Transguard Group LLC,API User,E6AEAE22430
2022-02-16 08:27,72456714,"16,412.7060","16,407.8060",05.00 AED,5.00,4.9000,0.1000,564345810,1584849,Success,United Arab Emirates,DU UAE,Transguard Group LLC,API User,E6AEAE17361
2022-02-16 08:29,72456794,"16,407.8060","16,398.0060",10.00 AED,10.00,9.8000,0.2000,564345982,1584852,Success,United Arab Emirates,DU UAE,Transguard Group LLC,API User,E6AEAE22430
2022-02-16 08:30,72456857,"16,398.0060","16,393.1060",05.00 AED,5.00,4.9000,0.1000,564346130,1584856,Success,United Arab Emirates,DU UAE,Transguard Group LLC,API User,E6AEAE17361
2022-02-16 08:36,72457171,"16,393.1060","16,383.3060",10.00 AED,10.00,9.8000,0.2000,564346804,1584864,Success,United Arab Emirates,DU UAE,Transguard Group LLC,API User,E6AEAE22430
2022-02-16 08:37,72457202,"16,383.3060","16,378.4060",05.00 AED,5.00,4.9000,0.1000,564346882,1584870,Success,United Arab Emirates,DU UAE,Transguard Group LLC,API User,E6AEAE17361
2022-02-16 08:37,72457210,"16,378.4060","16,368.6060",10.00 AED,10.00,9.8000,0.2000,564346890,1584871,Success,United Arab Emirates,DU UAE,Transguard Group LLC,API User,E6AEAE22430
2022-02-16 08:38,72457261,"16,368.6060","16,349.0060",20.00 AED,20.00,19.6000,0.4000,564347006,1584875,Success,United Arab Emirates,DU UAE,Transguard Group LLC,API User,E6AEAE12938
2022-02-16 08:40,72457347,"16,349.0060","16,329.4060",20.00 AED,20.00,19.6000,0.4000,564347203,1584879,Success,United Arab Emirates,DU UAE,Transguard Group LLC,API User,E6AEAE12938
2022-02-16 08:41,72457360,"16,329.4060","16,319.6060",10.00 AED,10.00,9.8000,0.2000,564347236,1584882,Success,United Arab Emirates,DU UAE,Transguard Group LLC,API User,E6AEAE22430
2022-02-16 08:43,72457440,"16,319.6060","16,314.7060",05.00 AED,5.00,4.9000,0.1000,564347425,1584887,Success,United Arab Emirates,DU UAE,Transguard Group LLC,API User,E6AEAE17361
2022-02-16 08:45,72457532,"16,314.7060","16,304.9060",10.00 AED,10.00,9.8000,0.2000,564347643,1584892,Success,United Arab Emirates,DU UAE,Transguard Group LLC,API User,E6AEAE22430
2022-02-16 08:46,72457565,"16,304.9060","16,295.1060",10.00 AED,10.00,9.8000,0.2000,564347703,1584895,Success,United Arab Emirates,DU UAE,Transguard Group LLC,API User,E6AEAE22430
2022-02-16 08:46,72457576,"16,295.1060","16,275.5060",20.00 AED,20.00,19.6000,0.4000,564347722,1584897,Success,United Arab Emirates,DU UAE,Transguard Group LLC,API User,E6AEAE12938
2022-02-16 08:46,72457585,"16,275.5060","16,270.6060",05.00 AED,5.00,4.9000,0.1000,564347743,1584899,Success,United Arab Emirates,DU UAE,Transguard Group LLC,API User,E6AEAE17361
2022-02-16 08:47,72457605,"16,270.6060","16,265.7060",05.00 AED,5.00,4.9000,0.1000,564347797,1584902,Success,United Arab Emirates,DU UAE,Transguard Group LLC,API User,E6AEAE17361
2022-02-16 08:48,72457638,"16,265.7060","16,255.9060",10.00 AED,10.00,9.8000,0.2000,564347866,1584905,Success,United Arab Emirates,DU UAE,Transguard Group LLC,API User,E6AEAE22430
2022-02-16 08:50,72457718,"16,255.9060","16,246.1060",10.00 AED,10.00,9.8000,0.2000,564348064,1584910,Success,United Arab Emirates,DU UAE,Transguard Group LLC,API User,E6AEAE22430
2022-02-16 08:53,72457860,"16,246.1060","16,241.2060",05.00 AED,5.00,4.9000,0.1000,564348371,1584917,Success,United Arab Emirates,DU UAE,Transguard Group LLC,API User,E6AEAE17361
2022-02-16 08:54,72457893,"16,241.2060","16,233.0660",300.00 PKR,9.25,8.1400,1.1100,564348454,1584922,Success,Pakistan,Zong Pakistan,Transguard Group LLC,API User,ZNPKPK70504
2022-02-16 08:57,72457994,"16,233.0660","16,223.2660",10.00 AED,10.00,9.8000,0.2000,564348675,1584926,Success,United Arab Emirates,DU UAE,Transguard Group LLC,API User,E6AEAE22430
2022-02-16 09:00,72458153,"16,223.2660","16,213.4660",10.00 AED,10.00,9.8000,0.2000,564349050,1584935,Success,United Arab Emirates,DU UAE,Transguard Group LLC,API User,E6AEAE22430
2022-02-16 09:01,72458168,"16,213.4660","16,208.5660",05.00 AED,5.00,4.9000,0.1000,564349091,1584939,Success,United Arab Emirates,DU UAE,Transguard Group LLC,API User,E6AEAE17361
2022-02-16 09:02,72458195,"16,208.5660","16,204.8260",100.00 NPR,4.25,3.7400,0.5100,564349166,1584945,Success,Nepal,Ncell Nepal,Transguard Group LLC,API User,NP_NC_TopUp_100.00
2022-02-16 09:04,72458287,"16,204.8260","16,201.0860",100.00 NPR,4.25,3.7400,0.5100,564349391,1584951,Success,Nepal,Ncell Nepal,Transguard Group LLC,API User,NP_NC_TopUp_100.00
2022-02-16 09:07,72458429,"16,201.0860","16,196.1860",05.00 AED,5.00,4.9000,0.1000,564349723,1584963,Success,United Arab Emirates,DU UAE,Transguard Group LLC,API User,E6AEAE17361
2022-02-16 09:10,72458528,"16,196.1860","16,191.2860",05.00 AED,5.00,4.9000,0.1000,564349971,1584975,Success,United Arab Emirates,DU UAE,Transguard Group LLC,API User,E6AEAE17361
2022-02-16 09:10,72458529,"16,191.2860","16,181.4860",10.00 AED,10.00,9.8000,0.2000,564349977,1584976,Success,United Arab Emirates,DU UAE,Transguard Group LLC,API User,E6AEAE22430
2022-02-16 09:10,72458545,"16,181.4860","16,176.5860",05.00 AED,5.00,4.9000,0.1000,564350008,1584978,Success,United Arab Emirates,DU UAE,Transguard Group LLC,API User,E6AEAE17361
2022-02-16 09:14,72458681,"16,176.5860","16,166.7860",10.00 AED,10.00,9.8000,0.2000,564350334,1584986,Success,United Arab Emirates,DU UAE,Transguard Group LLC,API User,E6AEAE22430
2022-02-16 09:15,72458752,"16,166.7860","16,156.9860",10.00 AED,10.00,9.8000,0.2000,564350513,1584993,Success,United Arab Emirates,DU UAE,Transguard Group LLC,API User,E6AEAE22430
2022-02-16 09:17,72458821,"16,156.9860","16,122.6860",35.00 AED,35.00,34.3000,0.7000,564350643,1584998,Success,United Arab Emirates,DU UAE,Transguard Group LLC,API User,E6AEAE73954
2022-02-16 09:18,72458841,"16,122.6860","16,117.7860",05.00 AED,5.00,4.9000,0.1000,564350694,1585001,Success,United Arab Emirates,DU UAE,Transguard Group LLC,API User,E6AEAE17361
2022-02-16 09:21,72458959,"16,117.7860","16,107.9860",10.00 AED,10.00,9.8000,0.2000,564350970,1585009,Success,United Arab Emirates,DU UAE,Transguard Group LLC,API User,E6AEAE22430
2022-02-16 09:22,72459015,"16,107.9860","16,098.1860",10.00 AED,10.00,9.8000,0.2000,564351099,1585014,Success,United Arab Emirates,DU UAE,Transguard Group LLC,API User,E6AEAE22430
2022-02-16 09:23,72459075,"16,098.1860","16,093.2860",05.00 AED,5.00,4.9000,0.1000,564351239,1585019,Success,United Arab Emirates,DU UAE,Transguard Group LLC,API User,E6AEAE17361
2022-02-16 09:26,72459157,"16,093.2860","16,088.3860",05.00 AED,5.00,4.9000,0.1000,564351437,1585034,Success,United Arab Emirates,DU UAE,Transguard Group LLC,API User,E6AEAE17361
2022-02-16 09:26,72459162,"16,088.3860","16,083.4860",05.00 AED,5.00,4.9000,0.1000,564351442,1585035,Success,United Arab Emirates,DU UAE,Transguard Group LLC,API User,E6AEAE17361
2022-02-16 09:34,72459476,"16,083.4860","16,073.6860",10.00 AED,10.00,9.8000,0.2000,564352245,1585045,Success,United Arab Emirates,DU UAE,Transguard Group LLC,API User,E6AEAE22430
2022-02-16 09:42,72459755,"16,073.6860","16,063.8860",10.00 AED,10.00,9.8000,0.2000,564352948,1585061,Success,United Arab Emirates,DU UAE,Transguard Group LLC,API User,E6AEAE22430
2022-02-16 09:43,72459802,"16,063.8860","16,054.0860",10.00 AED,10.00,9.8000,0.2000,564353042,1585064,Success,United Arab Emirates,DU UAE,Transguard Group LLC,API User,E6AEAE22430
2022-02-16 09:46,72459923,"16,054.0860","16,044.2860",10.00 AED,10.00,9.8000,0.2000,564353304,1585073,Success,United Arab Emirates,DU UAE,Transguard Group LLC,API User,E6AEAE22430
2022-02-16 09:50,72460045,"16,044.2860","16,029.5860",15.00 AED,15.00,14.7000,0.3000,564353612,1585079,Success,United Arab Emirates,DU UAE,Transguard Group LLC,API User,E6AEAE8527
2022-02-16 09:50,72460063,"16,029.5860","16,024.6860",05.00 AED,5.00,4.9000,0.1000,564353649,1585083,Success,United Arab Emirates,DU UAE,Transguard Group LLC,API User,E6AEAE17361
2022-02-16 09:51,72460124,"16,024.6860","15,995.2860",30.00 AED,30.00,29.4000,0.6000,564353791,1585089,Success,United Arab Emirates,DU UAE,Transguard Group LLC,API User,E6AEAE46146
2022-02-16 09:53,72460206,"15,995.2860","15,990.3860",05.00 AED,5.00,4.9000,0.1000,564353960,1585095,Success,United Arab Emirates,DU UAE,Transguard Group LLC,API User,E6AEAE17361
2022-02-16 09:53,72460214,"15,990.3860","15,960.9860",30.00 AED,30.00,29.4000,0.6000,564353981,1585096,Success,United Arab Emirates,DU UAE,Transguard Group LLC,API User,E6AEAE46146
2022-02-16 09:54,72460249,"15,960.9860","15,941.3860",20.00 AED,20.00,19.6000,0.4000,564354050,1585099,Success,United Arab Emirates,DU UAE,Transguard Group LLC,API User,E6AEAE12938
2022-02-16 09:55,72460280,"15,941.3860","15,936.4860",05.00 AED,5.00,4.9000,0.1000,564354131,1585103,Success,United Arab Emirates,DU UAE,Transguard Group LLC,API User,E6AEAE17361
2022-02-16 09:57,72460360,"15,936.4860","15,931.5860",05.00 AED,5.00,4.9000,0.1000,564354321,1585108,Success,United Arab Emirates,DU UAE,Transguard Group LLC,API User,E6AEAE17361
2022-02-16 09:59,72460435,"15,931.5860","15,926.6860",05.00 AED,5.00,4.9000,0.1000,564354483,1585114,Success,United Arab Emirates,DU UAE,Transguard Group LLC,API User,E6AEAE17361
2022-02-16 10:00,72460483,"15,926.6860","15,907.0860",20.00 AED,20.00,19.6000,0.4000,564354613,1585123,Success,United Arab Emirates,DU UAE,Transguard Group LLC,API User,E6AEAE12938
2022-02-16 10:00,72460490,"15,907.0860","15,898.9460",300.00 PKR,9.25,8.1400,1.1100,564354638,1585126,Success,Pakistan,Zong Pakistan,Transguard Group LLC,API User,ZNPKPK70504
2022-02-16 10:01,72460504,"15,898.9460","15,889.1460",10.00 AED,10.00,9.8000,0.2000,564354672,1585127,Success,United Arab Emirates,DU UAE,Transguard Group LLC,API User,E6AEAE22430
2022-02-16 10:05,72460672,"15,889.1460","15,884.2460",05.00 AED,5.00,4.9000,0.1000,564355070,1585132,Success,United Arab Emirates,DU UAE,Transguard Group LLC,API User,E6AEAE17361
2022-02-16 10:06,72460696,"15,884.2460","15,879.3460",05.00 AED,5.00,4.9000,0.1000,564355120,1585135,Success,United Arab Emirates,DU UAE,Transguard Group LLC,API User,E6AEAE17361
2022-02-16 10:07,72460765,"15,879.3460","15,874.4460",05.00 AED,5.00,4.9000,0.1000,564355249,1585138,Success,United Arab Emirates,DU UAE,Transguard Group LLC,API User,E6AEAE17361
2022-02-16 10:19,72461216,"15,874.4460","15,869.5460",05.00 AED,5.00,4.9000,0.1000,564356276,1585161,Success,United Arab Emirates,DU UAE,Transguard Group LLC,API User,E6AEAE17361
2022-02-16 10:19,72461225,"15,869.5460","15,864.6460",05.00 AED,5.00,4.9000,0.1000,564356291,1585163,Success,United Arab Emirates,DU UAE,Transguard Group LLC,API User,E6AEAE17361
2022-02-16 10:21,72461309,"15,864.6460","15,859.7460",05.00 AED,5.00,4.9000,0.1000,564356474,1585168,Success,United Arab Emirates,DU UAE,Transguard Group LLC,API User,E6AEAE17361
2022-02-16 10:27,72461570,"15,859.7460","15,851.8260",220.00 NPR,9.00,7.9200,1.0800,564357061,1585183,Success,Nepal,Ncell Nepal,Transguard Group LLC,API User,NCNPNP79518
2022-02-16 10:33,72461795,"15,851.8260","15,832.2260",20.00 AED,20.00,19.6000,0.4000,564357633,1585201,Success,United Arab Emirates,DU UAE,Transguard Group LLC,API User,E6AEAE12938
2022-02-16 10:35,72461863,"15,832.2260","15,827.3260",05.00 AED,5.00,4.9000,0.1000,564357807,1585208,Success,United Arab Emirates,DU UAE,Transguard Group LLC,API User,E6AEAE17361
2022-02-16 10:38,72461979,"15,827.3260","15,817.5260",10.00 AED,10.00,9.8000,0.2000,564358124,1585214,Success,United Arab Emirates,DU UAE,Transguard Group LLC,API User,E6AEAE22430
2022-02-16 10:39,72461986,"15,817.5260","15,807.7260",10.00 AED,10.00,9.8000,0.2000,564358142,1585217,Success,United Arab Emirates,DU UAE,Transguard Group LLC,API User,E6AEAE22430
2022-02-16 10:40,72462013,"15,807.7260","15,788.1260",20.00 AED,20.00,19.6000,0.4000,564358227,1585221,Success,United Arab Emirates,DU UAE,Transguard Group LLC,API User,E6AEAE12938
2022-02-16 10:41,72462063,"15,788.1260","15,768.5260",20.00 AED,20.00,19.6000,0.4000,564358331,1585225,Success,United Arab Emirates,DU UAE,Transguard Group LLC,API User,E6AEAE12938
2022-02-16 10:44,72462173,"15,768.5260","15,763.6260",05.00 AED,5.00,4.9000,0.1000,564358661,1585235,Success,United Arab Emirates,DU UAE,Transguard Group LLC,API User,E6AEAE17361
2022-02-16 10:47,72462253,"15,763.6260","15,758.7260",05.00 AED,5.00,4.9000,0.1000,564358908,1585240,Success,United Arab Emirates,DU UAE,Transguard Group LLC,API User,E6AEAE17361
2022-02-16 10:48,72462295,"15,758.7260","15,748.9260",10.00 AED,10.00,9.8000,0.2000,564359002,1585244,Success,United Arab Emirates,DU UAE,Transguard Group LLC,API User,E6AEAE22430
2022-02-16 10:49,72462348,"15,748.9260","15,742.9860",99.00 INR,6.75,5.9400,0.8100,564359145,1585250,Success,India,Airtel India,Transguard Group LLC,API User,AIININ6418
2022-02-16 10:51,72462407,"15,742.9860","15,738.0860",05.00 AED,5.00,4.9000,0.1000,564359274,1585260,Success,United Arab Emirates,DU UAE,Transguard Group LLC,API User,E6AEAE17361
2022-02-16 10:52,72462475,"15,738.0860","15,728.2860",10.00 AED,10.00,9.8000,0.2000,564359413,1585266,Success,United Arab Emirates,DU UAE,Transguard Group LLC,API User,E6AEAE22430
2022-02-16 10:53,72462494,"15,728.2860","15,718.4860",10.00 AED,10.00,9.8000,0.2000,564359460,1585268,Success,United Arab Emirates,DU UAE,Transguard Group LLC,API User,E6AEAE22430
2022-02-16 10:53,72462519,"15,718.4860","15,703.7860",15.00 AED,15.00,14.7000,0.3000,564359529,1585273,Success,United Arab Emirates,DU UAE,Transguard Group LLC,API User,E6AEAE8527
2022-02-16 10:53,72462520,"15,703.7860","15,693.9860",10.00 AED,10.00,9.8000,0.2000,564359530,1585274,Success,United Arab Emirates,DU UAE,Transguard Group LLC,API User,E6AEAE22430
2022-02-16 10:57,72462699,"15,693.9860","15,689.0860",05.00 AED,5.00,4.9000,0.1000,564359933,1585281,Success,United Arab Emirates,DU UAE,Transguard Group LLC,API User,E6AEAE17361
2022-02-16 10:58,72462728,"15,689.0860","15,679.2860",10.00 AED,10.00,9.8000,0.2000,564360006,1585285,Success,United Arab Emirates,DU UAE,Transguard Group LLC,API User,E6AEAE22430
2022-02-16 11:01,72462828,"15,679.2860","15,669.4860",10.00 AED,10.00,9.8000,0.2000,564360264,1585291,Success,United Arab Emirates,DU UAE,Transguard Group LLC,API User,E6AEAE22430
2022-02-16 11:03,72462907,"15,669.4860","15,664.5860",05.00 AED,5.00,4.9000,0.1000,564360465,1585294,Success,United Arab Emirates,DU UAE,Transguard Group LLC,API User,E6AEAE17361
2022-02-16 11:07,72463045,"15,664.5860","15,659.6860",05.00 AED,5.00,4.9000,0.1000,564360829,1585309,Success,United Arab Emirates,DU UAE,Transguard Group LLC,API User,E6AEAE17361
2022-02-16 11:09,72463123,"15,659.6860","15,649.8860",10.00 AED,10.00,9.8000,0.2000,564361020,1585315,Success,United Arab Emirates,DU UAE,Transguard Group LLC,API User,E6AEAE22430
2022-02-16 11:13,72463271,"15,649.8860","15,640.0860",10.00 AED,10.00,9.8000,0.2000,564361399,1585324,Success,United Arab Emirates,DU UAE,Transguard Group LLC,API User,E6AEAE22430
2022-02-16 11:14,72463305,"15,640.0860","15,635.1860",05.00 AED,5.00,4.9000,0.1000,564361485,1585328,Success,United Arab Emirates,DU UAE,Transguard Group LLC,API User,E6AEAE17361
2022-02-16 11:14,72463335,"15,635.1860","15,630.2860",05.00 AED,5.00,4.9000,0.1000,564361529,1585332,Success,United Arab Emirates,DU UAE,Transguard Group LLC,API User,E6AEAE17361
2022-02-16 11:17,72463499,"15,630.2860","15,625.3860",05.00 AED,5.00,4.9000,0.1000,564361925,1585336,Success,United Arab Emirates,DU UAE,Transguard Group LLC,API User,E6AEAE17361
2022-02-16 11:24,72463748,"15,625.3860","15,620.4860",05.00 AED,5.00,4.9000,0.1000,564362567,1585343,Success,United Arab Emirates,DU UAE,Transguard Group LLC,API User,E6AEAE17361
2022-02-16 11:28,72463917,"15,620.4860","15,610.6860",10.00 AED,10.00,9.8000,0.2000,564362972,1585351,Success,United Arab Emirates,DU UAE,Transguard Group LLC,API User,E6AEAE22430
2022-02-16 11:28,72463938,"15,610.6860","15,606.5060",150.00 PKR,4.75,4.1800,0.5700,564363010,1585354,Success,Pakistan,Zong Pakistan,Transguard Group LLC,API User,ZNPKPK65621
2022-02-16 11:29,72463968,"15,606.5060","15,596.7060",10.00 AED,10.00,9.8000,0.2000,564363084,1585360,Success,United Arab Emirates,DU UAE,Transguard Group LLC,API User,E6AEAE22430
2022-02-16 11:34,72464157,"15,596.7060","15,591.8060",05.00 AED,5.00,4.9000,0.1000,564363610,1585377,Success,United Arab Emirates,DU UAE,Transguard Group LLC,API User,E6AEAE17361
2022-02-16 11:38,72464353,"15,591.8060","15,586.9060",05.00 AED,5.00,4.9000,0.1000,564364084,1585393,Success,United Arab Emirates,DU UAE,Transguard Group LLC,API User,E6AEAE17361
2022-02-16 11:39,72464372,"15,586.9060","15,577.1060",10.00 AED,10.00,9.8000,0.2000,564364131,1585396,Success,United Arab Emirates,DU UAE,Transguard Group LLC,API User,E6AEAE22430
2022-02-16 11:42,72464475,"15,577.1060","15,572.2060",05.00 AED,5.00,4.9000,0.1000,564364452,1585402,Success,United Arab Emirates,DU UAE,Transguard Group LLC,API User,E6AEAE17361
2022-02-16 11:48,72464729,"15,572.2060","15,567.3060",05.00 AED,5.00,4.9000,0.1000,564365066,1585407,Success,United Arab Emirates,DU UAE,Transguard Group LLC,API User,E6AEAE17361
2022-02-16 11:52,72464939,"15,567.3060","15,562.4060",05.00 AED,5.00,4.9000,0.1000,564365594,1585414,Success,United Arab Emirates,DU UAE,Transguard Group LLC,API User,E6AEAE17361
2022-02-16 11:53,72464948,"15,562.4060","15,552.6060",10.00 AED,10.00,9.8000,0.2000,564365628,1585418,Success,United Arab Emirates,DU UAE,Transguard Group LLC,API User,E6AEAE22430
2022-02-16 11:53,72464951,"15,552.6060","15,542.8060",10.00 AED,10.00,9.8000,0.2000,564365637,1585419,Success,United Arab Emirates,DU UAE,Transguard Group LLC,API User,E6AEAE22430
2022-02-16 11:57,72465103,"15,542.8060","15,533.0060",10.00 AED,10.00,9.8000,0.2000,564366026,1585430,Success,United Arab Emirates,DU UAE,Transguard Group LLC,API User,E6AEAE22430
2022-02-16 11:58,72465135,"15,533.0060","15,528.1060",05.00 AED,5.00,4.9000,0.1000,564366091,1585437,Success,United Arab Emirates,DU UAE,Transguard Group LLC,API User,E6AEAE17361
2022-02-16 11:59,72465205,"15,528.1060","15,508.5060",20.00 AED,20.00,19.6000,0.4000,564366246,1585441,Success,United Arab Emirates,DU UAE,Transguard Group LLC,API User,E6AEAE12938
2022-02-16 12:03,72465358,"15,508.5060","15,503.6060",05.00 AED,5.00,4.9000,0.1000,564366619,1585448,Success,United Arab Emirates,DU UAE,Transguard Group LLC,API User,E6AEAE17361
2022-02-16 12:05,72465422,"15,503.6060","15,493.8060",10.00 AED,10.00,9.8000,0.2000,564366755,1585453,Success,United Arab Emirates,DU UAE,Transguard Group LLC,API User,E6AEAE22430
2022-02-16 12:06,72465468,"15,493.8060","15,474.2060",20.00 AED,20.00,19.6000,0.4000,564366857,1585461,Success,United Arab Emirates,DU UAE,Transguard Group LLC,API User,E6AEAE12938
2022-02-16 12:07,72465504,"15,474.2060","15,469.3060",05.00 AED,5.00,4.9000,0.1000,564366934,1585467,Success,United Arab Emirates,DU UAE,Transguard Group LLC,API User,E6AEAE17361
2022-02-16 12:08,72465565,"15,469.3060","15,464.4060",05.00 AED,5.00,4.9000,0.1000,564367062,1585471,Success,United Arab Emirates,DU UAE,Transguard Group LLC,API User,E6AEAE17361
2022-02-16 12:09,72465592,"15,464.4060","15,454.6060",10.00 AED,10.00,9.8000,0.2000,564367140,1585476,Success,United Arab Emirates,DU UAE,Transguard Group LLC,API User,E6AEAE22430
2022-02-16 12:10,72465638,"15,454.6060","15,449.7060",05.00 AED,5.00,4.9000,0.1000,564367255,1585480,Success,United Arab Emirates,DU UAE,Transguard Group LLC,API User,E6AEAE17361
2022-02-16 12:10,72465658,"15,449.7060","15,444.8060",05.00 AED,5.00,4.9000,0.1000,564367308,1585484,Success,United Arab Emirates,DU UAE,Transguard Group LLC,API User,E6AEAE17361
2022-02-16 12:14,72465799,"15,444.8060","15,435.0060",10.00 AED,10.00,9.8000,0.2000,564367679,1585494,Success,United Arab Emirates,DU UAE,Transguard Group LLC,API User,E6AEAE22430
2022-02-16 12:15,72465833,"15,435.0060","15,430.1060",05.00 AED,5.00,4.9000,0.1000,564367772,1585498,Success,United Arab Emirates,DU UAE,Transguard Group LLC,API User,E6AEAE17361
2022-02-16 12:15,72465860,"15,430.1060","15,425.2060",05.00 AED,5.00,4.9000,0.1000,564367841,1585503,Success,United Arab Emirates,DU UAE,Transguard Group LLC,API User,E6AEAE17361
2022-02-16 12:15,72465863,"15,425.2060","15,420.3060",05.00 AED,5.00,4.9000,0.1000,564367858,1585504,Success,United Arab Emirates,DU UAE,Transguard Group LLC,API User,E6AEAE17361
2022-02-16 12:17,72465920,"15,420.3060","15,415.4060",05.00 AED,5.00,4.9000,0.1000,564368003,1585514,Success,United Arab Emirates,DU UAE,Transguard Group LLC,API User,E6AEAE17361
2022-02-16 12:18,72465952,"15,415.4060","15,410.5060",05.00 AED,5.00,4.9000,0.1000,564368078,1585521,Success,United Arab Emirates,DU UAE,Transguard Group LLC,API User,E6AEAE17361
2022-02-16 12:18,72465986,"15,410.5060","15,405.6060",05.00 AED,5.00,4.9000,0.1000,564368184,1585523,Success,United Arab Emirates,DU UAE,Transguard Group LLC,API User,E6AEAE17361
2022-02-16 12:21,72466117,"15,405.6060","15,395.8060",10.00 AED,10.00,9.8000,0.2000,564368514,1585528,Success,United Arab Emirates,DU UAE,Transguard Group LLC,API User,E6AEAE22430
2022-02-16 12:22,72466156,"15,395.8060","15,390.9060",05.00 AED,5.00,4.9000,0.1000,564368594,1585533,Success,United Arab Emirates,DU UAE,Transguard Group LLC,API User,E6AEAE17361
2022-02-16 12:24,72466229,"15,390.9060","15,386.7260",150.00 PKR,4.75,4.1800,0.5700,564368786,1585548,Success,Pakistan,Jazz Pakistan,Transguard Group LLC,API User,MBPKPK20699
2022-02-16 12:24,72466241,"15,386.7260","15,376.9260",10.00 AED,10.00,9.8000,0.2000,564368790,1585549,Success,United Arab Emirates,DU UAE,Transguard Group LLC,API User,E6AEAE22430
2022-02-16 12:25,72466316,"15,376.9260","15,372.0260",05.00 AED,5.00,4.9000,0.1000,564368998,1585555,Success,United Arab Emirates,DU UAE,Transguard Group LLC,API User,E6AEAE17361
2022-02-16 12:27,72466368,"15,372.0260","15,362.2260",10.00 AED,10.00,9.8000,0.2000,564369127,1585561,Success,United Arab Emirates,DU UAE,Transguard Group LLC,API User,E6AEAE22430
2022-02-16 12:28,72466425,"15,362.2260","15,357.3260",05.00 AED,5.00,4.9000,0.1000,564369251,1585567,Success,United Arab Emirates,DU UAE,Transguard Group LLC,API User,E6AEAE17361
2022-02-16 12:29,72466462,"15,357.3260","15,352.4260",05.00 AED,5.00,4.9000,0.1000,564369335,1585574,Success,United Arab Emirates,DU UAE,Transguard Group LLC,API User,E6AEAE17361
2022-02-16 12:35,72466720,"15,352.4260","15,347.5260",05.00 AED,5.00,4.9000,0.1000,564369968,1585586,Success,United Arab Emirates,DU UAE,Transguard Group LLC,API User,E6AEAE17361
2022-02-16 12:38,72466848,"15,347.5260","15,342.6260",05.00 AED,5.00,4.9000,0.1000,564370284,1585593,Success,United Arab Emirates,DU UAE,Transguard Group LLC,API User,E6AEAE17361
2022-02-16 12:42,72466983,"15,342.6260","15,332.8260",10.00 AED,10.00,9.8000,0.2000,564370622,1585602,Success,United Arab Emirates,DU UAE,Transguard Group LLC,API User,E6AEAE22430
2022-02-16 12:44,72467084,"15,332.8260","15,327.9260",05.00 AED,5.00,4.9000,0.1000,564370877,1585608,Success,United Arab Emirates,DU UAE,Transguard Group LLC,API User,E6AEAE17361
2022-02-16 12:48,72467261,"15,327.9260","15,308.3260",20.00 AED,20.00,19.6000,0.4000,564371353,1585615,Success,United Arab Emirates,DU UAE,Transguard Group LLC,API User,E6AEAE12938
2022-02-16 12:49,72467294,"15,308.3260","15,303.4260",05.00 AED,5.00,4.9000,0.1000,564371433,1585618,Success,United Arab Emirates,DU UAE,Transguard Group LLC,API User,E6AEAE17361
2022-02-16 12:49,72467310,"15,303.4260","15,293.6260",10.00 AED,10.00,9.8000,0.2000,564371484,1585621,Success,United Arab Emirates,DU UAE,Transguard Group LLC,API User,E6AEAE22430
2022-02-16 12:52,72467428,"15,293.6260","15,288.7260",05.00 AED,5.00,4.9000,0.1000,564371785,1585626,Success,United Arab Emirates,DU UAE,Transguard Group LLC,API User,E6AEAE17361
2022-02-16 12:55,72467568,"15,288.7260","15,283.8260",05.00 AED,5.00,4.9000,0.1000,564372159,1585630,Success,United Arab Emirates,DU UAE,Transguard Group LLC,API User,E6AEAE17361
2022-02-16 13:02,72467863,"15,283.8260","15,278.9260",05.00 AED,5.00,4.9000,0.1000,564372898,1585642,Success,United Arab Emirates,DU UAE,Transguard Group LLC,API User,E6AEAE17361
2022-02-16 13:04,72467915,"15,278.9260","15,269.1260",10.00 AED,10.00,9.8000,0.2000,564373034,1585645,Success,United Arab Emirates,DU UAE,Transguard Group LLC,API User,E6AEAE22430
2022-02-16 13:08,72468112,"15,254.4260","15,249.5260",05.00 AED,5.00,4.9000,0.1000,564373521,1585665,Success,United Arab Emirates,DU UAE,Transguard Group LLC,API User,E6AEAE17361
2022-02-16 13:08,72468114,"15,264.2260","15,254.4260",10.00 AED,10.00,9.8000,0.2000,564373516,1585664,Success,United Arab Emirates,DU UAE,Transguard Group LLC,API User,E6AEAE22430
2022-02-16 13:08,72468115,"15,269.1260","15,264.2260",05.00 AED,5.00,4.9000,0.1000,564373512,1585663,Success,United Arab Emirates,DU UAE,Transguard Group LLC,API User,E6AEAE17361
2022-02-16 13:09,72468173,"15,249.5260","15,244.6260",05.00 AED,5.00,4.9000,0.1000,564373673,1585671,Success,United Arab Emirates,DU UAE,Transguard Group LLC,API User,E6AEAE17361
2022-02-16 13:09,72468186,"15,244.6260","15,215.2260",30.00 AED,30.00,29.4000,0.6000,564373698,1585672,Success,United Arab Emirates,DU UAE,Transguard Group LLC,API User,E6AEAE46146
2022-02-16 13:10,72468225,"15,215.2260","15,205.4260",10.00 AED,10.00,9.8000,0.2000,564373802,1585676,Success,United Arab Emirates,DU UAE,Transguard Group LLC,API User,E6AEAE22430
2022-02-16 13:11,72468263,"15,205.4260","15,185.8260",20.00 AED,20.00,19.6000,0.4000,564373903,1585680,Success,United Arab Emirates,DU UAE,Transguard Group LLC,API User,E6AEAE12938
2022-02-16 13:12,72468299,"15,185.8260","15,166.2260",20.00 AED,20.00,19.6000,0.4000,564373998,1585683,Success,United Arab Emirates,DU UAE,Transguard Group LLC,API User,E6AEAE12938
2022-02-16 13:13,72468352,"15,166.2260","15,156.4260",10.00 AED,10.00,9.8000,0.2000,564374104,1585686,Success,United Arab Emirates,DU UAE,Transguard Group LLC,API User,E6AEAE22430
2022-02-16 13:14,72468417,"15,156.4260","15,146.6260",10.00 AED,10.00,9.8000,0.2000,564374275,1585691,Success,United Arab Emirates,DU UAE,Transguard Group LLC,API User,E6AEAE22430
2022-02-16 13:16,72468484,"15,146.6260","15,141.7260",05.00 AED,5.00,4.9000,0.1000,564374457,1585697,Success,United Arab Emirates,DU UAE,Transguard Group LLC,API User,E6AEAE17361
2022-02-16 13:16,72468502,"15,141.7260","15,136.8260",05.00 AED,5.00,4.9000,0.1000,564374494,1585700,Success,United Arab Emirates,DU UAE,Transguard Group LLC,API User,E6AEAE17361
2022-02-16 13:17,72468541,"15,136.8260","15,127.0260",10.00 AED,10.00,9.8000,0.2000,564374604,1585702,Success,United Arab Emirates,DU UAE,Transguard Group LLC,API User,E6AEAE22430
2022-02-16 13:18,72468581,"15,127.0260","15,122.1260",05.00 AED,5.00,4.9000,0.1000,564374703,1585705,Success,United Arab Emirates,DU UAE,Transguard Group LLC,API User,E6AEAE17361
2022-02-16 13:20,72468639,"15,122.1260","15,117.2260",05.00 AED,5.00,4.9000,0.1000,564374839,1585710,Success,United Arab Emirates,DU UAE,Transguard Group LLC,API User,E6AEAE17361
2022-02-16 13:21,72468680,"15,117.2260","15,112.3260",05.00 AED,5.00,4.9000,0.1000,564374943,1585714,Success,United Arab Emirates,DU UAE,Transguard Group LLC,API User,E6AEAE17361
2022-02-16 13:21,72468698,"15,112.3260","15,107.4260",05.00 AED,5.00,4.9000,0.1000,564374982,1585719,Success,United Arab Emirates,DU UAE,Transguard Group LLC,API User,E6AEAE17361
2022-02-16 13:21,72468703,"15,107.4260","15,102.5260",05.00 AED,5.00,4.9000,0.1000,564374995,1585721,Success,United Arab Emirates,DU UAE,Transguard Group LLC,API User,E6AEAE17361
2022-02-16 13:24,72468821,"15,102.5260","15,092.7260",10.00 AED,10.00,9.8000,0.2000,564375304,1585732,Success,United Arab Emirates,DU UAE,Transguard Group LLC,API User,E6AEAE22430
2022-02-16 13:25,72468849,"15,092.7260","15,082.9260",10.00 AED,10.00,9.8000,0.2000,564375379,1585735,Success,United Arab Emirates,DU UAE,Transguard Group LLC,API User,E6AEAE22430
2022-02-16 13:26,72468900,"15,082.9260","15,078.0260",05.00 AED,5.00,4.9000,0.1000,564375503,1585739,Success,United Arab Emirates,DU UAE,Transguard Group LLC,API User,E6AEAE17361
2022-02-16 13:27,72468957,"15,078.0260","15,058.4260",20.00 AED,20.00,19.6000,0.4000,564375639,1585743,Success,United Arab Emirates,DU UAE,Transguard Group LLC,API User,E6AEAE12938
2022-02-16 13:28,72469017,"15,058.4260","15,053.5260",05.00 AED,5.00,4.9000,0.1000,564375781,1585748,Success,United Arab Emirates,DU UAE,Transguard Group LLC,API User,E6AEAE17361
2022-02-16 13:28,72469019,"15,053.5260","15,048.6260",05.00 AED,5.00,4.9000,0.1000,564375782,1585749,Success,United Arab Emirates,DU UAE,Transguard Group LLC,API User,E6AEAE17361
2022-02-16 13:30,72469100,"15,048.6260","15,038.8260",10.00 AED,10.00,9.8000,0.2000,564376002,1585754,Success,United Arab Emirates,DU UAE,Transguard Group LLC,API User,E6AEAE22430
2022-02-16 13:31,72469123,"15,038.8260","15,033.9260",05.00 AED,5.00,4.9000,0.1000,564376053,1585758,Success,United Arab Emirates,DU UAE,Transguard Group LLC,API User,E6AEAE17361
2022-02-16 13:31,72469135,"15,033.9260","15,029.0260",05.00 AED,5.00,4.9000,0.1000,564376075,1585760,Success,United Arab Emirates,DU UAE,Transguard Group LLC,API User,E6AEAE17361
2022-02-16 13:34,72469269,"15,029.0260","15,019.2260",10.00 AED,10.00,9.8000,0.2000,564376421,1585773,Success,United Arab Emirates,DU UAE,Transguard Group LLC,API User,E6AEAE22430
2022-02-16 13:36,72469329,"15,019.2260","15,014.3260",05.00 AED,5.00,4.9000,0.1000,564376581,1585780,Success,United Arab Emirates,DU UAE,Transguard Group LLC,API User,E6AEAE17361
2022-02-16 13:37,72469378,"15,014.3260","15,009.4260",05.00 AED,5.00,4.9000,0.1000,564376699,1585784,Success,United Arab Emirates,DU UAE,Transguard Group LLC,API User,E6AEAE17361
2022-02-16 13:38,72469404,"15,009.4260","14,965.3260",45.00 AED,45.00,44.1000,0.9000,564376758,1585786,Success,United Arab Emirates,DU UAE,Transguard Group LLC,API User,E6AEAE35243
2022-02-16 13:38,72469410,"14,965.3260","14,955.5260",10.00 AED,10.00,9.8000,0.2000,564376780,1585790,Success,United Arab Emirates,DU UAE,Transguard Group LLC,API User,E6AEAE22430
2022-02-16 13:38,72469427,"14,955.5260","14,945.7260",10.00 AED,10.00,9.8000,0.2000,564376815,1585792,Success,United Arab Emirates,DU UAE,Transguard Group LLC,API User,E6AEAE22430
2022-02-16 13:41,72469561,"14,945.7260","14,940.8260",05.00 AED,5.00,4.9000,0.1000,564377132,1585799,Success,United Arab Emirates,DU UAE,Transguard Group LLC,API User,E6AEAE17361
2022-02-16 13:42,72469592,"14,940.8260","14,931.0260",10.00 AED,10.00,9.8000,0.2000,564377217,1585802,Success,United Arab Emirates,DU UAE,Transguard Group LLC,API User,E6AEAE22430
2022-02-16 13:43,72469623,"14,931.0260","14,911.4260",20.00 AED,20.00,19.6000,0.4000,564377315,1585807,Success,United Arab Emirates,DU UAE,Transguard Group LLC,API User,E6AEAE12938
2022-02-16 13:43,72469645,"14,911.4260","14,901.6260",10.00 AED,10.00,9.8000,0.2000,564377377,1585813,Success,United Arab Emirates,DU UAE,Transguard Group LLC,API User,E6AEAE22430
2022-02-16 13:50,72469941,"14,901.6260","14,896.7260",05.00 AED,5.00,4.9000,0.1000,564378105,1585826,Success,United Arab Emirates,DU UAE,Transguard Group LLC,API User,E6AEAE17361
2022-02-16 13:52,72470040,"14,896.7260","14,891.8260",05.00 AED,5.00,4.9000,0.1000,564378390,1585834,Success,United Arab Emirates,DU UAE,Transguard Group LLC,API User,E6AEAE17361
2022-02-16 13:54,72470103,"14,891.8260","14,886.9260",05.00 AED,5.00,4.9000,0.1000,564378561,1585843,Success,United Arab Emirates,DU UAE,Transguard Group LLC,API User,E6AEAE17361
2022-02-16 13:57,72470224,"14,886.9260","14,882.0260",05.00 AED,5.00,4.9000,0.1000,564378887,1585853,Success,United Arab Emirates,DU UAE,Transguard Group LLC,API User,E6AEAE17361
2022-02-16 13:58,72470291,"14,882.0260","14,862.4260",20.00 AED,20.00,19.6000,0.4000,564379042,1585856,Success,United Arab Emirates,DU UAE,Transguard Group LLC,API User,E6AEAE12938
2022-02-16 14:02,72470455,"14,862.4260","14,857.5260",05.00 AED,5.00,4.9000,0.1000,564379453,1585866,Success,United Arab Emirates,DU UAE,Transguard Group LLC,API User,E6AEAE17361
2022-02-16 14:07,72470652,"14,857.5260","14,852.6260",05.00 AED,5.00,4.9000,0.1000,564380018,1585870,Success,United Arab Emirates,DU UAE,Transguard Group LLC,API User,E6AEAE17361
2022-02-16 14:12,72470842,"14,852.6260","14,847.7260",05.00 AED,5.00,4.9000,0.1000,564380573,1585884,Success,United Arab Emirates,DU UAE,Transguard Group LLC,API User,E6AEAE17361
2022-02-16 14:21,72471218,"14,847.7260","14,842.8260",05.00 AED,5.00,4.9000,0.1000,564381592,1585894,Success,United Arab Emirates,DU UAE,Transguard Group LLC,API User,E6AEAE17361
2022-02-16 14:23,72471279,"14,842.8260","14,837.9260",05.00 AED,5.00,4.9000,0.1000,564381793,1585899,Success,United Arab Emirates,DU UAE,Transguard Group LLC,API User,E6AEAE17361
2022-02-16 14:24,72471335,"14,837.9260","14,828.1260",10.00 AED,10.00,9.8000,0.2000,564381924,1585902,Success,United Arab Emirates,DU UAE,Transguard Group LLC,API User,E6AEAE22430
2022-02-16 14:26,72471410,"14,828.1260","14,818.3260",10.00 AED,10.00,9.8000,0.2000,564382112,1585907,Success,United Arab Emirates,DU UAE,Transguard Group LLC,API User,E6AEAE22430
2022-02-16 14:26,72471423,"14,818.3260","14,813.4260",05.00 AED,5.00,4.9000,0.1000,564382143,1585911,Success,United Arab Emirates,DU UAE,Transguard Group LLC,API User,E6AEAE17361
2022-02-16 14:26,72471449,"14,813.4260","14,804.8460",315.00 PKR,9.75,8.5800,1.1700,564382209,1585915,Success,Pakistan,Zong Pakistan,Transguard Group LLC,API User,ZNPKPK29953
2022-02-16 14:37,72471899,"14,804.8460","14,795.0460",10.00 AED,10.00,9.8000,0.2000,564383510,1585928,Success,United Arab Emirates,DU UAE,Transguard Group LLC,API User,E6AEAE22430
2022-02-16 14:39,72471976,"14,795.0460","14,790.1460",05.00 AED,5.00,4.9000,0.1000,564383731,1585935,Success,United Arab Emirates,DU UAE,Transguard Group LLC,API User,E6AEAE17361
2022-02-16 14:40,72472005,"14,790.1460","14,780.3460",10.00 AED,10.00,9.8000,0.2000,564383813,1585938,Success,United Arab Emirates,DU UAE,Transguard Group LLC,API User,E6AEAE22430
2022-02-16 14:41,72472077,"14,780.3460","14,775.4460",05.00 AED,5.00,4.9000,0.1000,564383991,1585942,Success,United Arab Emirates,DU UAE,Transguard Group LLC,API User,E6AEAE17361
2022-02-16 14:48,72472331,"14,775.4460","14,770.5460",05.00 AED,5.00,4.9000,0.1000,564384706,1585953,Success,United Arab Emirates,DU UAE,Transguard Group LLC,API User,E6AEAE17361
2022-02-16 14:52,72472538,"14,770.5460","14,760.7460",10.00 AED,10.00,9.8000,0.2000,564385281,1585963,Success,United Arab Emirates,DU UAE,Transguard Group LLC,API User,E6AEAE22430
2022-02-16 14:54,72472588,"14,760.7460","14,756.5660",150.00 PKR,4.75,4.1800,0.5700,564385433,1585970,Success,Pakistan,Jazz Pakistan,Transguard Group LLC,API User,MBPKPK20699
2022-02-16 14:57,72472759,"14,756.5660","14,752.8260",151.00 PKR,4.25,3.7400,0.5100,564385856,1585977,Failure,Pakistan,Telenor Pakistan,Transguard Group LLC,API User,TPPKPK94108
2022-02-16 14:57,72472759,"14,752.8260","14,749.0860",151.00 PKR,4.25,3.7400,0.5100,564385856,1585977,Failure,Pakistan,Telenor Pakistan,Transguard Group LLC,API User,TPPKPK94108
2022-02-16 15:10,72473418,"14,756.5660","14,751.6660",05.00 AED,5.00,4.9000,0.1000,564387545,1585992,Success,United Arab Emirates,DU UAE,Transguard Group LLC,API User,E6AEAE17361
2022-02-16 15:12,72473530,"14,751.6660","14,746.7660",05.00 AED,5.00,4.9000,0.1000,564387845,1586001,Failure,United Arab Emirates,DU UAE,Transguard Group LLC,API User,E6AEAE17361
2022-02-16 15:12,72473530,"14,746.7660","14,741.8660",05.00 AED,5.00,4.9000,0.1000,564387845,1586001,Failure,United Arab Emirates,DU UAE,Transguard Group LLC,API User,E6AEAE17361
2022-02-16 15:13,72473546,"14,751.6660","14,741.8660",10.00 AED,10.00,9.8000,0.2000,564387868,1586002,Success,United Arab Emirates,DU UAE,Transguard Group LLC,API User,E6AEAE22430
2022-02-16 15:15,72473641,"14,741.8660","14,736.9660",05.00 AED,5.00,4.9000,0.1000,564388101,1586007,Success,United Arab Emirates,DU UAE,Transguard Group LLC,API User,E6AEAE17361
2022-02-16 15:23,72473972,"14,736.9660","14,732.0660",05.00 AED,5.00,4.9000,0.1000,564389028,1586015,Success,United Arab Emirates,DU UAE,Transguard Group LLC,API User,E6AEAE17361
2022-02-16 15:41,72474846,"14,732.0660","14,712.4660",20.00 AED,20.00,19.6000,0.4000,564391398,1586035,Success,United Arab Emirates,DU UAE,Transguard Group LLC,API User,E6AEAE12938
2022-02-16 15:54,72475560,"14,712.4660","14,692.8660",20.00 AED,20.00,19.6000,0.4000,564393332,1586052,Success,United Arab Emirates,DU UAE,Transguard Group LLC,API User,E6AEAE12938
2022-02-16 15:58,72475773,"14,692.8660","14,684.0660",100.00 PHP,10.00,8.8000,1.2000,564393893,1586055,Success,Philippines,BS_Globe Philippines,Transguard Group LLC,API User,PH_GB_TopUp_100.00
2022-02-16 16:00,72475873,"14,684.0660","14,680.3260",100.00 NPR,4.25,3.7400,0.5100,564394182,1586063,Success,Nepal,Ncell Nepal,Transguard Group LLC,API User,NP_NC_TopUp_100.00
2022-02-16 16:03,72476049,"14,680.3260","14,675.4260",05.00 AED,5.00,4.9000,0.1000,564394643,1586075,Success,United Arab Emirates,DU UAE,Transguard Group LLC,API User,E6AEAE17361
2022-02-16 16:03,72476055,"14,675.4260","14,666.8460",315.00 PKR,9.75,8.5800,1.1700,564394676,1586077,Success,Pakistan,Zong Pakistan,Transguard Group LLC,API User,ZNPKPK29953
2022-02-16 16:03,72476096,"14,666.8460","14,661.9460",05.00 AED,5.00,4.9000,0.1000,564394772,1586082,Success,United Arab Emirates,DU UAE,Transguard Group LLC,API User,E6AEAE17361
2022-02-16 16:08,72476346,"14,661.9460","14,657.0460",05.00 AED,5.00,4.9000,0.1000,564395476,1586087,Success,United Arab Emirates,DU UAE,Transguard Group LLC,API User,E6AEAE17361
2022-02-16 16:11,72476512,"14,657.0460","14,652.1460",05.00 AED,5.00,4.9000,0.1000,564395922,1586092,Success,United Arab Emirates,DU UAE,Transguard Group LLC,API User,E6AEAE17361
2022-02-16 16:12,72476565,"14,652.1460","14,647.2460",05.00 AED,5.00,4.9000,0.1000,564396076,1586101,Success,United Arab Emirates,DU UAE,Transguard Group LLC,API User,E6AEAE17361
2022-02-16 16:13,72476585,"14,647.2460","14,642.3460",05.00 AED,5.00,4.9000,0.1000,564396118,1586105,Success,United Arab Emirates,DU UAE,Transguard Group LLC,API User,E6AEAE17361
2022-02-16 16:13,72476610,"14,642.3460","14,637.4460",05.00 AED,5.00,4.9000,0.1000,564396174,1586109,Success,United Arab Emirates,DU UAE,Transguard Group LLC,API User,E6AEAE17361
2022-02-16 16:16,72476820,"14,637.4460","14,632.5460",05.00 AED,5.00,4.9000,0.1000,564396742,1586113,Success,United Arab Emirates,DU UAE,Transguard Group LLC,API User,E6AEAE17361
2022-02-16 16:19,72476962,"14,632.5460","14,627.6460",05.00 AED,5.00,4.9000,0.1000,564397068,1586120,Success,United Arab Emirates,DU UAE,Transguard Group LLC,API User,E6AEAE17361
2022-02-16 16:20,72477029,"14,627.6460","14,617.8460",10.00 AED,10.00,9.8000,0.2000,564397276,1586127,Success,United Arab Emirates,DU UAE,Transguard Group LLC,API User,E6AEAE22430
2022-02-16 16:21,72477057,"14,617.8460","14,612.9460",05.00 AED,5.00,4.9000,0.1000,564397353,1586133,Success,United Arab Emirates,DU UAE,Transguard Group LLC,API User,E6AEAE17361
2022-02-16 16:21,72477089,"14,612.9460","14,608.0460",05.00 AED,5.00,4.9000,0.1000,564397437,1586138,Success,United Arab Emirates,DU UAE,Transguard Group LLC,API User,E6AEAE17361
2022-02-16 16:21,72477118,"14,608.0460","14,603.1460",05.00 AED,5.00,4.9000,0.1000,564397493,1586140,Success,United Arab Emirates,DU UAE,Transguard Group LLC,API User,E6AEAE17361
2022-02-16 16:22,72477158,"14,603.1460","14,598.2460",05.00 AED,5.00,4.9000,0.1000,564397590,1586143,Success,United Arab Emirates,DU UAE,Transguard Group LLC,API User,E6AEAE17361
2022-02-16 16:24,72477290,"14,598.2460","14,581.3060",470.00 NPR,19.25,16.9400,2.3100,564397960,1586150,Success,Nepal,Ncell Nepal,Transguard Group LLC,API User,NCNPNP37643
2022-02-16 16:25,72477311,"14,581.3060","14,571.5060",10.00 AED,10.00,9.8000,0.2000,564397998,1586153,Success,United Arab Emirates,DU UAE,Transguard Group LLC,API User,E6AEAE22430
2022-02-16 16:31,72477654,"14,571.5060","14,566.6060",05.00 AED,5.00,4.9000,0.1000,564398964,1586163,Success,United Arab Emirates,DU UAE,Transguard Group LLC,API User,E6AEAE17361
2022-02-16 16:33,72477762,"14,566.6060","14,547.0060",20.00 AED,20.00,19.6000,0.4000,564399270,72477762,Success,United Arab Emirates,DU UAE,Transguard Group LLC,mohammed.arafath@transguardgroup.com,E6AEAE12938
2022-02-16 16:33,72477812,"14,547.0060","14,527.4060",20.00 AED,20.00,19.6000,0.4000,564399392,1586170,Success,United Arab Emirates,DU UAE,Transguard Group LLC,API User,E6AEAE12938
2022-02-16 16:34,72477837,"14,527.4060","14,502.9060",25.00 AED,25.00,24.5000,0.5000,564399466,72477837,Success,United Arab Emirates,DU UAE,Transguard Group LLC,mohammed.arafath@transguardgroup.com,E6AEAE17343
2022-02-16 16:35,72477895,"14,502.9060","14,497.9810",05.00 AED,5.00,4.9250,0.0750,564399617,72477895,Success,United Arab Emirates,Etisalat UAE,Transguard Group LLC,mohammed.arafath@transguardgroup.com,ETAEAE54031
2022-02-16 16:35,72477928,"14,497.9810","14,493.0810",05.00 AED,5.00,4.9000,0.1000,564399710,72477928,Success,United Arab Emirates,DU UAE,Transguard Group LLC,mohammed.arafath@transguardgroup.com,E6AEAE17361
2022-02-16 16:36,72477980,"14,493.0810","14,477.0210",575.00 PKR,18.25,16.0600,2.1900,564399854,1586174,Success,Pakistan,Jazz Pakistan,Transguard Group LLC,API User,MBPKPK68304
2022-02-16 16:38,72478134,"14,477.0210","14,472.1210",05.00 AED,5.00,4.9000,0.1000,564400221,1586177,Success,United Arab Emirates,DU UAE,Transguard Group LLC,API User,E6AEAE17361
2022-02-16 16:40,72478213,"14,472.1210","14,462.3210",10.00 AED,10.00,9.8000,0.2000,564400414,1586181,Success,United Arab Emirates,DU UAE,Transguard Group LLC,API User,E6AEAE22430
2022-02-16 16:41,72478299,"14,462.3210","14,452.5210",10.00 AED,10.00,9.8000,0.2000,564400668,1586187,Success,United Arab Emirates,DU UAE,Transguard Group LLC,API User,E6AEAE22430
2022-02-16 16:45,72478539,"14,452.5210","14,447.6210",05.00 AED,5.00,4.9000,0.1000,564401252,1586192,Success,United Arab Emirates,DU UAE,Transguard Group LLC,API User,E6AEAE17361
2022-02-16 16:49,72478835,"14,447.6210","14,442.7210",05.00 AED,5.00,4.9000,0.1000,564401963,1586206,Success,United Arab Emirates,DU UAE,Transguard Group LLC,API User,E6AEAE17361
2022-02-16 16:53,72479092,"14,442.7210","14,437.8210",05.00 AED,5.00,4.9000,0.1000,564402696,1586211,Success,United Arab Emirates,DU UAE,Transguard Group LLC,API User,E6AEAE17361
2022-02-16 16:54,72479183,"14,437.8210","14,428.0210",10.00 AED,10.00,9.8000,0.2000,564402937,1586214,Success,United Arab Emirates,DU UAE,Transguard Group LLC,API User,E6AEAE22430
2022-02-16 16:57,72479369,"14,428.0210","14,423.1210",05.00 AED,5.00,4.9000,0.1000,564403389,1586220,Success,United Arab Emirates,DU UAE,Transguard Group LLC,API User,E6AEAE17361
2022-02-16 16:58,72479384,"14,423.1210","14,413.3210",10.00 AED,10.00,9.8000,0.2000,564403429,1586222,Success,United Arab Emirates,DU UAE,Transguard Group LLC,API User,E6AEAE22430
2022-02-16 17:00,72479557,"14,413.3210","14,408.4210",05.00 AED,5.00,4.9000,0.1000,564403882,1586229,Success,United Arab Emirates,DU UAE,Transguard Group LLC,API User,E6AEAE17361
2022-02-16 17:00,72479559,"14,408.4210","14,398.6210",10.00 AED,10.00,9.8000,0.2000,564403889,1586230,Success,United Arab Emirates,DU UAE,Transguard Group LLC,API User,E6AEAE22430
2022-02-16 17:02,72479640,"14,398.6210","14,379.0210",20.00 AED,20.00,19.6000,0.4000,564404126,1586239,Success,United Arab Emirates,DU UAE,Transguard Group LLC,API User,E6AEAE12938
2022-02-16 17:03,72479747,"14,379.0210","14,374.1210",05.00 AED,5.00,4.9000,0.1000,564404363,1586244,Success,United Arab Emirates,DU UAE,Transguard Group LLC,API User,E6AEAE17361
2022-02-16 17:08,72480084,"14,374.1210","14,369.2210",05.00 AED,5.00,4.9000,0.1000,564405242,1586258,Success,United Arab Emirates,DU UAE,Transguard Group LLC,API User,E6AEAE17361
2022-02-16 17:12,72480361,"14,369.2210","14,364.3210",05.00 AED,5.00,4.9000,0.1000,564405938,1586272,Success,United Arab Emirates,DU UAE,Transguard Group LLC,API User,E6AEAE17361
2022-02-16 17:12,72480390,"14,364.3210","14,359.4210",05.00 AED,5.00,4.9000,0.1000,564406020,1586277,Success,United Arab Emirates,DU UAE,Transguard Group LLC,API User,E6AEAE17361
2022-02-16 17:13,72480450,"14,359.4210","14,354.5210",05.00 AED,5.00,4.9000,0.1000,564406194,1586283,Success,United Arab Emirates,DU UAE,Transguard Group LLC,API User,E6AEAE17361
2022-02-16 17:14,72480486,"14,354.5210","14,349.6210",05.00 AED,5.00,4.9000,0.1000,564406287,1586286,Success,United Arab Emirates,DU UAE,Transguard Group LLC,API User,E6AEAE17361
2022-02-16 17:17,72480694,"14,349.6210","14,330.0210",20.00 AED,20.00,19.6000,0.4000,564406898,1586292,Success,United Arab Emirates,DU UAE,Transguard Group LLC,API User,E6AEAE12938
2022-02-16 17:21,72480959,"14,330.0210","14,320.2210",10.00 AED,10.00,9.8000,0.2000,564407610,1586309,Success,United Arab Emirates,DU UAE,Transguard Group LLC,API User,E6AEAE22430
2022-02-16 17:22,72481006,"14,320.2210","14,310.4210",10.00 AED,10.00,9.8000,0.2000,564407703,1586313,Success,United Arab Emirates,DU UAE,Transguard Group LLC,API User,E6AEAE22430
2022-02-16 17:24,72481122,"14,310.4210","14,300.6210",10.00 AED,10.00,9.8000,0.2000,564408004,1586320,Success,United Arab Emirates,DU UAE,Transguard Group LLC,API User,E6AEAE22430
2022-02-16 17:25,72481221,"14,300.6210","14,290.8210",10.00 AED,10.00,9.8000,0.2000,564408286,1586323,Success,United Arab Emirates,DU UAE,Transguard Group LLC,API User,E6AEAE22430
2022-02-16 17:26,72481318,"14,290.8210","14,281.0210",10.00 AED,10.00,9.8000,0.2000,564408509,1586327,Success,United Arab Emirates,DU UAE,Transguard Group LLC,API User,E6AEAE22430
2022-02-16 17:28,72481449,"14,281.0210","14,276.1210",05.00 AED,5.00,4.9000,0.1000,564408821,1586331,Success,United Arab Emirates,DU UAE,Transguard Group LLC,API User,E6AEAE17361
2022-02-16 17:29,72481503,"14,276.1210","14,266.3210",10.00 AED,10.00,9.8000,0.2000,564408949,1586335,Success,United Arab Emirates,DU UAE,Transguard Group LLC,API User,E6AEAE22430
2022-02-16 17:30,72481588,"14,266.3210","14,261.4210",05.00 AED,5.00,4.9000,0.1000,564409167,1586338,Success,United Arab Emirates,DU UAE,Transguard Group LLC,API User,E6AEAE17361
2022-02-16 17:33,72481800,"14,261.4210","14,256.5210",05.00 AED,5.00,4.9000,0.1000,564409686,1586343,Success,United Arab Emirates,DU UAE,Transguard Group LLC,API User,E6AEAE17361
2022-02-16 17:34,72481905,"14,256.5210","14,246.7210",10.00 AED,10.00,9.8000,0.2000,564409979,1586348,Success,United Arab Emirates,DU UAE,Transguard Group LLC,API User,E6AEAE22430
2022-02-16 17:36,72482019,"14,246.7210","14,241.8210",05.00 AED,5.00,4.9000,0.1000,564410235,1586353,Success,United Arab Emirates,DU UAE,Transguard Group LLC,API User,E6AEAE17361
2022-02-16 17:39,72482275,"14,241.8210","14,236.9210",05.00 AED,5.00,4.9000,0.1000,564410859,1586362,Success,United Arab Emirates,DU UAE,Transguard Group LLC,API User,E6AEAE17361
2022-02-16 17:40,72482369,"14,236.9210","14,232.0210",05.00 AED,5.00,4.9000,0.1000,564411078,1586367,Success,United Arab Emirates,DU UAE,Transguard Group LLC,API User,E6AEAE17361
2022-02-16 17:41,72482493,"14,232.0210","14,212.4210",20.00 AED,20.00,19.6000,0.4000,564411407,1586370,Success,United Arab Emirates,DU UAE,Transguard Group LLC,API User,E6AEAE12938
2022-02-16 17:44,72482657,"14,212.4210","14,207.5210",05.00 AED,5.00,4.9000,0.1000,564411836,1586377,Success,United Arab Emirates,DU UAE,Transguard Group LLC,API User,E6AEAE17361
2022-02-16 17:44,72482660,"14,207.5210","14,202.6210",05.00 AED,5.00,4.9000,0.1000,564411849,1586378,Success,United Arab Emirates,DU UAE,Transguard Group LLC,API User,E6AEAE17361
2022-02-16 17:45,72482733,"14,202.6210","14,197.7210",05.00 AED,5.00,4.9000,0.1000,564412018,1586381,Success,United Arab Emirates,DU UAE,Transguard Group LLC,API User,E6AEAE17361
2022-02-16 17:45,72482773,"14,197.7210","14,193.9810",100.00 NPR,4.25,3.7400,0.5100,564412147,1586385,Success,Nepal,Ncell Nepal,Transguard Group LLC,API User,NP_NC_TopUp_100.00
2022-02-16 17:48,72483027,"14,193.9810","14,184.1810",10.00 AED,10.00,9.8000,0.2000,564412760,1586395,Success,United Arab Emirates,DU UAE,Transguard Group LLC,API User,E6AEAE22430
2022-02-16 17:51,72483229,"14,184.1810","14,179.2810",05.00 AED,5.00,4.9000,0.1000,564413281,1586402,Success,United Arab Emirates,DU UAE,Transguard Group LLC,API User,E6AEAE17361
2022-02-16 17:53,72483393,"14,179.2810","14,174.3810",05.00 AED,5.00,4.9000,0.1000,564413718,1586407,Success,United Arab Emirates,DU UAE,Transguard Group LLC,API User,E6AEAE17361
2022-02-16 17:57,72483685,"14,174.3810","14,149.8810",25.00 AED,25.00,24.5000,0.5000,564414539,1586416,Success,United Arab Emirates,DU UAE,Transguard Group LLC,API User,E6AEAE17343
2022-02-16 17:59,72483815,"14,149.8810","14,144.9810",05.00 AED,5.00,4.9000,0.1000,564414925,1586423,Success,United Arab Emirates,DU UAE,Transguard Group LLC,API User,E6AEAE17361
2022-02-16 18:00,72483880,"14,144.9810","14,140.0810",05.00 AED,5.00,4.9000,0.1000,564415093,1586427,Success,United Arab Emirates,DU UAE,Transguard Group LLC,API User,E6AEAE17361
2022-02-16 18:00,72483960,"14,140.0810","14,135.1810",05.00 AED,5.00,4.9000,0.1000,564415290,1586431,Success,United Arab Emirates,DU UAE,Transguard Group LLC,API User,E6AEAE17361
2022-02-16 18:02,72484050,"14,135.1810","14,125.3810",10.00 AED,10.00,9.8000,0.2000,564415540,1586434,Success,United Arab Emirates,DU UAE,Transguard Group LLC,API User,E6AEAE22430
2022-02-16 18:03,72484156,"14,125.3810","14,115.5810",10.00 AED,10.00,9.8000,0.2000,564415824,1586439,Success,United Arab Emirates,DU UAE,Transguard Group LLC,API User,E6AEAE22430
2022-02-16 18:04,72484247,"14,115.5810","14,076.3810",40.00 AED,40.00,39.2000,0.8000,564416052,1586443,Success,United Arab Emirates,DU UAE,Transguard Group LLC,API User,E6AEAE64011
2022-02-16 18:05,72484302,"14,076.3810","14,056.7810",20.00 AED,20.00,19.6000,0.4000,564416218,1586449,Success,United Arab Emirates,DU UAE,Transguard Group LLC,API User,E6AEAE12938
2022-02-16 18:06,72484370,"14,056.7810","14,046.9810",10.00 AED,10.00,9.8000,0.2000,564416401,1586452,Success,United Arab Emirates,DU UAE,Transguard Group LLC,API User,E6AEAE22430
2022-02-16 18:11,72484849,"14,046.9810","14,037.1810",10.00 AED,10.00,9.8000,0.2000,564417608,1586463,Success,United Arab Emirates,DU UAE,Transguard Group LLC,API User,E6AEAE22430
2022-02-16 18:12,72484952,"14,037.1810","14,027.3810",10.00 AED,10.00,9.8000,0.2000,564417869,1586466,Success,United Arab Emirates,DU UAE,Transguard Group LLC,API User,E6AEAE22430
2022-02-16 18:18,72485475,"14,027.3810","14,017.5810",10.00 AED,10.00,9.8000,0.2000,564419226,1586479,Success,United Arab Emirates,DU UAE,Transguard Group LLC,API User,E6AEAE22430
2022-02-16 18:20,72485608,"14,017.5810","14,012.6810",05.00 AED,5.00,4.9000,0.1000,564419543,1586484,Success,United Arab Emirates,DU UAE,Transguard Group LLC,API User,E6AEAE17361
2022-02-16 18:20,72485621,"14,012.6810","14,007.7810",05.00 AED,5.00,4.9000,0.1000,564419608,1586486,Success,United Arab Emirates,DU UAE,Transguard Group LLC,API User,E6AEAE17361
2022-02-16 18:22,72485815,"14,007.7810","13,997.9810",10.00 AED,10.00,9.8000,0.2000,564420093,1586491,Success,United Arab Emirates,DU UAE,Transguard Group LLC,API User,E6AEAE22430
2022-02-16 18:25,72486084,"13,997.9810","13,988.1810",10.00 AED,10.00,9.8000,0.2000,564420787,1586497,Success,United Arab Emirates,DU UAE,Transguard Group LLC,API User,E6AEAE22430
2022-02-16 18:26,72486132,"13,988.1810","13,983.2810",05.00 AED,5.00,4.9000,0.1000,564420932,1586500,Success,United Arab Emirates,DU UAE,Transguard Group LLC,API User,E6AEAE17361
2022-02-16 18:27,72486235,"13,983.2810","13,978.3810",05.00 AED,5.00,4.9000,0.1000,564421205,1586507,Success,United Arab Emirates,DU UAE,Transguard Group LLC,API User,E6AEAE17361
2022-02-16 18:28,72486287,"13,978.3810","13,968.5810",10.00 AED,10.00,9.8000,0.2000,564421342,1586511,Success,United Arab Emirates,DU UAE,Transguard Group LLC,API User,E6AEAE22430
2022-02-16 18:30,72486501,"13,968.5810","13,963.6810",05.00 AED,5.00,4.9000,0.1000,564421898,1586516,Success,United Arab Emirates,DU UAE,Transguard Group LLC,API User,E6AEAE17361
2022-02-16 18:33,72486737,"13,963.6810","13,958.7810",05.00 AED,5.00,4.9000,0.1000,564422473,1586519,Success,United Arab Emirates,DU UAE,Transguard Group LLC,API User,E6AEAE17361
2022-02-16 18:38,72487233,"13,958.7810","13,948.9810",10.00 AED,10.00,9.8000,0.2000,564423692,1586530,Success,United Arab Emirates,DU UAE,Transguard Group LLC,API User,E6AEAE22430
2022-02-16 18:38,72487316,"13,948.9810","13,944.0810",05.00 AED,5.00,4.9000,0.1000,564423876,1586533,Success,United Arab Emirates,DU UAE,Transguard Group LLC,API User,E6AEAE17361
2022-02-16 18:40,72487437,"13,944.0810","13,934.2810",10.00 AED,10.00,9.8000,0.2000,564424162,1586536,Success,United Arab Emirates,DU UAE,Transguard Group LLC,API User,E6AEAE22430
2022-02-16 18:41,72487582,"13,934.2810","13,929.3810",05.00 AED,5.00,4.9000,0.1000,564424587,1586541,Success,United Arab Emirates,DU UAE,Transguard Group LLC,API User,E6AEAE17361
2022-02-16 18:42,72487703,"13,929.3810","13,924.4810",05.00 AED,5.00,4.9000,0.1000,564424848,1586548,Success,United Arab Emirates,DU UAE,Transguard Group LLC,API User,E6AEAE17361
2022-02-16 18:43,72487707,"13,924.4810","13,914.6810",10.00 AED,10.00,9.8000,0.2000,564424871,1586549,Success,United Arab Emirates,DU UAE,Transguard Group LLC,API User,E6AEAE22430
2022-02-16 18:44,72487806,"13,914.6810","13,909.7810",05.00 AED,5.00,4.9000,0.1000,564425095,1586556,Success,United Arab Emirates,DU UAE,Transguard Group LLC,API User,E6AEAE17361
2022-02-16 18:44,72487885,"13,909.7810","13,904.8810",05.00 AED,5.00,4.9000,0.1000,564425288,1586559,Success,United Arab Emirates,DU UAE,Transguard Group LLC,API User,E6AEAE17361
2022-02-16 18:47,72488181,"13,904.8810","13,895.0810",10.00 AED,10.00,9.8000,0.2000,564425996,1586562,Success,United Arab Emirates,DU UAE,Transguard Group LLC,API User,E6AEAE22430
2022-02-16 18:49,72488373,"13,895.0810","13,890.1810",05.00 AED,5.00,4.9000,0.1000,564426466,1586572,Success,United Arab Emirates,DU UAE,Transguard Group LLC,API User,E6AEAE17361
2022-02-16 18:52,72488554,"13,890.1810","13,880.3810",10.00 AED,10.00,9.8000,0.2000,564426994,1586582,Success,United Arab Emirates,DU UAE,Transguard Group LLC,API User,E6AEAE22430
2022-02-16 18:52,72488623,"13,880.3810","13,870.5810",10.00 AED,10.00,9.8000,0.2000,564427183,1586585,Success,United Arab Emirates,DU UAE,Transguard Group LLC,API User,E6AEAE22430
2022-02-16 19:01,72489389,"13,870.5810","13,865.6810",05.00 AED,5.00,4.9000,0.1000,564429123,1586610,Success,United Arab Emirates,DU UAE,Transguard Group LLC,API User,E6AEAE17361
2022-02-16 19:03,72489617,"13,865.6810","13,855.8810",10.00 AED,10.00,9.8000,0.2000,564429660,1586619,Success,United Arab Emirates,DU UAE,Transguard Group LLC,API User,E6AEAE22430
2022-02-16 19:03,72489643,"13,855.8810","13,850.9810",05.00 AED,5.00,4.9000,0.1000,564429726,1586621,Success,United Arab Emirates,DU UAE,Transguard Group LLC,API User,E6AEAE17361
2022-02-16 19:06,72489957,"13,850.9810","13,841.1810",10.00 AED,10.00,9.8000,0.2000,564430437,1586625,Success,United Arab Emirates,DU UAE,Transguard Group LLC,API User,E6AEAE22430
2022-02-16 19:06,72490024,"13,841.1810","13,836.2810",05.00 AED,5.00,4.9000,0.1000,564430588,1586628,Success,United Arab Emirates,DU UAE,Transguard Group LLC,API User,E6AEAE17361
2022-02-16 19:10,72490462,"13,836.2810","13,826.4810",10.00 AED,10.00,9.8000,0.2000,564431555,1586632,Success,United Arab Emirates,DU UAE,Transguard Group LLC,API User,E6AEAE22430
2022-02-16 19:11,72490642,"13,826.4810","13,821.5810",05.00 AED,5.00,4.9000,0.1000,564431948,1586638,Success,United Arab Emirates,DU UAE,Transguard Group LLC,API User,E6AEAE17361
2022-02-16 19:12,72490774,"13,821.5810","13,801.9810",20.00 AED,20.00,19.6000,0.4000,564432196,1586642,Success,United Arab Emirates,DU UAE,Transguard Group LLC,API User,E6AEAE12938
2022-02-16 19:13,72490899,"13,801.9810","13,792.1810",10.00 AED,10.00,9.8000,0.2000,564432468,1586649,Success,United Arab Emirates,DU UAE,Transguard Group LLC,API User,E6AEAE22430
2022-02-16 19:16,72491215,"13,792.1810","13,782.3810",10.00 AED,10.00,9.8000,0.2000,564433252,1586656,Success,United Arab Emirates,DU UAE,Transguard Group LLC,API User,E6AEAE22430
2022-02-16 19:17,72491287,"13,782.3810","13,777.4810",05.00 AED,5.00,4.9000,0.1000,564433426,1586664,Success,United Arab Emirates,DU UAE,Transguard Group LLC,API User,E6AEAE17361
2022-02-16 19:18,72491376,"13,777.4810","13,733.3810",45.00 AED,45.00,44.1000,0.9000,564433626,1586668,Success,United Arab Emirates,DU UAE,Transguard Group LLC,API User,E6AEAE35243
2022-02-16 19:19,72491495,"13,733.3810","13,728.4810",05.00 AED,5.00,4.9000,0.1000,564433938,1586674,Success,United Arab Emirates,DU UAE,Transguard Group LLC,API User,E6AEAE17361
2022-02-16 19:19,72491518,"13,728.4810","13,723.5810",05.00 AED,5.00,4.9000,0.1000,564433980,1586675,Success,United Arab Emirates,DU UAE,Transguard Group LLC,API User,E6AEAE17361
2022-02-16 19:24,72492085,"13,723.5810","13,713.7810",10.00 AED,10.00,9.8000,0.2000,564435407,1586690,Success,United Arab Emirates,DU UAE,Transguard Group LLC,API User,E6AEAE22430
2022-02-16 19:24,72492100,"13,713.7810","13,708.8810",05.00 AED,5.00,4.9000,0.1000,564435444,1586691,Success,United Arab Emirates,DU UAE,Transguard Group LLC,API User,E6AEAE17361
2022-02-16 19:28,72492485,"13,708.8810","13,703.9810",05.00 AED,5.00,4.9000,0.1000,564436418,1586699,Success,United Arab Emirates,DU UAE,Transguard Group LLC,API User,E6AEAE17361
2022-02-16 19:31,72492771,"13,703.9810","13,699.0810",05.00 AED,5.00,4.9000,0.1000,564437191,1586706,Success,United Arab Emirates,DU UAE,Transguard Group LLC,API User,E6AEAE17361
2022-02-16 19:32,72492901,"13,699.0810","13,694.1810",05.00 AED,5.00,4.9000,0.1000,564437537,1586711,Success,United Arab Emirates,DU UAE,Transguard Group LLC,API User,E6AEAE17361
2022-02-16 19:33,72493012,"13,694.1810","13,689.2810",05.00 AED,5.00,4.9000,0.1000,564437795,1586714,Success,United Arab Emirates,DU UAE,Transguard Group LLC,API User,E6AEAE17361
2022-02-16 19:39,72493569,"13,689.2810","13,679.4810",10.00 AED,10.00,9.8000,0.2000,564439297,1586734,Success,United Arab Emirates,DU UAE,Transguard Group LLC,API User,E6AEAE22430
2022-02-16 19:40,72493619,"13,679.4810","13,669.6810",10.00 AED,10.00,9.8000,0.2000,564439441,1586739,Success,United Arab Emirates,DU UAE,Transguard Group LLC,API User,E6AEAE22430
2022-02-16 19:43,72493931,"13,669.6810","13,664.7810",05.00 AED,5.00,4.9000,0.1000,564440228,1586746,Success,United Arab Emirates,DU UAE,Transguard Group LLC,API User,E6AEAE17361
2022-02-16 19:43,72493951,"13,664.7810","13,654.9810",10.00 AED,10.00,9.8000,0.2000,564440304,1586749,Success,United Arab Emirates,DU UAE,Transguard Group LLC,API User,E6AEAE22430
2022-02-16 19:43,72493976,"13,654.9810","13,651.2410",102.00 NPR,4.25,3.7400,0.5100,564440375,1586750,Success,Nepal,Nepal Telecom Nepal,Transguard Group LLC,API User,NENPNP19715
2022-02-16 19:44,72494070,"13,651.2410","13,636.5410",15.00 AED,15.00,14.7000,0.3000,564440616,1586754,Success,United Arab Emirates,DU UAE,Transguard Group LLC,API User,E6AEAE8527
2022-02-16 19:46,72494245,"13,636.5410","13,598.5410",10.00 USD,40.00,38.0000,2.0000,564441116,1586761,Success,United States,Google Play US,Transguard Group LLC,API User,GPUSUS88522
2022-02-16 19:46,72494286,"13,598.5410","13,593.6410",05.00 AED,5.00,4.9000,0.1000,564441185,1586763,Success,United Arab Emirates,DU UAE,Transguard Group LLC,API User,E6AEAE17361
2022-02-16 19:47,72494371,"13,593.6410","13,588.7410",05.00 AED,5.00,4.9000,0.1000,564441410,1586770,Success,United Arab Emirates,DU UAE,Transguard Group LLC,API User,E6AEAE17361
2022-02-16 19:47,72494381,"13,588.7410","13,583.8410",05.00 AED,5.00,4.9000,0.1000,564441421,1586771,Success,United Arab Emirates,DU UAE,Transguard Group LLC,API User,E6AEAE17361
2022-02-16 19:49,72494497,"13,583.8410","13,578.9410",05.00 AED,5.00,4.9000,0.1000,564441738,1586780,Success,United Arab Emirates,DU UAE,Transguard Group LLC,API User,E6AEAE17361
2022-02-16 19:49,72494535,"13,578.9410","13,569.1410",10.00 AED,10.00,9.8000,0.2000,564441829,1586783,Success,United Arab Emirates,DU UAE,Transguard Group LLC,API User,E6AEAE22430
2022-02-16 19:50,72494705,"13,569.1410","13,564.2410",05.00 AED,5.00,4.9000,0.1000,564442232,1586794,Success,United Arab Emirates,DU UAE,Transguard Group LLC,API User,E6AEAE17361
2022-02-16 19:51,72494777,"13,564.2410","13,559.3410",05.00 AED,5.00,4.9000,0.1000,564442405,1586797,Success,United Arab Emirates,DU UAE,Transguard Group LLC,API User,E6AEAE17361
2022-02-16 19:52,72494890,"13,559.3410","13,554.4410",05.00 AED,5.00,4.9000,0.1000,564442676,1586805,Success,United Arab Emirates,DU UAE,Transguard Group LLC,API User,E6AEAE17361
2022-02-16 19:54,72495075,"13,554.4410","13,520.1410",35.00 AED,35.00,34.3000,0.7000,564443166,1586811,Success,United Arab Emirates,DU UAE,Transguard Group LLC,API User,E6AEAE73954
2022-02-16 19:57,72495383,"13,520.1410","13,510.3410",10.00 AED,10.00,9.8000,0.2000,564443999,1586822,Success,United Arab Emirates,DU UAE,Transguard Group LLC,API User,E6AEAE22430
2022-02-16 19:58,72495444,"13,510.3410","13,505.4410",05.00 AED,5.00,4.9000,0.1000,564444152,1586826,Success,United Arab Emirates,DU UAE,Transguard Group LLC,API User,E6AEAE17361
2022-02-16 19:58,72495456,"13,505.4410","13,496.6410",315.00 PKR,10.00,8.8000,1.2000,564444207,1586828,Success,Pakistan,Telenor Pakistan,Transguard Group LLC,API User,TPPKPK75105
2022-02-16 19:59,72495593,"13,496.6410","13,491.7410",05.00 AED,5.00,4.9000,0.1000,564444544,1586834,Success,United Arab Emirates,DU UAE,Transguard Group LLC,API User,E6AEAE17361
2022-02-16 20:01,72495759,"13,491.7410","13,486.8410",05.00 AED,5.00,4.9000,0.1000,564445011,1586838,Success,United Arab Emirates,DU UAE,Transguard Group LLC,API User,E6AEAE17361
2022-02-16 20:05,72496176,"13,486.8410","13,467.2410",20.00 AED,20.00,19.6000,0.4000,564446113,1586847,Success,United Arab Emirates,DU UAE,Transguard Group LLC,API User,E6AEAE12938
2022-02-16 20:09,72496560,"13,467.2410","13,462.3410",05.00 AED,5.00,4.9000,0.1000,564447052,1586861,Success,United Arab Emirates,DU UAE,Transguard Group LLC,API User,E6AEAE17361
2022-02-16 20:11,72496830,"13,462.3410","13,455.0810",200.00 NPR,8.25,7.2600,0.9900,564447792,1586870,Success,Nepal,Nepal Telecom Nepal,Transguard Group LLC,API User,NP_NE_TopUp_200.00
2022-02-16 20:13,72496987,"13,455.0810","13,445.2810",10.00 AED,10.00,9.8000,0.2000,564448161,1586880,Success,United Arab Emirates,DU UAE,Transguard Group LLC,API User,E6AEAE22430
2022-02-16 20:13,72497040,"13,445.2810","13,440.3810",05.00 AED,5.00,4.9000,0.1000,564448307,1586884,Success,United Arab Emirates,DU UAE,Transguard Group LLC,API User,E6AEAE17361
2022-02-16 20:14,72497100,"13,440.3810","13,435.4810",05.00 AED,5.00,4.9000,0.1000,564448455,1586887,Success,United Arab Emirates,DU UAE,Transguard Group LLC,API User,E6AEAE17361
2022-02-16 20:14,72497132,"13,435.4810","13,430.5810",05.00 AED,5.00,4.9000,0.1000,564448537,1586891,Success,United Arab Emirates,DU UAE,Transguard Group LLC,API User,E6AEAE17361
2022-02-16 20:15,72497188,"13,430.5810","13,425.6810",05.00 AED,5.00,4.9000,0.1000,564448710,1586894,Success,United Arab Emirates,DU UAE,Transguard Group LLC,API User,E6AEAE17361
2022-02-16 20:15,72497246,"13,425.6810","13,420.7810",05.00 AED,5.00,4.9000,0.1000,564448855,1586898,Success,United Arab Emirates,DU UAE,Transguard Group LLC,API User,E6AEAE17361
2022-02-16 20:16,72497351,"13,415.8810","13,412.1410",100.00 NPR,4.25,3.7400,0.5100,564449137,1586907,Success,Nepal,Ncell Nepal,Transguard Group LLC,API User,NP_NC_TopUp_100.00
2022-02-16 20:16,72497353,"13,420.7810","13,415.8810",05.00 AED,5.00,4.9000,0.1000,564449130,1586906,Success,United Arab Emirates,DU UAE,Transguard Group LLC,API User,E6AEAE17361
2022-02-16 20:18,72497489,"13,412.1410","13,407.2410",05.00 AED,5.00,4.9000,0.1000,564449466,1586912,Success,United Arab Emirates,DU UAE,Transguard Group LLC,API User,E6AEAE17361
2022-02-16 20:18,72497535,"13,407.2410","13,397.4410",10.00 AED,10.00,9.8000,0.2000,564449540,1586913,Success,United Arab Emirates,DU UAE,Transguard Group LLC,API User,E6AEAE22430
2022-02-16 20:19,72497593,"13,397.4410","13,387.6410",10.00 AED,10.00,9.8000,0.2000,564449707,1586916,Success,United Arab Emirates,DU UAE,Transguard Group LLC,API User,E6AEAE22430
2022-02-16 20:19,72497654,"13,387.6410","13,377.8410",10.00 AED,10.00,9.8000,0.2000,564449868,1586919,Success,United Arab Emirates,DU UAE,Transguard Group LLC,API User,E6AEAE22430
2022-02-16 20:20,72497714,"13,377.8410","13,368.0410",10.00 AED,10.00,9.8000,0.2000,564450069,1586925,Success,United Arab Emirates,DU UAE,Transguard Group LLC,API User,E6AEAE22430
2022-02-16 20:23,72498022,"13,368.0410","13,358.2410",10.00 AED,10.00,9.8000,0.2000,564450871,1586938,Success,United Arab Emirates,DU UAE,Transguard Group LLC,API User,E6AEAE22430
2022-02-16 20:24,72498115,"13,358.2410","13,338.6410",20.00 AED,20.00,19.6000,0.4000,564451101,1586944,Success,United Arab Emirates,DU UAE,Transguard Group LLC,API User,E6AEAE12938
2022-02-16 20:27,72498338,"13,338.6410","13,333.7410",05.00 AED,5.00,4.9000,0.1000,564451702,1586951,Success,United Arab Emirates,DU UAE,Transguard Group LLC,API User,E6AEAE17361
2022-02-16 20:32,72498815,"13,333.7410","13,323.9410",10.00 AED,10.00,9.8000,0.2000,564452979,1586965,Success,United Arab Emirates,DU UAE,Transguard Group LLC,API User,E6AEAE22430
2022-02-16 20:33,72498962,"13,323.9410","13,319.0410",05.00 AED,5.00,4.9000,0.1000,564453400,1586974,Success,United Arab Emirates,DU UAE,Transguard Group LLC,API User,E6AEAE17361
2022-02-16 20:34,72498975,"13,319.0410","13,314.1410",05.00 AED,5.00,4.9000,0.1000,564453448,1586976,Success,United Arab Emirates,DU UAE,Transguard Group LLC,API User,E6AEAE17361
2022-02-16 20:36,72499205,"13,314.1410","13,309.2410",05.00 AED,5.00,4.9000,0.1000,564454102,1586983,Success,United Arab Emirates,DU UAE,Transguard Group LLC,API User,E6AEAE17361
2022-02-16 20:37,72499264,"13,309.2410","13,304.3410",05.00 AED,5.00,4.9000,0.1000,564454283,1586987,Success,United Arab Emirates,DU UAE,Transguard Group LLC,API User,E6AEAE17361
2022-02-16 20:39,72499483,"13,304.3410","13,299.4410",05.00 AED,5.00,4.9000,0.1000,564454873,1586991,Success,United Arab Emirates,DU UAE,Transguard Group LLC,API User,E6AEAE17361
2022-02-16 20:42,72499748,"13,299.4410","13,289.6410",10.00 AED,10.00,9.8000,0.2000,564455580,1587004,Success,United Arab Emirates,DU UAE,Transguard Group LLC,API User,E6AEAE22430
2022-02-16 20:44,72499874,"13,289.6410","13,284.7410",05.00 AED,5.00,4.9000,0.1000,564455944,1587007,Success,United Arab Emirates,DU UAE,Transguard Group LLC,API User,E6AEAE17361
2022-02-16 20:49,72500365,"13,284.7410","13,276.1610",315.00 PKR,9.75,8.5800,1.1700,564457247,1587017,Success,Pakistan,Zong Pakistan,Transguard Group LLC,API User,ZNPKPK29953
2022-02-16 20:50,72500442,"13,276.1610","13,271.2610",05.00 AED,5.00,4.9000,0.1000,564457411,1587020,Success,United Arab Emirates,DU UAE,Transguard Group LLC,API User,E6AEAE17361
2022-02-16 20:51,72500576,"13,271.2610","13,266.3610",05.00 AED,5.00,4.9000,0.1000,564457744,1587023,Success,United Arab Emirates,DU UAE,Transguard Group LLC,API User,E6AEAE17361
2022-02-16 20:53,72500761,"13,266.3610","13,256.5610",10.00 AED,10.00,9.8000,0.2000,564458242,1587031,Success,United Arab Emirates,DU UAE,Transguard Group LLC,API User,E6AEAE22430
2022-02-16 20:54,72500892,"13,256.5610","13,251.6610",05.00 AED,5.00,4.9000,0.1000,564458531,1587037,Success,United Arab Emirates,DU UAE,Transguard Group LLC,API User,E6AEAE17361
2022-02-16 20:54,72500908,"13,251.6610","13,241.8610",10.00 AED,10.00,9.8000,0.2000,564458578,1587039,Success,United Arab Emirates,DU UAE,Transguard Group LLC,API User,E6AEAE22430
2022-02-16 20:59,72501295,"13,241.8610","13,236.9610",05.00 AED,5.00,4.9000,0.1000,564459591,1587050,Success,United Arab Emirates,DU UAE,Transguard Group LLC,API User,E6AEAE17361
2022-02-16 21:00,72501473,"13,236.9610","13,232.0610",05.00 AED,5.00,4.9000,0.1000,564460046,1587057,Success,United Arab Emirates,DU UAE,Transguard Group LLC,API User,E6AEAE17361
2022-02-16 21:01,72501535,"13,232.0610","13,227.1610",05.00 AED,5.00,4.9000,0.1000,564460247,1587066,Success,United Arab Emirates,DU UAE,Transguard Group LLC,API User,E6AEAE17361
2022-02-16 21:01,72501536,"13,227.1610","13,222.2610",05.00 AED,5.00,4.9000,0.1000,564460250,1587067,Success,United Arab Emirates,DU UAE,Transguard Group LLC,API User,E6AEAE17361
2022-02-16 21:03,72501709,"13,222.2610","13,213.4610",315.00 PKR,10.00,8.8000,1.2000,564460657,1587072,Success,Pakistan,Telenor Pakistan,Transguard Group LLC,API User,TPPKPK75105
2022-02-16 21:03,72501720,"13,213.4610","13,208.5610",05.00 AED,5.00,4.9000,0.1000,564460664,1587074,Success,United Arab Emirates,DU UAE,Transguard Group LLC,API User,E6AEAE17361
2022-02-16 21:05,72501881,"13,208.5610","13,203.6610",05.00 AED,5.00,4.9000,0.1000,564461092,1587085,Success,United Arab Emirates,DU UAE,Transguard Group LLC,API User,E6AEAE17361
2022-02-16 21:07,72502098,"13,203.6610","13,198.7610",05.00 AED,5.00,4.9000,0.1000,564461604,1587096,Success,United Arab Emirates,DU UAE,Transguard Group LLC,API User,E6AEAE17361
2022-02-16 21:08,72502234,"13,198.7610","13,188.9610",10.00 AED,10.00,9.8000,0.2000,564461935,1587104,Success,United Arab Emirates,DU UAE,Transguard Group LLC,API User,E6AEAE22430
2022-02-16 21:09,72502256,"13,188.9610","13,179.1610",10.00 AED,10.00,9.8000,0.2000,564462002,1587106,Success,United Arab Emirates,DU UAE,Transguard Group LLC,API User,E6AEAE22430
2022-02-16 21:10,72502393,"13,179.1610","13,174.2610",05.00 AED,5.00,4.9000,0.1000,564462379,1587112,Success,United Arab Emirates,DU UAE,Transguard Group LLC,API User,E6AEAE17361
2022-02-16 21:12,72502567,"13,174.2610","13,164.4610",10.00 AED,10.00,9.8000,0.2000,564462788,1587121,Success,United Arab Emirates,DU UAE,Transguard Group LLC,API User,E6AEAE22430
2022-02-16 21:13,72502625,"13,164.4610","13,144.8610",20.00 AED,20.00,19.6000,0.4000,564462956,1587127,Success,United Arab Emirates,DU UAE,Transguard Group LLC,API User,E6AEAE12938
2022-02-16 21:14,72502699,"13,144.8610","13,105.6610",40.00 AED,40.00,39.2000,0.8000,564463145,1587130,Success,United Arab Emirates,DU UAE,Transguard Group LLC,API User,E6AEAE64011
2022-02-16 21:17,72503021,"13,105.6610","13,095.8610",10.00 AED,10.00,9.8000,0.2000,564464008,1587142,Success,United Arab Emirates,DU UAE,Transguard Group LLC,API User,E6AEAE22430
2022-02-16 21:19,72503158,"13,095.8610","13,086.0610",10.00 AED,10.00,9.8000,0.2000,564464332,1587150,Success,United Arab Emirates,DU UAE,Transguard Group LLC,API User,E6AEAE22430
2022-02-16 21:19,72503184,"13,086.0610","13,081.1610",05.00 AED,5.00,4.9000,0.1000,564464409,1587151,Success,United Arab Emirates,DU UAE,Transguard Group LLC,API User,E6AEAE17361
2022-02-16 21:20,72503257,"13,081.1610","13,076.2610",05.00 AED,5.00,4.9000,0.1000,564464596,1587154,Success,United Arab Emirates,DU UAE,Transguard Group LLC,API User,E6AEAE17361
2022-02-16 21:20,72503306,"13,076.2610","13,071.3610",05.00 AED,5.00,4.9000,0.1000,564464748,1587157,Success,United Arab Emirates,DU UAE,Transguard Group LLC,API User,E6AEAE17361
2022-02-16 21:21,72503367,"13,071.3610","13,066.4610",05.00 AED,5.00,4.9000,0.1000,564464900,1587160,Success,United Arab Emirates,DU UAE,Transguard Group LLC,API User,E6AEAE17361
2022-02-16 21:26,72503766,"13,066.4610","13,061.5610",05.00 AED,5.00,4.9000,0.1000,564465992,1587167,Success,United Arab Emirates,DU UAE,Transguard Group LLC,API User,E6AEAE17361
2022-02-16 21:32,72504257,"13,061.5610","13,057.3810",150.00 PKR,4.75,4.1800,0.5700,564467334,1587175,Success,Pakistan,Jazz Pakistan,Transguard Group LLC,API User,MBPKPK20699
2022-02-16 21:34,72504435,"13,057.3810","13,052.4810",05.00 AED,5.00,4.9000,0.1000,564467766,1587182,Success,United Arab Emirates,DU UAE,Transguard Group LLC,API User,E6AEAE17361
2022-02-16 21:34,72504464,"13,052.4810","13,032.8810",20.00 AED,20.00,19.6000,0.4000,564467829,1587185,Success,United Arab Emirates,DU UAE,Transguard Group LLC,API User,E6AEAE12938
2022-02-16 21:35,72504527,"13,032.8810","13,027.9810",05.00 AED,5.00,4.9000,0.1000,564468043,1587188,Success,United Arab Emirates,DU UAE,Transguard Group LLC,API User,E6AEAE17361
2022-02-16 21:37,72504662,"13,027.9810","12,988.7810",40.00 AED,40.00,39.2000,0.8000,564468438,1587192,Success,United Arab Emirates,DU UAE,Transguard Group LLC,API User,E6AEAE64011
2022-02-16 21:37,72504685,"12,988.7810","12,978.9810",10.00 AED,10.00,9.8000,0.2000,564468502,1587194,Success,United Arab Emirates,DU UAE,Transguard Group LLC,API User,E6AEAE22430
2022-02-16 21:38,72504711,"12,978.9810","12,959.3810",20.00 AED,20.00,19.6000,0.4000,564468578,1587197,Success,United Arab Emirates,DU UAE,Transguard Group LLC,API User,E6AEAE12938
2022-02-16 21:39,72504872,"12,959.3810","12,954.4810",05.00 AED,5.00,4.9000,0.1000,564469003,1587202,Success,United Arab Emirates,DU UAE,Transguard Group LLC,API User,E6AEAE17361
2022-02-16 21:41,72505017,"12,954.4810","12,944.6810",10.00 AED,10.00,9.8000,0.2000,564469373,1587207,Success,United Arab Emirates,DU UAE,Transguard Group LLC,API User,E6AEAE22430
2022-02-16 21:44,72505279,"12,944.6810","12,934.8810",10.00 AED,10.00,9.8000,0.2000,564470022,1587214,Success,United Arab Emirates,DU UAE,Transguard Group LLC,API User,E6AEAE22430
2022-02-16 21:46,72505448,"12,934.8810","12,929.9810",05.00 AED,5.00,4.9000,0.1000,564470481,1587217,Success,United Arab Emirates,DU UAE,Transguard Group LLC,API User,E6AEAE17361
2022-02-16 21:47,72505502,"12,929.9810","12,920.1810",10.00 AED,10.00,9.8000,0.2000,564470611,1587222,Success,United Arab Emirates,DU UAE,Transguard Group LLC,API User,E6AEAE22430
2022-02-16 21:52,72505938,"12,920.1810","12,910.3810",10.00 AED,10.00,9.8000,0.2000,564471771,1587236,Success,United Arab Emirates,DU UAE,Transguard Group LLC,API User,E6AEAE22430
2022-02-16 21:54,72506061,"12,910.3810","12,900.5810",10.00 AED,10.00,9.8000,0.2000,564472089,1587243,Success,United Arab Emirates,DU UAE,Transguard Group LLC,API User,E6AEAE22430
2022-02-16 21:55,72506130,"12,900.5810","12,895.6810",05.00 AED,5.00,4.9000,0.1000,564472262,1587247,Success,United Arab Emirates,DU UAE,Transguard Group LLC,API User,E6AEAE17361
2022-02-16 21:56,72506229,"12,895.6810","12,890.7810",05.00 AED,5.00,4.9000,0.1000,564472557,1587252,Success,United Arab Emirates,DU UAE,Transguard Group LLC,API User,E6AEAE17361
2022-02-16 22:01,72506620,"12,890.7810","12,885.8810",05.00 AED,5.00,4.9000,0.1000,564473605,1587261,Success,United Arab Emirates,DU UAE,Transguard Group LLC,API User,E6AEAE17361
2022-02-16 22:02,72506760,"12,885.8810","12,880.9810",05.00 AED,5.00,4.9000,0.1000,564474004,1587270,Success,United Arab Emirates,DU UAE,Transguard Group LLC,API User,E6AEAE17361
2022-02-16 22:04,72506906,"12,880.9810","12,876.0810",05.00 AED,5.00,4.9000,0.1000,564474411,1587279,Success,United Arab Emirates,DU UAE,Transguard Group LLC,API User,E6AEAE17361
2022-02-16 22:05,72506950,"12,876.0810","12,871.1810",05.00 AED,5.00,4.9000,0.1000,564474529,1587285,Success,United Arab Emirates,DU UAE,Transguard Group LLC,API User,E6AEAE17361
2022-02-16 22:07,72507136,"12,871.1810","12,866.2810",05.00 AED,5.00,4.9000,0.1000,564474997,1587289,Success,United Arab Emirates,DU UAE,Transguard Group LLC,API User,E6AEAE17361
2022-02-16 22:09,72507273,"12,866.2810","12,841.7810",25.00 AED,25.00,24.5000,0.5000,564475336,1587296,Success,United Arab Emirates,DU UAE,Transguard Group LLC,API User,E6AEAE17343
2022-02-16 22:09,72507292,"12,841.7810","12,836.8810",05.00 AED,5.00,4.9000,0.1000,564475388,1587298,Success,United Arab Emirates,DU UAE,Transguard Group LLC,API User,E6AEAE17361
2022-02-16 22:10,72507359,"12,836.8810","12,827.0810",10.00 AED,10.00,9.8000,0.2000,564475545,1587304,Success,United Arab Emirates,DU UAE,Transguard Group LLC,API User,E6AEAE22430
2022-02-16 22:10,72507364,"12,827.0810","12,822.1810",05.00 AED,5.00,4.9000,0.1000,564475557,1587305,Success,United Arab Emirates,DU UAE,Transguard Group LLC,API User,E6AEAE17361
2022-02-16 22:14,72507748,"12,822.1810","12,817.2810",05.00 AED,5.00,4.9000,0.1000,564476519,1587311,Success,United Arab Emirates,DU UAE,Transguard Group LLC,API User,E6AEAE17361
2022-02-16 22:21,72508251,"12,817.2810","12,807.4810",10.00 AED,10.00,9.8000,0.2000,564477910,1587321,Failure,United Arab Emirates,DU UAE,Transguard Group LLC,API User,E6AEAE22430
2022-02-16 22:21,72508251,"12,807.4810","12,797.6810",10.00 AED,10.00,9.8000,0.2000,564477910,1587321,Failure,United Arab Emirates,DU UAE,Transguard Group LLC,API User,E6AEAE22430
2022-02-16 22:23,72508416,"12,817.2810","12,812.3810",05.00 AED,5.00,4.9000,0.1000,564478365,1587328,Success,United Arab Emirates,DU UAE,Transguard Group LLC,API User,E6AEAE17361
2022-02-16 22:30,72508904,"12,792.7810","12,782.9810",10.00 AED,10.00,9.8000,0.2000,564479728,1587339,Success,United Arab Emirates,DU UAE,Transguard Group LLC,API User,E6AEAE22430
2022-02-16 22:30,72508905,"12,812.3810","12,792.7810",20.00 AED,20.00,19.6000,0.4000,564479708,1587338,Success,United Arab Emirates,DU UAE,Transguard Group LLC,API User,E6AEAE12938
2022-02-16 22:30,72508963,"12,782.9810","12,778.0810",05.00 AED,5.00,4.9000,0.1000,564479882,1587343,Success,United Arab Emirates,DU UAE,Transguard Group LLC,API User,E6AEAE17361
2022-02-16 22:31,72508984,"12,778.0810","12,773.1810",05.00 AED,5.00,4.9000,0.1000,564479964,1587345,Success,United Arab Emirates,DU UAE,Transguard Group LLC,API User,E6AEAE17361
2022-02-16 22:34,72509195,"12,773.1810","12,768.2810",05.00 AED,5.00,4.9000,0.1000,564480552,1587351,Success,United Arab Emirates,DU UAE,Transguard Group LLC,API User,E6AEAE17361
2022-02-16 22:35,72509248,"12,768.2810","12,763.3810",05.00 AED,5.00,4.9000,0.1000,564480690,1587355,Success,United Arab Emirates,DU UAE,Transguard Group LLC,API User,E6AEAE17361
2022-02-16 22:36,72509368,"12,763.3810","12,753.5810",10.00 AED,10.00,9.8000,0.2000,564481052,1587360,Success,United Arab Emirates,DU UAE,Transguard Group LLC,API User,E6AEAE22430
2022-02-16 22:37,72509388,"12,753.5810","12,743.7810",10.00 AED,10.00,9.8000,0.2000,564481101,1587361,Success,United Arab Emirates,DU UAE,Transguard Group LLC,API User,E6AEAE22430
2022-02-16 22:40,72509658,"12,743.7810","12,733.2210",179.00 INR,12.00,10.5600,1.4400,564481839,1587370,Success,India,Jio India,Transguard Group LLC,API User,RJININ96886
2022-02-16 22:45,72510025,"12,733.2210","12,713.6210",20.00 AED,20.00,19.6000,0.4000,564482802,1587375,Success,United Arab Emirates,DU UAE,Transguard Group LLC,API User,E6AEAE12938
2022-02-16 22:46,72510070,"12,713.6210","12,703.8210",10.00 AED,10.00,9.8000,0.2000,564482951,1587379,Success,United Arab Emirates,DU UAE,Transguard Group LLC,API User,E6AEAE22430
2022-02-16 22:52,72510463,"12,703.8210","12,698.9210",05.00 AED,5.00,4.9000,0.1000,564484081,1587385,Success,United Arab Emirates,DU UAE,Transguard Group LLC,API User,E6AEAE17361
2022-02-16 22:52,72510473,"12,698.9210","12,674.4210",25.00 AED,25.00,24.5000,0.5000,564484107,1587386,Success,United Arab Emirates,DU UAE,Transguard Group LLC,API User,E6AEAE17343
2022-02-16 22:59,72510911,"12,674.4210","12,669.5210",05.00 AED,5.00,4.9000,0.1000,564485518,1587391,Success,United Arab Emirates,DU UAE,Transguard Group LLC,API User,E6AEAE17361
2022-02-16 23:06,72511297,"12,669.5210","12,664.6210",05.00 AED,5.00,4.9000,0.1000,564486773,1587402,Success,United Arab Emirates,DU UAE,Transguard Group LLC,API User,E6AEAE17361
2022-02-16 23:08,72511423,"12,664.6210","12,659.7210",05.00 AED,5.00,4.9000,0.1000,564487184,1587407,Success,United Arab Emirates,DU UAE,Transguard Group LLC,API User,E6AEAE17361
2022-02-16 23:17,72511940,"12,659.7210","12,649.9210",10.00 AED,10.00,9.8000,0.2000,564488779,1587419,Success,United Arab Emirates,DU UAE,Transguard Group LLC,API User,E6AEAE22430
2022-02-16 23:28,72512553,"12,649.9210","12,645.0210",05.00 AED,5.00,4.9000,0.1000,564490653,1587426,Success,United Arab Emirates,DU UAE,Transguard Group LLC,API User,E6AEAE17361
2022-02-16 23:28,72512573,"12,645.0210","12,625.4210",20.00 AED,20.00,19.6000,0.4000,564490743,1587430,Success,United Arab Emirates,DU UAE,Transguard Group LLC,API User,E6AEAE12938
2022-02-16 23:29,72512620,"12,625.4210","12,605.8210",20.00 AED,20.00,19.6000,0.4000,564490902,1587435,Success,United Arab Emirates,DU UAE,Transguard Group LLC,API User,E6AEAE12938
2022-02-16 23:32,72512737,"12,605.8210","12,596.0210",10.00 AED,10.00,9.8000,0.2000,564491301,1587438,Success,United Arab Emirates,DU UAE,Transguard Group LLC,API User,E6AEAE22430
2022-02-16 23:45,72513483,"12,596.0210","12,592.2810",100.00 NPR,4.25,3.7400,0.5100,564493549,1587444,Success,Nepal,Nepal Telecom Nepal,Transguard Group LLC,API User,NP_NE_TopUp_100.00
2022-02-16 23:51,72513848,"12,592.2810","12,587.3810",05.00 AED,5.00,4.9000,0.1000,564494517,1587447,Success,United Arab Emirates,DU UAE,Transguard Group LLC,API User,E6AEAE17361
2022-02-16 23:52,72513885,"12,587.3810","12,582.4810",05.00 AED,5.00,4.9000,0.1000,564494615,1587450,Success,United Arab Emirates,DU UAE,Transguard Group LLC,API User,E6AEAE17361
2022-02-16 23:59,72514228,"12,582.4810","12,578.5210",500.00 XAF,4.50,3.9600,0.5400,564495662,1587455,Success,Cameroon,MTN Cameroon,Transguard Group LLC,API User,CM_MT_TopUp_500.00
2022-02-17 00:05,72514515,"12,578.5210","12,569.7210",820.00 NGN,10.00,8.8000,1.2000,564496447,1587460,Success,Nigeria,Airtel Nigeria,Transguard Group LLC,API User,NG_ZA_TopUp
2022-02-17 00:08,72514728,"12,569.7210","12,564.8210",05.00 AED,5.00,4.9000,0.1000,564497005,1587465,Success,United Arab Emirates,DU UAE,Transguard Group LLC,API User,E6AEAE17361
2022-02-17 00:13,72514962,"12,564.8210","12,555.0210",10.00 AED,10.00,9.8000,0.2000,564497706,1587470,Success,United Arab Emirates,DU UAE,Transguard Group LLC,API User,E6AEAE22430
2022-02-17 00:20,72515325,"12,555.0210","12,535.4210",20.00 AED,20.00,19.6000,0.4000,564498758,1587479,Success,United Arab Emirates,DU UAE,Transguard Group LLC,API User,E6AEAE12938
2022-02-17 00:21,72515359,"12,535.4210","12,525.6210",10.00 AED,10.00,9.8000,0.2000,564498887,1587483,Success,United Arab Emirates,DU UAE,Transguard Group LLC,API User,E6AEAE22430
2022-02-17 00:25,72515596,"12,515.8210","12,506.0210",10.00 AED,10.00,9.8000,0.2000,564499585,1587494,Failure,United Arab Emirates,DU UAE,Transguard Group LLC,API User,E6AEAE22430
2022-02-17 00:25,72515596,"12,506.0210","12,496.2210",10.00 AED,10.00,9.8000,0.2000,564499585,1587494,Failure,United Arab Emirates,DU UAE,Transguard Group LLC,API User,E6AEAE22430
2022-02-17 00:25,72515597,"12,525.6210","12,515.8210",10.00 AED,10.00,9.8000,0.2000,564499578,1587493,Success,United Arab Emirates,DU UAE,Transguard Group LLC,API User,E6AEAE22430
2022-02-17 00:29,72515757,"12,515.8210","12,506.0210",10.00 AED,10.00,9.8000,0.2000,564500054,1587501,Success,United Arab Emirates,DU UAE,Transguard Group LLC,API User,E6AEAE22430
2022-02-17 00:34,72515952,"12,506.0210","12,496.7810",249.00 NPR,10.50,9.2400,1.2600,564500664,1587507,Success,Nepal,Ncell Nepal,Transguard Group LLC,API User,NCNPNP23671
2022-02-17 00:51,72516759,"12,496.7810","12,491.8810",05.00 AED,5.00,4.9000,0.1000,564503025,1587515,Success,United Arab Emirates,DU UAE,Transguard Group LLC,API User,E6AEAE17361
2022-02-17 01:16,72517893,"12,491.8810","12,486.9810",05.00 AED,5.00,4.9000,0.1000,564506450,1587527,Success,United Arab Emirates,DU UAE,Transguard Group LLC,API User,E6AEAE17361
2022-02-17 01:22,72518174,"12,486.9810","12,477.1810",10.00 AED,10.00,9.8000,0.2000,564507225,1587534,Success,United Arab Emirates,DU UAE,Transguard Group LLC,API User,E6AEAE22430
2022-02-17 01:23,72518234,"12,477.1810","12,472.2810",05.00 AED,5.00,4.9000,0.1000,564507409,1587537,Success,United Arab Emirates,DU UAE,Transguard Group LLC,API User,E6AEAE17361
2022-02-17 01:33,72518670,"12,472.2810","12,467.3810",05.00 AED,5.00,4.9000,0.1000,564508755,1587544,Success,United Arab Emirates,DU UAE,Transguard Group LLC,API User,E6AEAE17361
2022-02-17 01:38,72518883,"12,467.3810","12,447.7810",20.00 AED,20.00,19.6000,0.4000,564509349,1587547,Failure,United Arab Emirates,DU UAE,Transguard Group LLC,API User,E6AEAE12938
2022-02-17 01:38,72518883,"12,447.7810","12,428.1810",20.00 AED,20.00,19.6000,0.4000,564509349,1587547,Failure,United Arab Emirates,DU UAE,Transguard Group LLC,API User,E6AEAE12938
2022-02-17 01:43,72519121,"12,467.3810","12,462.4810",05.00 AED,5.00,4.9000,0.1000,564510021,1587552,Failure,United Arab Emirates,DU UAE,Transguard Group LLC,API User,E6AEAE17361
2022-02-17 01:43,72519121,"12,462.4810","12,457.5810",05.00 AED,5.00,4.9000,0.1000,564510021,1587552,Failure,United Arab Emirates,DU UAE,Transguard Group LLC,API User,E6AEAE17361
2022-02-17 01:58,72519851,"12,467.3810","12,457.5810",10.00 AED,10.00,9.8000,0.2000,564512040,1587557,Success,United Arab Emirates,DU UAE,Transguard Group LLC,API User,E6AEAE22430
2022-02-17 02:47,72522243,"12,457.5810","12,452.6810",05.00 AED,5.00,4.9000,0.1000,564518835,1587566,Success,United Arab Emirates,DU UAE,Transguard Group LLC,API User,E6AEAE17361
2022-02-17 02:53,72522552,"12,452.6810","12,448.5010",50.00 PHP,4.75,4.1800,0.5700,564519634,1587571,Success,Philippines,Smart (SunCellular) Philippines,Transguard Group LLC,API User,PH_SM_TopUp_50.00
2022-02-17 03:00,72522923,"12,448.5010","12,443.6010",05.00 AED,5.00,4.9000,0.1000,564520617,1587574,Success,United Arab Emirates,DU UAE,Transguard Group LLC,API User,E6AEAE17361
2022-02-17 03:10,72523442,"12,443.6010","12,428.9010",15.00 AED,15.00,14.7000,0.3000,564522063,1587577,Success,United Arab Emirates,DU UAE,Transguard Group LLC,API User,E6AEAE8527
2022-02-17 04:18,72527124,"12,428.9010","12,419.1010",10.00 AED,10.00,9.8000,0.2000,564532385,1587599,Success,United Arab Emirates,DU UAE,Transguard Group LLC,API User,E6AEAE22430
2022-02-17 04:25,72527483,"12,419.1010","12,399.5010",20.00 AED,20.00,19.6000,0.4000,564533427,1587604,Success,United Arab Emirates,DU UAE,Transguard Group LLC,API User,E6AEAE12938
2022-02-17 04:39,72528231,"12,399.5010","12,389.7010",10.00 AED,10.00,9.8000,0.2000,564535464,1587610,Success,United Arab Emirates,DU UAE,Transguard Group LLC,API User,E6AEAE22430
2022-02-17 04:39,72528255,"12,389.7010","12,384.8010",05.00 AED,5.00,4.9000,0.1000,564535517,1587612,Success,United Arab Emirates,DU UAE,Transguard Group LLC,API User,E6AEAE17361
2022-02-17 04:45,72528609,"12,384.8010","12,379.9010",05.00 AED,5.00,4.9000,0.1000,564536428,1587617,Success,United Arab Emirates,DU UAE,Transguard Group LLC,API User,E6AEAE17361
2022-02-17 04:47,72528699,"12,379.9010","12,371.9810",220.00 NPR,9.00,7.9200,1.0800,564536736,1587620,Success,Nepal,Ncell Nepal,Transguard Group LLC,API User,NCNPNP79518
2022-02-17 04:51,72528957,"12,371.9810","12,362.1810",10.00 AED,10.00,9.8000,0.2000,564537387,1587627,Success,United Arab Emirates,DU UAE,Transguard Group LLC,API User,E6AEAE22430
2022-02-17 04:55,72529187,"12,362.1810","12,357.2810",05.00 AED,5.00,4.9000,0.1000,564537914,1587635,Success,United Arab Emirates,DU UAE,Transguard Group LLC,API User,E6AEAE17361
2022-02-17 04:55,72529196,"12,357.2810","12,351.3410",100.00 INR,6.75,5.9400,0.8100,564537941,1587636,Success,India,Airtel India,Transguard Group LLC,API User,AIININ36410
2022-02-17 04:57,72529304,"12,351.3410","12,333.9610",299.00 INR,19.75,17.3800,2.3700,564538179,1587644,Success,India,Airtel India,Transguard Group LLC,API User,AIININ55294
2022-02-17 04:58,72529372,"12,333.9610","12,319.2610",15.00 AED,15.00,14.7000,0.3000,564538330,1587647,Success,United Arab Emirates,DU UAE,Transguard Group LLC,API User,E6AEAE8527
2022-02-17 05:08,72529978,"12,319.2610","12,314.3610",05.00 AED,5.00,4.9000,0.1000,564539767,1587650,Success,United Arab Emirates,DU UAE,Transguard Group LLC,API User,E6AEAE17361
2022-02-17 05:12,72530228,"12,314.3610","12,309.4610",05.00 AED,5.00,4.9000,0.1000,564540365,1587657,Success,United Arab Emirates,DU UAE,Transguard Group LLC,API User,E6AEAE17361
2022-02-17 05:17,72530486,"12,309.4610","12,305.7210",100.00 NPR,4.25,3.7400,0.5100,564540987,1587661,Failure,Nepal,Nepal Telecom Nepal,Transguard Group LLC,API User,NP_NE_TopUp_100.00
2022-02-17 05:17,72530486,"12,305.7210","12,301.9810",100.00 NPR,4.25,3.7400,0.5100,564540987,1587661,Failure,Nepal,Nepal Telecom Nepal,Transguard Group LLC,API User,NP_NE_TopUp_100.00
2022-02-17 05:22,72530788,"12,309.4610","12,304.5610",05.00 AED,5.00,4.9000,0.1000,564541694,1587666,Success,United Arab Emirates,DU UAE,Transguard Group LLC,API User,E6AEAE17361
2022-02-17 05:28,72531135,"12,304.5610","12,300.3810",150.00 PKR,4.75,4.1800,0.5700,564542530,1587676,Success,Pakistan,Ufone Pakistan,Transguard Group LLC,API User,UFPKPK90336
2022-02-17 05:29,72531170,"12,300.3810","12,290.5810",10.00 AED,10.00,9.8000,0.2000,564542601,1587679,Success,United Arab Emirates,DU UAE,Transguard Group LLC,API User,E6AEAE22430
2022-02-17 05:47,72532295,"12,290.5810","12,287.5010",50.00 INR,3.50,3.0800,0.4200,564545204,1587696,Success,India,Vi India,Transguard Group LLC,API User,VFININ24286
2022-02-17 05:50,72532485,"12,287.5010","12,282.6010",05.00 AED,5.00,4.9000,0.1000,564545611,1587701,Success,United Arab Emirates,DU UAE,Transguard Group LLC,API User,E6AEAE17361
2022-02-17 05:51,72532542,"12,282.6010","12,277.7010",05.00 AED,5.00,4.9000,0.1000,564545736,1587705,Success,United Arab Emirates,DU UAE,Transguard Group LLC,API User,E6AEAE17361
2022-02-17 05:53,72532634,"12,277.7010","12,267.9010",10.00 AED,10.00,9.8000,0.2000,564545958,1587708,Success,United Arab Emirates,DU UAE,Transguard Group LLC,API User,E6AEAE22430
2022-02-17 05:55,72532766,"12,267.9010","12,263.0010",05.00 AED,5.00,4.9000,0.1000,564546240,1587712,Success,United Arab Emirates,DU UAE,Transguard Group LLC,API User,E6AEAE17361
2022-02-17 05:58,72532941,"12,263.0010","12,253.2010",10.00 AED,10.00,9.8000,0.2000,564546641,1587716,Success,United Arab Emirates,DU UAE,Transguard Group LLC,API User,E6AEAE22430
2022-02-17 06:07,72533421,"12,253.2010","12,243.4010",10.00 AED,10.00,9.8000,0.2000,564547678,1587722,Success,United Arab Emirates,DU UAE,Transguard Group LLC,API User,E6AEAE22430
2022-02-17 06:12,72533713,"12,243.4010","12,233.6010",10.00 AED,10.00,9.8000,0.2000,564548315,1587728,Success,United Arab Emirates,DU UAE,Transguard Group LLC,API User,E6AEAE22430
2022-02-17 06:17,72534040,"12,233.6010","12,223.8010",10.00 AED,10.00,9.8000,0.2000,564548984,1587733,Success,United Arab Emirates,DU UAE,Transguard Group LLC,API User,E6AEAE22430
2022-02-17 06:25,72534531,"12,223.8010","12,218.9010",05.00 AED,5.00,4.9000,0.1000,564549997,1587738,Success,United Arab Emirates,DU UAE,Transguard Group LLC,API User,E6AEAE17361
2022-02-17 06:26,72534594,"12,218.9010","12,209.1010",10.00 AED,10.00,9.8000,0.2000,564550137,1587743,Success,United Arab Emirates,DU UAE,Transguard Group LLC,API User,E6AEAE22430
2022-02-17 06:26,72534598,"12,209.1010","12,189.5010",20.00 AED,20.00,19.6000,0.4000,564550152,1587744,Failure,United Arab Emirates,DU UAE,Transguard Group LLC,API User,E6AEAE12938
2022-02-17 06:26,72534598,"12,189.5010","12,169.9010",20.00 AED,20.00,19.6000,0.4000,564550152,1587744,Failure,United Arab Emirates,DU UAE,Transguard Group LLC,API User,E6AEAE12938
2022-02-17 06:28,72534686,"12,209.1010","12,199.3010",10.00 AED,10.00,9.8000,0.2000,564550332,1587749,Success,United Arab Emirates,DU UAE,Transguard Group LLC,API User,E6AEAE22430
2022-02-17 06:28,72534712,"12,199.3010","12,194.4010",05.00 AED,5.00,4.9000,0.1000,564550379,1587752,Success,United Arab Emirates,DU UAE,Transguard Group LLC,API User,E6AEAE17361
2022-02-17 06:29,72534730,"12,194.4010","12,184.6010",10.00 AED,10.00,9.8000,0.2000,564550419,1587754,Success,United Arab Emirates,DU UAE,Transguard Group LLC,API User,E6AEAE22430
2022-02-17 06:31,72534856,"12,184.6010","12,174.8010",10.00 AED,10.00,9.8000,0.2000,564550672,1587759,Success,United Arab Emirates,DU UAE,Transguard Group LLC,API User,E6AEAE22430
2022-02-17 06:31,72534865,"12,174.8010","12,169.9010",05.00 AED,5.00,4.9000,0.1000,564550696,1587761,Success,United Arab Emirates,DU UAE,Transguard Group LLC,API User,E6AEAE17361
2022-02-17 06:32,72534949,"12,169.9010","12,160.1010",10.00 AED,10.00,9.8000,0.2000,564550844,1587765,Success,United Arab Emirates,DU UAE,Transguard Group LLC,API User,E6AEAE22430
2022-02-17 06:37,72535252,"12,160.1010","12,150.3010",10.00 AED,10.00,9.8000,0.2000,564551534,1587770,Success,United Arab Emirates,DU UAE,Transguard Group LLC,API User,E6AEAE22430
2022-02-17 06:41,72535415,"12,150.3010","12,145.4010",05.00 AED,5.00,4.9000,0.1000,564551888,1587779,Success,United Arab Emirates,DU UAE,Transguard Group LLC,API User,E6AEAE17361
2022-02-17 06:47,72535703,"12,145.4010","12,140.5010",05.00 AED,5.00,4.9000,0.1000,564552606,1587788,Success,United Arab Emirates,DU UAE,Transguard Group LLC,API User,E6AEAE17361
2022-02-17 06:48,72535755,"12,140.5010","12,135.6010",05.00 AED,5.00,4.9000,0.1000,564552722,1587792,Success,United Arab Emirates,DU UAE,Transguard Group LLC,API User,E6AEAE17361
2022-02-17 06:54,72536089,"12,135.6010","12,125.8010",10.00 AED,10.00,9.8000,0.2000,564553467,1587802,Success,United Arab Emirates,DU UAE,Transguard Group LLC,API User,E6AEAE22430
2022-02-17 06:56,72536206,"12,125.8010","12,116.0010",10.00 AED,10.00,9.8000,0.2000,564553724,1587810,Success,United Arab Emirates,DU UAE,Transguard Group LLC,API User,E6AEAE22430
2022-02-17 06:57,72536262,"12,116.0010","12,106.2010",10.00 AED,10.00,9.8000,0.2000,564553844,1587813,Success,United Arab Emirates,DU UAE,Transguard Group LLC,API User,E6AEAE22430
2022-02-17 07:01,72536470,"12,106.2010","12,101.3010",05.00 AED,5.00,4.9000,0.1000,564554315,1587825,Success,United Arab Emirates,DU UAE,Transguard Group LLC,API User,E6AEAE17361
2022-02-17 07:05,72536638,"12,101.3010","12,081.7010",20.00 AED,20.00,19.6000,0.4000,564554728,1587838,Success,United Arab Emirates,DU UAE,Transguard Group LLC,API User,E6AEAE12938
2022-02-17 07:05,72536670,"12,081.7010","12,071.9010",10.00 AED,10.00,9.8000,0.2000,564554805,1587841,Success,United Arab Emirates,DU UAE,Transguard Group LLC,API User,E6AEAE22430
2022-02-17 07:11,72536959,"12,071.9010","12,037.6010",35.00 AED,35.00,34.3000,0.7000,564555460,1587859,Success,United Arab Emirates,DU UAE,Transguard Group LLC,API User,E6AEAE73954
2022-02-17 07:13,72537054,"12,037.6010","12,027.8010",10.00 AED,10.00,9.8000,0.2000,564555659,1587865,Success,United Arab Emirates,DU UAE,Transguard Group LLC,API User,E6AEAE22430
2022-02-17 07:13,72537087,"12,027.8010","12,022.9010",05.00 AED,5.00,4.9000,0.1000,564555730,1587869,Success,United Arab Emirates,DU UAE,Transguard Group LLC,API User,E6AEAE17361
2022-02-17 07:15,72537130,"12,022.9010","12,018.0010",05.00 AED,5.00,4.9000,0.1000,564555848,1587873,Success,United Arab Emirates,DU UAE,Transguard Group LLC,API User,E6AEAE17361
2022-02-17 07:16,72537209,"12,018.0010","12,008.2010",10.00 AED,10.00,9.8000,0.2000,564556038,1587877,Success,United Arab Emirates,DU UAE,Transguard Group LLC,API User,E6AEAE22430
2022-02-17 07:19,72537344,"12,008.2010","12,003.3010",05.00 AED,5.00,4.9000,0.1000,564556368,1587880,Success,United Arab Emirates,DU UAE,Transguard Group LLC,API User,E6AEAE17361
2022-02-17 07:21,72537436,"12,003.3010","11,998.4010",05.00 AED,5.00,4.9000,0.1000,564556599,1587884,Success,United Arab Emirates,DU UAE,Transguard Group LLC,API User,E6AEAE17361
2022-02-17 07:28,72537733,"11,998.4010","11,993.5010",05.00 AED,5.00,4.9000,0.1000,564557265,1587893,Success,United Arab Emirates,DU UAE,Transguard Group LLC,API User,E6AEAE17361
2022-02-17 07:29,72537817,"11,993.5010","11,988.6010",05.00 AED,5.00,4.9000,0.1000,564557446,1587896,Success,United Arab Emirates,DU UAE,Transguard Group LLC,API User,E6AEAE17361
2022-02-17 07:31,72537879,"11,988.6010","11,983.7010",05.00 AED,5.00,4.9000,0.1000,564557588,1587899,Success,United Arab Emirates,DU UAE,Transguard Group LLC,API User,E6AEAE17361
2022-02-17 07:37,72538179,"11,983.7010","11,973.9010",10.00 AED,10.00,9.8000,0.2000,564558242,1587915,Success,United Arab Emirates,DU UAE,Transguard Group LLC,API User,E6AEAE22430
2022-02-17 07:38,72538211,"11,973.9010","11,969.0010",05.00 AED,5.00,4.9000,0.1000,564558305,1587918,Success,United Arab Emirates,DU UAE,Transguard Group LLC,API User,E6AEAE17361
2022-02-17 07:43,72538460,"11,969.0010","11,964.1010",05.00 AED,5.00,4.9000,0.1000,564558858,1587927,Success,United Arab Emirates,DU UAE,Transguard Group LLC,API User,E6AEAE17361
2022-02-17 07:43,72538480,"11,964.1010","11,959.2010",05.00 AED,5.00,4.9000,0.1000,564558912,1587931,Success,United Arab Emirates,DU UAE,Transguard Group LLC,API User,E6AEAE17361
2022-02-17 07:44,72538496,"11,959.2010","11,949.4010",10.00 AED,10.00,9.8000,0.2000,564558962,1587936,Success,United Arab Emirates,DU UAE,Transguard Group LLC,API User,E6AEAE22430
2022-02-17 07:44,72538510,"11,949.4010","11,944.5010",05.00 AED,5.00,4.9000,0.1000,564559007,1587939,Success,United Arab Emirates,DU UAE,Transguard Group LLC,API User,E6AEAE17361
2022-02-17 07:47,72538653,"11,944.5010","11,934.7010",10.00 AED,10.00,9.8000,0.2000,564559312,1587948,Success,United Arab Emirates,DU UAE,Transguard Group LLC,API User,E6AEAE22430
2022-02-17 07:48,72538676,"11,934.7010","11,915.1010",20.00 AED,20.00,19.6000,0.4000,564559352,1587949,Success,United Arab Emirates,DU UAE,Transguard Group LLC,API User,E6AEAE12938
2022-02-17 07:48,72538706,"11,915.1010","11,910.2010",05.00 AED,5.00,4.9000,0.1000,564559420,1587952,Success,United Arab Emirates,DU UAE,Transguard Group LLC,API User,E6AEAE17361
2022-02-17 07:50,72538776,"11,910.2010","11,905.3010",05.00 AED,5.00,4.9000,0.1000,564559598,1587956,Success,United Arab Emirates,DU UAE,Transguard Group LLC,API User,E6AEAE17361
2022-02-17 07:52,72538810,"11,905.3010","11,895.5010",10.00 AED,10.00,9.8000,0.2000,564559694,1587960,Success,United Arab Emirates,DU UAE,Transguard Group LLC,API User,E6AEAE22430
2022-02-17 07:55,72538961,"11,895.5010","11,885.7010",10.00 AED,10.00,9.8000,0.2000,564560035,1587973,Success,United Arab Emirates,DU UAE,Transguard Group LLC,API User,E6AEAE22430
2022-02-17 07:56,72538974,"11,885.7010","11,880.8010",05.00 AED,5.00,4.9000,0.1000,564560073,1587976,Success,United Arab Emirates,DU UAE,Transguard Group LLC,API User,E6AEAE17361
2022-02-17 07:56,72538997,"11,880.8010","11,875.9010",05.00 AED,5.00,4.9000,0.1000,564560125,1587978,Success,United Arab Emirates,DU UAE,Transguard Group LLC,API User,E6AEAE17361
2022-02-17 08:01,72539206,"11,875.9010","11,871.0010",05.00 AED,5.00,4.9000,0.1000,564560602,1587985,Success,United Arab Emirates,DU UAE,Transguard Group LLC,API User,E6AEAE17361
2022-02-17 08:03,72539324,"11,871.0010","11,866.1010",05.00 AED,5.00,4.9000,0.1000,564560852,1587998,Success,United Arab Emirates,DU UAE,Transguard Group LLC,API User,E6AEAE17361
2022-02-17 08:04,72539336,"11,866.1010","11,861.2010",05.00 AED,5.00,4.9000,0.1000,564560880,1588001,Success,United Arab Emirates,DU UAE,Transguard Group LLC,API User,E6AEAE17361
2022-02-17 08:04,72539337,"11,861.2010","11,851.4010",10.00 AED,10.00,9.8000,0.2000,564560886,1588002,Success,United Arab Emirates,DU UAE,Transguard Group LLC,API User,E6AEAE22430
2022-02-17 08:04,72539356,"11,851.4010","11,846.5010",05.00 AED,5.00,4.9000,0.1000,564560942,1588005,Success,United Arab Emirates,DU UAE,Transguard Group LLC,API User,E6AEAE17361
2022-02-17 08:06,72539422,"11,846.5010","11,836.7010",10.00 AED,10.00,9.8000,0.2000,564561101,1588015,Success,United Arab Emirates,DU UAE,Transguard Group LLC,API User,E6AEAE22430
2022-02-17 08:06,72539424,"11,836.7010","11,831.8010",05.00 AED,5.00,4.9000,0.1000,564561114,1588016,Success,United Arab Emirates,DU UAE,Transguard Group LLC,API User,E6AEAE17361
2022-02-17 08:07,72539464,"11,831.8010","11,826.9010",05.00 AED,5.00,4.9000,0.1000,564561201,1588018,Success,United Arab Emirates,DU UAE,Transguard Group LLC,API User,E6AEAE17361
2022-02-17 08:07,72539498,"11,826.9010","11,800.7210",300.00 PHP,29.75,26.1800,3.5700,564561266,1588021,Success,Philippines,BS_Globe Philippines,Transguard Group LLC,API User,PH_GB_TopUp_300.00
2022-02-17 08:09,72539570,"11,800.7210","11,795.8210",05.00 AED,5.00,4.9000,0.1000,564561429,1588025,Success,United Arab Emirates,DU UAE,Transguard Group LLC,API User,E6AEAE17361
2022-02-17 08:10,72539584,"11,795.8210","11,786.0210",10.00 AED,10.00,9.8000,0.2000,564561456,1588029,Failure,United Arab Emirates,DU UAE,Transguard Group LLC,API User,E6AEAE22430
2022-02-17 08:10,72539584,"11,786.0210","11,776.2210",10.00 AED,10.00,9.8000,0.2000,564561456,1588029,Failure,United Arab Emirates,DU UAE,Transguard Group LLC,API User,E6AEAE22430
2022-02-17 08:14,72539786,"11,795.8210","11,790.9210",05.00 AED,5.00,4.9000,0.1000,564561895,1588043,Success,United Arab Emirates,DU UAE,Transguard Group LLC,API User,E6AEAE17361
2022-02-17 08:18,72539937,"11,790.9210","11,786.0210",05.00 AED,5.00,4.9000,0.1000,564562263,1588055,Success,United Arab Emirates,DU UAE,Transguard Group LLC,API User,E6AEAE17361
2022-02-17 08:25,72540200,"11,786.0210","11,781.1210",05.00 AED,5.00,4.9000,0.1000,564562874,1588065,Success,United Arab Emirates,DU UAE,Transguard Group LLC,API User,E6AEAE17361
2022-02-17 08:29,72540361,"11,781.1210","11,776.2210",05.00 AED,5.00,4.9000,0.1000,564563262,1588080,Success,United Arab Emirates,DU UAE,Transguard Group LLC,API User,E6AEAE17361
2022-02-17 08:29,72540364,"11,776.2210","11,766.4210",10.00 AED,10.00,9.8000,0.2000,564563263,1588081,Success,United Arab Emirates,DU UAE,Transguard Group LLC,API User,E6AEAE22430
2022-02-17 08:29,72540367,"11,766.4210","11,761.5210",05.00 AED,5.00,4.9000,0.1000,564563271,1588082,Success,United Arab Emirates,DU UAE,Transguard Group LLC,API User,E6AEAE17361
2022-02-17 08:30,72540399,"11,761.5210","11,751.7210",10.00 AED,10.00,9.8000,0.2000,564563357,1588085,Success,United Arab Emirates,DU UAE,Transguard Group LLC,API User,E6AEAE22430
2022-02-17 08:32,72540486,"11,751.7210","11,741.9210",10.00 AED,10.00,9.8000,0.2000,564563552,1588089,Success,United Arab Emirates,DU UAE,Transguard Group LLC,API User,E6AEAE22430
2022-02-17 08:33,72540523,"11,741.9210","11,737.0210",05.00 AED,5.00,4.9000,0.1000,564563637,1588094,Success,United Arab Emirates,DU UAE,Transguard Group LLC,API User,E6AEAE17361
2022-02-17 08:39,72540758,"11,737.0210","11,732.1210",05.00 AED,5.00,4.9000,0.1000,564564173,1588110,Success,United Arab Emirates,DU UAE,Transguard Group LLC,API User,E6AEAE17361
2022-02-17 08:41,72540820,"11,732.1210","11,727.2210",05.00 AED,5.00,4.9000,0.1000,564564329,1588116,Success,United Arab Emirates,DU UAE,Transguard Group LLC,API User,E6AEAE17361
2022-02-17 08:41,72540837,"11,727.2210","11,722.3210",05.00 AED,5.00,4.9000,0.1000,564564361,1588120,Success,United Arab Emirates,DU UAE,Transguard Group LLC,API User,E6AEAE17361
2022-02-17 08:43,72540910,"11,722.3210","11,712.5210",10.00 AED,10.00,9.8000,0.2000,564564553,1588126,Success,United Arab Emirates,DU UAE,Transguard Group LLC,API User,E6AEAE22430
2022-02-17 08:47,72541044,"11,712.5210","11,707.6210",05.00 AED,5.00,4.9000,0.1000,564564919,1588139,Success,United Arab Emirates,DU UAE,Transguard Group LLC,API User,E6AEAE17361
2022-02-17 08:48,72541063,"11,707.6210","11,703.4410",150.00 PKR,4.75,4.1800,0.5700,564564963,1588142,Success,Pakistan,Ufone Pakistan,Transguard Group LLC,API User,UFPKPK90336
2022-02-17 08:49,72541112,"11,703.4410","11,698.5410",05.00 AED,5.00,4.9000,0.1000,564565094,1588148,Success,United Arab Emirates,DU UAE,Transguard Group LLC,API User,E6AEAE17361
2022-02-17 08:50,72541126,"11,698.5410","11,693.6410",05.00 AED,5.00,4.9000,0.1000,564565124,1588152,Success,United Arab Emirates,DU UAE,Transguard Group LLC,API User,E6AEAE17361
2022-02-17 08:51,72541235,"11,693.6410","11,683.8410",10.00 AED,10.00,9.8000,0.2000,564565320,1588161,Success,United Arab Emirates,DU UAE,Transguard Group LLC,API User,E6AEAE22430
2022-02-17 08:52,72541244,"11,683.8410","11,678.9410",05.00 AED,5.00,4.9000,0.1000,564565359,1588165,Success,United Arab Emirates,DU UAE,Transguard Group LLC,API User,E6AEAE17361
2022-02-17 08:53,72541270,"11,678.9410","11,674.0410",05.00 AED,5.00,4.9000,0.1000,564565436,1588169,Success,United Arab Emirates,DU UAE,Transguard Group LLC,API User,E6AEAE17361
2022-02-17 08:55,72541335,"11,674.0410","11,669.1410",05.00 AED,5.00,4.9000,0.1000,564565608,1588176,Success,United Arab Emirates,DU UAE,Transguard Group LLC,API User,E6AEAE17361
2022-02-17 08:56,72541372,"11,669.1410","11,664.2410",05.00 AED,5.00,4.9000,0.1000,564565691,1588179,Success,United Arab Emirates,DU UAE,Transguard Group LLC,API User,E6AEAE17361
2022-02-17 09:02,72541602,"11,664.2410","11,659.3410",05.00 AED,5.00,4.9000,0.1000,564566277,1588185,Success,United Arab Emirates,DU UAE,Transguard Group LLC,API User,E6AEAE17361
2022-02-17 09:04,72541656,"11,659.3410","11,649.5410",10.00 AED,10.00,9.8000,0.2000,564566393,1588194,Success,United Arab Emirates,DU UAE,Transguard Group LLC,API User,E6AEAE22430
2022-02-17 09:04,72541661,"11,649.5410","11,644.6410",05.00 AED,5.00,4.9000,0.1000,564566400,1588195,Success,United Arab Emirates,DU UAE,Transguard Group LLC,API User,E6AEAE17361
2022-02-17 09:04,72541677,"11,644.6410","11,639.7410",05.00 AED,5.00,4.9000,0.1000,564566439,1588198,Success,United Arab Emirates,DU UAE,Transguard Group LLC,API User,E6AEAE17361
2022-02-17 09:07,72541783,"11,639.7410","11,634.8410",05.00 AED,5.00,4.9000,0.1000,564566695,1588208,Success,United Arab Emirates,DU UAE,Transguard Group LLC,API User,E6AEAE17361
2022-02-17 09:08,72541824,"11,634.8410","11,625.0410",10.00 AED,10.00,9.8000,0.2000,564566791,1588213,Success,United Arab Emirates,DU UAE,Transguard Group LLC,API User,E6AEAE22430
2022-02-17 09:16,72542091,"11,625.0410","11,620.1410",05.00 AED,5.00,4.9000,0.1000,564567443,1588228,Success,United Arab Emirates,DU UAE,Transguard Group LLC,API User,E6AEAE17361
2022-02-17 09:17,72542121,"11,620.1410","11,615.2410",05.00 AED,5.00,4.9000,0.1000,564567503,1588231,Success,United Arab Emirates,DU UAE,Transguard Group LLC,API User,E6AEAE17361
2022-02-17 09:26,72542421,"11,615.2410","11,600.5410",15.00 AED,15.00,14.7000,0.3000,564568264,1588251,Success,United Arab Emirates,DU UAE,Transguard Group LLC,API User,E6AEAE8527
2022-02-17 09:27,72542479,"11,600.5410","11,590.7410",10.00 AED,10.00,9.8000,0.2000,564568390,1588257,Success,United Arab Emirates,DU UAE,Transguard Group LLC,API User,E6AEAE22430
2022-02-17 09:30,72542582,"11,590.7410","11,585.8410",05.00 AED,5.00,4.9000,0.1000,564568637,1588263,Success,United Arab Emirates,DU UAE,Transguard Group LLC,API User,E6AEAE17361
2022-02-17 09:34,72542692,"11,585.8410","11,580.9410",05.00 AED,5.00,4.9000,0.1000,564568921,1588267,Success,United Arab Emirates,DU UAE,Transguard Group LLC,API User,E6AEAE17361
2022-02-17 09:38,72542849,"11,580.9410","11,576.0410",05.00 AED,5.00,4.9000,0.1000,564569270,1588278,Success,United Arab Emirates,DU UAE,Transguard Group LLC,API User,E6AEAE17361
2022-02-17 09:38,72542874,"11,576.0410","11,566.2410",10.00 AED,10.00,9.8000,0.2000,564569327,1588281,Success,United Arab Emirates,DU UAE,Transguard Group LLC,API User,E6AEAE22430
2022-02-17 09:39,72542910,"11,566.2410","11,561.3410",05.00 AED,5.00,4.9000,0.1000,564569405,1588284,Success,United Arab Emirates,DU UAE,Transguard Group LLC,API User,E6AEAE17361
2022-02-17 09:45,72543154,"11,561.3410","11,556.4410",05.00 AED,5.00,4.9000,0.1000,564569950,1588295,Success,United Arab Emirates,DU UAE,Transguard Group LLC,API User,E6AEAE17361
2022-02-17 09:47,72543207,"11,556.4410","11,551.5410",05.00 AED,5.00,4.9000,0.1000,564570075,1588301,Success,United Arab Emirates,DU UAE,Transguard Group LLC,API User,E6AEAE17361
2022-02-17 09:50,72543342,"11,551.5410","11,546.6410",05.00 AED,5.00,4.9000,0.1000,564570429,1588310,Success,United Arab Emirates,DU UAE,Transguard Group LLC,API User,E6AEAE17361
2022-02-17 09:55,72543486,"11,546.6410","11,541.7410",05.00 AED,5.00,4.9000,0.1000,564570786,1588317,Success,United Arab Emirates,DU UAE,Transguard Group LLC,API User,E6AEAE17361
2022-02-17 09:57,72543575,"11,541.7410","11,536.8410",05.00 AED,5.00,4.9000,0.1000,564571030,1588324,Success,United Arab Emirates,DU UAE,Transguard Group LLC,API User,E6AEAE17361
2022-02-17 09:58,72543594,"11,536.8410","11,517.2410",20.00 AED,20.00,19.6000,0.4000,564571080,1588327,Success,United Arab Emirates,DU UAE,Transguard Group LLC,API User,E6AEAE12938
2022-02-17 09:58,72543612,"11,517.2410","11,512.3410",05.00 AED,5.00,4.9000,0.1000,564571124,1588330,Success,United Arab Emirates,DU UAE,Transguard Group LLC,API User,E6AEAE17361
2022-02-17 09:59,72543641,"11,512.3410","11,502.5410",10.00 AED,10.00,9.8000,0.2000,564571196,1588333,Success,United Arab Emirates,DU UAE,Transguard Group LLC,API User,E6AEAE22430
2022-02-17 10:02,72543745,"11,502.5410","11,497.6410",05.00 AED,5.00,4.9000,0.1000,564571451,1588338,Success,United Arab Emirates,DU UAE,Transguard Group LLC,API User,E6AEAE17361
2022-02-17 10:04,72543784,"11,497.6410","11,491.7010",100.00 INR,6.75,5.9400,0.8100,564571564,1588343,Success,India,Airtel India,Transguard Group LLC,API User,AIININ36410
2022-02-17 10:04,72543809,"11,491.7010","11,481.9010",10.00 AED,10.00,9.8000,0.2000,564571627,1588348,Success,United Arab Emirates,DU UAE,Transguard Group LLC,API User,E6AEAE22430
2022-02-17 10:05,72543838,"11,481.9010","11,472.1010",10.00 AED,10.00,9.8000,0.2000,564571695,1588353,Success,United Arab Emirates,DU UAE,Transguard Group LLC,API User,E6AEAE22430
2022-02-17 10:06,72543859,"11,472.1010","11,462.3010",10.00 AED,10.00,9.8000,0.2000,564571740,1588357,Success,United Arab Emirates,DU UAE,Transguard Group LLC,API User,E6AEAE22430
2022-02-17 10:10,72544008,"11,462.3010","11,452.5010",10.00 AED,10.00,9.8000,0.2000,564572086,1588368,Success,United Arab Emirates,DU UAE,Transguard Group LLC,API User,E6AEAE22430
2022-02-17 10:10,72544022,"11,452.5010","11,442.7010",10.00 AED,10.00,9.8000,0.2000,564572119,1588371,Success,United Arab Emirates,DU UAE,Transguard Group LLC,API User,E6AEAE22430
2022-02-17 10:17,72544262,"11,442.7010","11,437.8010",05.00 AED,5.00,4.9000,0.1000,564572715,1588387,Success,United Arab Emirates,DU UAE,Transguard Group LLC,API User,E6AEAE17361
2022-02-17 10:22,72544471,"11,437.8010","11,428.0010",10.00 AED,10.00,9.8000,0.2000,564573197,1588391,Success,United Arab Emirates,DU UAE,Transguard Group LLC,API User,E6AEAE22430
2022-02-17 10:26,72544645,"11,428.0010","11,418.2010",10.00 AED,10.00,9.8000,0.2000,564573592,1588397,Success,United Arab Emirates,DU UAE,Transguard Group LLC,API User,E6AEAE22430
2022-02-17 10:27,72544653,"11,418.2010","11,408.4010",10.00 AED,10.00,9.8000,0.2000,564573604,1588399,Success,United Arab Emirates,DU UAE,Transguard Group LLC,API User,E6AEAE22430
2022-02-17 10:28,72544693,"11,408.4010","11,403.5010",05.00 AED,5.00,4.9000,0.1000,564573716,1588406,Success,United Arab Emirates,DU UAE,Transguard Group LLC,API User,E6AEAE17361
2022-02-17 10:28,72544694,"11,403.5010","11,364.3010",40.00 AED,40.00,39.2000,0.8000,564573721,1588407,Success,United Arab Emirates,DU UAE,Transguard Group LLC,API User,E6AEAE64011
2022-02-17 10:29,72544721,"11,364.3010","11,354.5010",10.00 AED,10.00,9.8000,0.2000,564573802,1588410,Success,United Arab Emirates,DU UAE,Transguard Group LLC,API User,E6AEAE22430
2022-02-17 10:30,72544760,"11,354.5010","11,349.6010",05.00 AED,5.00,4.9000,0.1000,564573924,1588416,Success,United Arab Emirates,DU UAE,Transguard Group LLC,API User,E6AEAE17361
2022-02-17 10:31,72544790,"11,349.6010","11,344.7010",05.00 AED,5.00,4.9000,0.1000,564573995,1588420,Success,United Arab Emirates,DU UAE,Transguard Group LLC,API User,E6AEAE17361
2022-02-17 10:34,72544891,"11,344.7010","11,339.8010",05.00 AED,5.00,4.9000,0.1000,564574242,1588432,Success,United Arab Emirates,DU UAE,Transguard Group LLC,API User,E6AEAE17361
2022-02-17 10:35,72544925,"11,339.8010","11,334.9010",05.00 AED,5.00,4.9000,0.1000,564574328,1588437,Success,United Arab Emirates,DU UAE,Transguard Group LLC,API User,E6AEAE17361
2022-02-17 10:35,72544941,"11,334.9010","11,330.0010",05.00 AED,5.00,4.9000,0.1000,564574380,1588441,Success,United Arab Emirates,DU UAE,Transguard Group LLC,API User,E6AEAE17361
2022-02-17 10:36,72544956,"11,330.0010","11,320.2010",10.00 AED,10.00,9.8000,0.2000,564574416,1588443,Success,United Arab Emirates,DU UAE,Transguard Group LLC,API User,E6AEAE22430
2022-02-17 10:38,72545033,"11,320.2010","11,315.3010",05.00 AED,5.00,4.9000,0.1000,564574617,1588455,Success,United Arab Emirates,DU UAE,Transguard Group LLC,API User,E6AEAE17361
2022-02-17 10:38,72545040,"11,315.3010","11,310.4010",05.00 AED,5.00,4.9000,0.1000,564574640,1588456,Success,United Arab Emirates,DU UAE,Transguard Group LLC,API User,E6AEAE17361
2022-02-17 10:40,72545102,"11,310.4010","11,300.6010",10.00 AED,10.00,9.8000,0.2000,564574788,1588467,Success,United Arab Emirates,DU UAE,Transguard Group LLC,API User,E6AEAE22430
2022-02-17 10:41,72545128,"11,300.6010","11,295.7010",05.00 AED,5.00,4.9000,0.1000,564574852,1588470,Success,United Arab Emirates,DU UAE,Transguard Group LLC,API User,E6AEAE17361
2022-02-17 10:45,72545263,"11,295.7010","11,285.9010",10.00 AED,10.00,9.8000,0.2000,564575191,1588478,Success,United Arab Emirates,DU UAE,Transguard Group LLC,API User,E6AEAE22430
2022-02-17 10:45,72545290,"11,285.9010","11,281.0010",05.00 AED,5.00,4.9000,0.1000,564575258,1588482,Success,United Arab Emirates,DU UAE,Transguard Group LLC,API User,E6AEAE17361
2022-02-17 10:48,72545367,"11,281.0010","11,276.6010","3,667.00 UGX",5.00,4.4000,0.6000,564575474,1588486,Success,Uganda,Airtel Uganda,Transguard Group LLC,API User,UG_WA_TopUp
2022-02-17 10:49,72545424,"38,749.7210","38,710.5210",40.00 AED,40.00,39.2000,0.8000,564575594,1588493,Success,United Arab Emirates,DU UAE,Transguard Group LLC,API User,E6AEAE64011
2022-02-17 10:51,72545473,"38,710.5210","38,700.7210",10.00 AED,10.00,9.8000,0.2000,564575713,1588496,Success,United Arab Emirates,DU UAE,Transguard Group LLC,API User,E6AEAE22430
2022-02-17 10:52,72545521,"38,700.7210","38,690.9210",10.00 AED,10.00,9.8000,0.2000,564575835,1588500,Success,United Arab Emirates,DU UAE,Transguard Group LLC,API User,E6AEAE22430
2022-02-17 10:53,72545563,"38,690.9210","38,686.0210",05.00 AED,5.00,4.9000,0.1000,564575946,1588503,Success,United Arab Emirates,DU UAE,Transguard Group LLC,API User,E6AEAE17361
2022-02-17 10:56,72545663,"38,686.0210","38,676.2210",10.00 AED,10.00,9.8000,0.2000,564576180,1588508,Success,United Arab Emirates,DU UAE,Transguard Group LLC,API User,E6AEAE22430
2022-02-17 10:57,72545695,"38,676.2210","38,671.3210",05.00 AED,5.00,4.9000,0.1000,564576262,1588513,Success,United Arab Emirates,DU UAE,Transguard Group LLC,API User,E6AEAE17361
2022-02-17 10:57,72545706,"38,671.3210","38,666.4210",05.00 AED,5.00,4.9000,0.1000,564576296,1588516,Success,United Arab Emirates,DU UAE,Transguard Group LLC,API User,E6AEAE17361
2022-02-17 10:59,72545759,"38,666.4210","38,656.6210",10.00 AED,10.00,9.8000,0.2000,564576453,72545759,Success,United Arab Emirates,DU UAE,Transguard Group LLC,mohammed.arafath@transguardgroup.com,E6AEAE22430
2022-02-17 11:00,72545813,"38,656.6210","38,651.7210",05.00 AED,5.00,4.9000,0.1000,564576591,1588525,Success,United Arab Emirates,DU UAE,Transguard Group LLC,API User,E6AEAE17361
2022-02-17 11:01,72545844,"38,651.7210","38,641.9210",10.00 AED,10.00,9.8000,0.2000,564576674,1588529,Success,United Arab Emirates,DU UAE,Transguard Group LLC,API User,E6AEAE22430
2022-02-17 11:02,72545857,"38,641.9210","38,637.0210",05.00 AED,5.00,4.9000,0.1000,564576701,1588531,Success,United Arab Emirates,DU UAE,Transguard Group LLC,API User,E6AEAE17361
2022-02-17 11:02,72545874,"38,637.0210","38,617.4210",20.00 AED,20.00,19.6000,0.4000,564576738,1588534,Success,United Arab Emirates,DU UAE,Transguard Group LLC,API User,E6AEAE12938
2022-02-17 11:09,72546086,"38,617.4210","38,612.5210",05.00 AED,5.00,4.9000,0.1000,564577303,1588547,Success,United Arab Emirates,DU UAE,Transguard Group LLC,API User,E6AEAE17361
2022-02-17 11:14,72546262,"38,612.5210","38,607.6210",05.00 AED,5.00,4.9000,0.1000,564577768,1588555,Success,United Arab Emirates,DU UAE,Transguard Group LLC,API User,E6AEAE17361
2022-02-17 11:31,72546876,"38,607.6210","38,602.7210",05.00 AED,5.00,4.9000,0.1000,564579337,1588577,Success,United Arab Emirates,DU UAE,Transguard Group LLC,API User,E6AEAE17361
2022-02-17 11:37,72547093,"38,602.7210","38,597.8210",05.00 AED,5.00,4.9000,0.1000,564579892,1588591,Success,United Arab Emirates,DU UAE,Transguard Group LLC,API User,E6AEAE17361
2022-02-17 11:38,72547123,"38,597.8210","38,592.9210",05.00 AED,5.00,4.9000,0.1000,564579963,1588598,Success,United Arab Emirates,DU UAE,Transguard Group LLC,API User,E6AEAE17361
2022-02-17 11:39,72547159,"38,592.9210","38,583.1210",10.00 AED,10.00,9.8000,0.2000,564580048,1588606,Success,United Arab Emirates,DU UAE,Transguard Group LLC,API User,E6AEAE22430
2022-02-17 11:41,72547258,"38,583.1210","38,578.2210",05.00 AED,5.00,4.9000,0.1000,564580297,1588615,Success,United Arab Emirates,DU UAE,Transguard Group LLC,API User,E6AEAE17361
2022-02-17 11:43,72547298,"38,578.2210","38,548.8210",30.00 AED,30.00,29.4000,0.6000,564580395,1588623,Success,United Arab Emirates,DU UAE,Transguard Group LLC,API User,E6AEAE46146
2022-02-17 11:43,72547310,"38,548.8210","38,543.9210",05.00 AED,5.00,4.9000,0.1000,564580433,1588627,Success,United Arab Emirates,DU UAE,Transguard Group LLC,API User,E6AEAE17361
2022-02-17 11:46,72547423,"38,543.9210","38,539.0210",05.00 AED,5.00,4.9000,0.1000,564580714,1588632,Success,United Arab Emirates,DU UAE,Transguard Group LLC,API User,E6AEAE17361
2022-02-17 11:47,72547443,"38,539.0210","38,534.1210",05.00 AED,5.00,4.9000,0.1000,564580758,1588635,Success,United Arab Emirates,DU UAE,Transguard Group LLC,API User,E6AEAE17361
2022-02-17 11:53,72547658,"38,534.1210","38,529.2210",05.00 AED,5.00,4.9000,0.1000,564581261,1588650,Success,United Arab Emirates,DU UAE,Transguard Group LLC,API User,E6AEAE17361
2022-02-17 11:53,72547682,"38,529.2210","38,519.4210",10.00 AED,10.00,9.8000,0.2000,564581328,1588652,Success,United Arab Emirates,DU UAE,Transguard Group LLC,API User,E6AEAE22430
2022-02-17 11:54,72547723,"38,519.4210","38,514.5210",05.00 AED,5.00,4.9000,0.1000,564581407,1588657,Success,United Arab Emirates,DU UAE,Transguard Group LLC,API User,E6AEAE17361
2022-02-17 11:55,72547748,"38,514.5210","38,509.6210",05.00 AED,5.00,4.9000,0.1000,564581472,1588661,Success,United Arab Emirates,DU UAE,Transguard Group LLC,API User,E6AEAE17361
2022-02-17 11:56,72547777,"38,509.6210","38,504.7210",05.00 AED,5.00,4.9000,0.1000,564581542,1588667,Success,United Arab Emirates,DU UAE,Transguard Group LLC,API User,E6AEAE17361
2022-02-17 11:58,72547865,"38,504.7210","38,494.9210",10.00 AED,10.00,9.8000,0.2000,564581749,1588674,Success,United Arab Emirates,DU UAE,Transguard Group LLC,API User,E6AEAE22430
2022-02-17 11:58,72547871,"38,494.9210","38,475.3210",20.00 AED,20.00,19.6000,0.4000,564581759,1588675,Success,United Arab Emirates,DU UAE,Transguard Group LLC,API User,E6AEAE12938
2022-02-17 12:00,72547915,"38,475.3210","38,465.5210",10.00 AED,10.00,9.8000,0.2000,564581870,1588681,Success,United Arab Emirates,DU UAE,Transguard Group LLC,API User,E6AEAE22430
2022-02-17 12:02,72548008,"38,465.5210","38,431.2210",35.00 AED,35.00,34.3000,0.7000,564582119,1588690,Success,United Arab Emirates,DU UAE,Transguard Group LLC,API User,E6AEAE73954
2022-02-17 12:03,72548019,"38,431.2210","38,426.3210",05.00 AED,5.00,4.9000,0.1000,564582145,1588693,Success,United Arab Emirates,DU UAE,Transguard Group LLC,API User,E6AEAE17361
2022-02-17 12:04,72548062,"38,426.3210","38,421.9210",06.60 GHS,5.00,4.4000,0.6000,564582263,1588700,Success,Ghana,MTN Ghana,Transguard Group LLC,API User,GH_MT_TopUp
2022-02-17 12:04,72548070,"38,421.9210","38,412.1210",10.00 AED,10.00,9.8000,0.2000,564582277,1588702,Success,United Arab Emirates,DU UAE,Transguard Group LLC,API User,E6AEAE22430
2022-02-17 12:06,72548150,"38,412.1210","38,402.3210",10.00 AED,10.00,9.8000,0.2000,564582489,1588709,Success,United Arab Emirates,DU UAE,Transguard Group LLC,API User,E6AEAE22430
2022-02-17 12:07,72548196,"38,402.3210","38,392.5210",10.00 AED,10.00,9.8000,0.2000,564582570,1588715,Success,United Arab Emirates,DU UAE,Transguard Group LLC,API User,E6AEAE22430
2022-02-17 12:08,72548216,"38,392.5210","38,387.6210",05.00 AED,5.00,4.9000,0.1000,564582608,1588717,Success,United Arab Emirates,DU UAE,Transguard Group LLC,API User,E6AEAE17361
2022-02-17 12:08,72548224,"38,387.6210","38,368.0210",20.00 AED,20.00,19.6000,0.4000,564582624,1588718,Success,United Arab Emirates,DU UAE,Transguard Group LLC,API User,E6AEAE12938
2022-02-17 12:11,72548323,"38,368.0210","38,363.1210",05.00 AED,5.00,4.9000,0.1000,564582885,1588735,Success,United Arab Emirates,DU UAE,Transguard Group LLC,API User,E6AEAE17361
2022-02-17 12:13,72548392,"38,363.1210","38,353.3210",10.00 AED,10.00,9.8000,0.2000,564583061,1588747,Success,United Arab Emirates,DU UAE,Transguard Group LLC,API User,E6AEAE22430
2022-02-17 12:14,72548414,"38,353.3210","38,348.4210",05.00 AED,5.00,4.9000,0.1000,564583117,1588751,Success,United Arab Emirates,DU UAE,Transguard Group LLC,API User,E6AEAE17361
2022-02-17 12:15,72548443,"38,348.4210","38,338.6210",10.00 AED,10.00,9.8000,0.2000,564583205,1588756,Success,United Arab Emirates,DU UAE,Transguard Group LLC,API User,E6AEAE22430
2022-02-17 12:17,72548513,"38,338.6210","38,332.6810",99.00 INR,6.75,5.9400,0.8100,564583394,1588766,Success,India,Airtel India,Transguard Group LLC,API User,AIININ6418
2022-02-17 12:19,72548580,"38,332.6810","38,322.8810",10.00 AED,10.00,9.8000,0.2000,564583564,1588773,Success,United Arab Emirates,DU UAE,Transguard Group LLC,API User,E6AEAE22430
2022-02-17 12:19,72548595,"38,322.8810","38,317.9810",05.00 AED,5.00,4.9000,0.1000,564583602,1588777,Success,United Arab Emirates,DU UAE,Transguard Group LLC,API User,E6AEAE17361
2022-02-17 12:20,72548624,"38,317.9810","38,308.1810",10.00 AED,10.00,9.8000,0.2000,564583704,1588781,Success,United Arab Emirates,DU UAE,Transguard Group LLC,API User,E6AEAE22430
2022-02-17 12:28,72548900,"38,308.1810","38,303.2810",05.00 AED,5.00,4.9000,0.1000,564584400,1588796,Success,United Arab Emirates,DU UAE,Transguard Group LLC,API User,E6AEAE17361
2022-02-17 12:39,72549292,"38,303.2810","38,293.4810",10.00 AED,10.00,9.8000,0.2000,564585500,1588816,Success,United Arab Emirates,DU UAE,Transguard Group LLC,API User,E6AEAE22430
2022-02-17 12:50,72549701,"38,293.4810","38,283.6810",10.00 AED,10.00,9.8000,0.2000,564586612,1588832,Success,United Arab Emirates,DU UAE,Transguard Group LLC,API User,E6AEAE22430
2022-02-17 12:52,72549762,"38,283.6810","38,278.7810",05.00 AED,5.00,4.9000,0.1000,564586785,1588839,Success,United Arab Emirates,DU UAE,Transguard Group LLC,API User,E6AEAE17361
2022-02-17 12:56,72549900,"38,278.7810","38,268.9810",10.00 AED,10.00,9.8000,0.2000,564587129,1588843,Success,United Arab Emirates,DU UAE,Transguard Group LLC,API User,E6AEAE22430
2022-02-17 12:58,72549967,"38,268.9810","38,259.1810",10.00 AED,10.00,9.8000,0.2000,564587279,1588849,Success,United Arab Emirates,DU UAE,Transguard Group LLC,API User,E6AEAE22430
2022-02-17 12:58,72549995,"38,259.1810","38,254.2810",05.00 AED,5.00,4.9000,0.1000,564587348,1588852,Success,United Arab Emirates,DU UAE,Transguard Group LLC,API User,E6AEAE17361
2022-02-17 12:59,72550008,"38,254.2810","38,244.4810",10.00 AED,10.00,9.8000,0.2000,564587381,1588855,Success,United Arab Emirates,DU UAE,Transguard Group LLC,API User,E6AEAE22430
2022-02-17 12:59,72550024,"38,244.4810","38,239.5810",05.00 AED,5.00,4.9000,0.1000,564587423,1588858,Success,United Arab Emirates,DU UAE,Transguard Group LLC,API User,E6AEAE17361
2022-02-17 13:00,72550052,"38,239.5810","38,234.6810",05.00 AED,5.00,4.9000,0.1000,564587509,1588863,Success,United Arab Emirates,DU UAE,Transguard Group LLC,API User,E6AEAE17361
2022-02-17 13:01,72550079,"38,234.6810","38,229.7810",05.00 AED,5.00,4.9000,0.1000,564587584,1588866,Success,United Arab Emirates,DU UAE,Transguard Group LLC,API User,E6AEAE17361
2022-02-17 13:01,72550101,"38,229.7810","38,224.8810",05.00 AED,5.00,4.9000,0.1000,564587633,1588871,Success,United Arab Emirates,DU UAE,Transguard Group LLC,API User,E6AEAE17361
2022-02-17 13:01,72550107,"38,224.8810","38,219.9810",05.00 AED,5.00,4.9000,0.1000,564587652,1588873,Success,United Arab Emirates,DU UAE,Transguard Group LLC,API User,E6AEAE17361
2022-02-17 13:03,72550149,"38,219.9810","38,210.1810",10.00 AED,10.00,9.8000,0.2000,564587789,1588877,Success,United Arab Emirates,DU UAE,Transguard Group LLC,API User,E6AEAE22430
2022-02-17 13:05,72550216,"38,210.1810","38,205.2810",05.00 AED,5.00,4.9000,0.1000,564587991,1588882,Success,United Arab Emirates,DU UAE,Transguard Group LLC,API User,E6AEAE17361
2022-02-17 13:06,72550261,"38,205.2810","38,200.3810",05.00 AED,5.00,4.9000,0.1000,564588097,1588887,Success,United Arab Emirates,DU UAE,Transguard Group LLC,API User,E6AEAE17361
2022-02-17 13:09,72550365,"38,200.3810","38,180.7810",20.00 AED,20.00,19.6000,0.4000,564588401,1588893,Success,United Arab Emirates,DU UAE,Transguard Group LLC,API User,E6AEAE12938
2022-02-17 13:25,72550978,"38,180.7810","38,175.8810",05.00 AED,5.00,4.9000,0.1000,564589990,1588911,Success,United Arab Emirates,DU UAE,Transguard Group LLC,API User,E6AEAE17361
2022-02-17 13:31,72551210,"38,175.8810","38,170.9810",05.00 AED,5.00,4.9000,0.1000,564590569,1588919,Success,United Arab Emirates,DU UAE,Transguard Group LLC,API User,E6AEAE17361
2022-02-17 13:33,72551276,"38,170.9810","38,161.1810",10.00 AED,10.00,9.8000,0.2000,564590759,1588924,Success,United Arab Emirates,DU UAE,Transguard Group LLC,API User,E6AEAE22430
2022-02-17 13:34,72551307,"38,161.1810","38,151.3810",10.00 AED,10.00,9.8000,0.2000,564590838,1588928,Failure,United Arab Emirates,DU UAE,Transguard Group LLC,API User,E6AEAE22430
2022-02-17 13:34,72551307,"38,151.3810","38,141.5810",10.00 AED,10.00,9.8000,0.2000,564590838,1588928,Failure,United Arab Emirates,DU UAE,Transguard Group LLC,API User,E6AEAE22430
2022-02-17 13:41,72551582,"38,161.1810","38,141.5810",20.00 AED,20.00,19.6000,0.4000,564591561,1588934,Success,United Arab Emirates,DU UAE,Transguard Group LLC,API User,E6AEAE12938
2022-02-17 13:41,72551602,"38,141.5810","38,137.1810","12,726.00 SLL",5.00,4.4000,0.6000,564591636,1588937,Success,Sierra Leone,Africell Sierra Leone,Transguard Group LLC,API User,SL_AF_TopUp
2022-02-17 13:45,72551739,"38,137.1810","38,133.0010",150.00 PKR,4.75,4.1800,0.5700,564592055,1588941,Success,Pakistan,Jazz Pakistan,Transguard Group LLC,API User,MBPKPK20699
2022-02-17 13:47,72551791,"38,133.0010","38,116.9410",575.00 PKR,18.25,16.0600,2.1900,564592198,1588945,Success,Pakistan,Jazz Pakistan,Transguard Group LLC,API User,MBPKPK68304
2022-02-17 13:57,72552175,"38,116.9410","38,107.1410",10.00 AED,10.00,9.8000,0.2000,564593169,1588960,Success,United Arab Emirates,DU UAE,Transguard Group LLC,API User,E6AEAE22430
2022-02-17 13:58,72552210,"38,107.1410","38,102.2410",05.00 AED,5.00,4.9000,0.1000,564593275,1588963,Success,United Arab Emirates,DU UAE,Transguard Group LLC,API User,E6AEAE17361
2022-02-17 14:02,72552325,"38,102.2410","38,092.4410",10.00 AED,10.00,9.8000,0.2000,564593582,1588970,Success,United Arab Emirates,DU UAE,Transguard Group LLC,API User,E6AEAE22430
2022-02-17 14:02,72552341,"38,092.4410","38,087.5410",05.00 AED,5.00,4.9000,0.1000,564593639,1588973,Success,United Arab Emirates,DU UAE,Transguard Group LLC,API User,E6AEAE17361
2022-02-17 14:09,72552616,"38,087.5410","38,067.9410",20.00 AED,20.00,19.6000,0.4000,564594351,1588981,Success,United Arab Emirates,DU UAE,Transguard Group LLC,API User,E6AEAE12938
2022-02-17 14:10,72552646,"38,067.9410","38,048.3410",20.00 AED,20.00,19.6000,0.4000,564594427,1588986,Success,United Arab Emirates,DU UAE,Transguard Group LLC,API User,E6AEAE12938
2022-02-17 14:11,72552682,"38,048.3410","38,009.1410",40.00 AED,40.00,39.2000,0.8000,564594529,1588989,Success,United Arab Emirates,DU UAE,Transguard Group LLC,API User,E6AEAE64011
2022-02-17 14:11,72552725,"38,009.1410","37,999.3410",10.00 AED,10.00,9.8000,0.2000,564594608,1588992,Success,United Arab Emirates,DU UAE,Transguard Group LLC,API User,E6AEAE22430
2022-02-17 14:12,72552780,"37,999.3410","37,989.5410",10.00 AED,10.00,9.8000,0.2000,564594750,1588999,Success,United Arab Emirates,DU UAE,Transguard Group LLC,API User,E6AEAE22430
2022-02-17 14:12,72552786,"37,989.5410","37,984.6410",05.00 AED,5.00,4.9000,0.1000,564594755,1589000,Success,United Arab Emirates,DU UAE,Transguard Group LLC,API User,E6AEAE17361
2022-02-17 14:18,72553058,"37,984.6410","37,979.7410",05.00 AED,5.00,4.9000,0.1000,564595428,1589005,Success,United Arab Emirates,DU UAE,Transguard Group LLC,API User,E6AEAE17361
2022-02-17 14:22,72553225,"37,979.7410","37,974.8410",05.00 AED,5.00,4.9000,0.1000,564595831,1589008,Success,United Arab Emirates,DU UAE,Transguard Group LLC,API User,E6AEAE17361
2022-02-17 14:27,72553472,"37,974.8410","37,965.0410",10.00 AED,10.00,9.8000,0.2000,564596415,1589019,Success,United Arab Emirates,DU UAE,Transguard Group LLC,API User,E6AEAE22430
2022-02-17 14:41,72554056,"37,965.0410","37,960.6410",01.09 USD,5.00,4.4000,0.6000,564597980,1589028,Success,Afghanistan,MTN Afghanistan,Transguard Group LLC,API User,AF_MT_TopUp
2022-02-17 14:47,72554264,"37,960.6410","37,956.4610",150.00 PKR,4.75,4.1800,0.5700,564598573,1589038,Success,Pakistan,Zong Pakistan,Transguard Group LLC,API User,ZNPKPK65621
2022-02-17 14:48,72554315,"37,956.4610","37,946.6610",10.00 AED,10.00,9.8000,0.2000,564598720,1589042,Success,United Arab Emirates,DU UAE,Transguard Group LLC,API User,E6AEAE22430
2022-02-17 14:50,72554371,"37,946.6610","37,941.7610",05.00 AED,5.00,4.9000,0.1000,564598918,1589050,Success,United Arab Emirates,DU UAE,Transguard Group LLC,API User,E6AEAE17361
2022-02-17 14:52,72554486,"37,941.7610","37,936.8610",05.00 AED,5.00,4.9000,0.1000,564599209,1589056,Success,United Arab Emirates,DU UAE,Transguard Group LLC,API User,E6AEAE17361
2022-02-17 14:53,72554502,"37,936.8610","37,931.9610",05.00 AED,5.00,4.9000,0.1000,564599254,1589059,Success,United Arab Emirates,DU UAE,Transguard Group LLC,API User,E6AEAE17361
2022-02-17 14:56,72554648,"37,931.9610","37,922.1610",10.00 AED,10.00,9.8000,0.2000,564599662,1589068,Success,United Arab Emirates,DU UAE,Transguard Group LLC,API User,E6AEAE22430
2022-02-17 15:03,72554914,"37,922.1610","37,914.2410",220.00 NPR,9.00,7.9200,1.0800,564600387,1589075,Success,Nepal,Ncell Nepal,Transguard Group LLC,API User,NCNPNP79518
2022-02-17 15:09,72555131,"37,914.2410","37,909.3410",05.00 AED,5.00,4.9000,0.1000,564601059,1589079,Success,United Arab Emirates,DU UAE,Transguard Group LLC,API User,E6AEAE17361
2022-02-17 15:17,72555442,"37,909.3410","37,899.5410",10.00 AED,10.00,9.8000,0.2000,564601938,1589082,Success,United Arab Emirates,DU UAE,Transguard Group LLC,API User,E6AEAE22430
2022-02-17 15:19,72555535,"37,899.5410","37,889.7410",10.00 AED,10.00,9.8000,0.2000,564602230,1589088,Success,United Arab Emirates,DU UAE,Transguard Group LLC,API User,E6AEAE22430
2022-02-17 15:47,72556628,"37,889.7410","37,881.3810",300.00 PKR,9.50,8.3600,1.1400,564605566,1589104,Success,Pakistan,Jazz Pakistan,Transguard Group LLC,API User,PK_MB_TopUp_300.00
2022-02-17 15:48,72556681,"37,881.3810","37,876.4810",05.00 AED,5.00,4.9000,0.1000,564605711,1589112,Success,United Arab Emirates,DU UAE,Transguard Group LLC,API User,E6AEAE17361
2022-02-17 15:50,72556790,"37,876.4810","37,866.6810",10.00 AED,10.00,9.8000,0.2000,564606001,1589121,Success,United Arab Emirates,DU UAE,Transguard Group LLC,API User,E6AEAE22430
2022-02-17 15:52,72556871,"37,866.6810","37,861.7810",05.00 AED,5.00,4.9000,0.1000,564606232,1589126,Success,United Arab Emirates,DU UAE,Transguard Group LLC,API User,E6AEAE17361
2022-02-17 15:55,72557000,"37,861.7810","37,857.6010",150.00 PKR,4.75,4.1800,0.5700,564606626,1589129,Success,Pakistan,Zong Pakistan,Transguard Group LLC,API User,ZNPKPK65621
2022-02-17 16:00,72557190,"37,857.6010","37,847.8010",10.00 AED,10.00,9.8000,0.2000,564607218,1589133,Success,United Arab Emirates,DU UAE,Transguard Group LLC,API User,E6AEAE22430
2022-02-17 16:01,72557258,"37,847.8010","37,842.9010",05.00 AED,5.00,4.9000,0.1000,564607437,1589137,Success,United Arab Emirates,DU UAE,Transguard Group LLC,API User,E6AEAE17361
2022-02-17 16:09,72557610,"37,842.9010","37,833.1010",10.00 AED,10.00,9.8000,0.2000,564608447,1589145,Success,United Arab Emirates,DU UAE,Transguard Group LLC,API User,E6AEAE22430
2022-02-17 16:21,72558229,"37,833.1010","37,813.5010",20.00 AED,20.00,19.6000,0.4000,564610185,72558229,Success,United Arab Emirates,DU UAE,Transguard Group LLC,mohammed.arafath@transguardgroup.com,E6AEAE12938
2022-02-17 16:22,72558273,"37,813.5010","37,808.6010",05.00 AED,5.00,4.9000,0.1000,564610316,1589163,Success,United Arab Emirates,DU UAE,Transguard Group LLC,API User,E6AEAE17361
2022-02-17 16:22,72558272,"37,808.6010","37,803.7010",05.00 AED,5.00,4.9000,0.1000,564610328,72558272,Success,United Arab Emirates,DU UAE,Transguard Group LLC,mohammed.arafath@transguardgroup.com,E6AEAE17361
2022-02-17 16:22,72558311,"37,803.7010","37,793.9010",10.00 AED,10.00,9.8000,0.2000,564610413,1589166,Success,United Arab Emirates,DU UAE,Transguard Group LLC,API User,E6AEAE22430
2022-02-17 16:24,72558385,"37,793.9010","37,784.1010",10.00 AED,10.00,9.8000,0.2000,564610620,72558385,Success,United Arab Emirates,DU UAE,Transguard Group LLC,mohammed.arafath@transguardgroup.com,E6AEAE22430
2022-02-17 16:35,72558941,"37,784.1010","37,779.2010",05.00 AED,5.00,4.9000,0.1000,564612166,1589176,Success,United Arab Emirates,DU UAE,Transguard Group LLC,API User,E6AEAE17361
2022-02-17 16:35,72558973,"37,779.2010","37,774.3010",05.00 AED,5.00,4.9000,0.1000,564612235,1589178,Success,United Arab Emirates,DU UAE,Transguard Group LLC,API User,E6AEAE17361
2022-02-17 16:36,72559038,"37,774.3010","37,769.4010",05.00 AED,5.00,4.9000,0.1000,564612399,1589181,Success,United Arab Emirates,DU UAE,Transguard Group LLC,API User,E6AEAE17361
2022-02-17 16:37,72559081,"37,769.4010","37,759.6010",10.00 AED,10.00,9.8000,0.2000,564612558,1589184,Success,United Arab Emirates,DU UAE,Transguard Group LLC,API User,E6AEAE22430
2022-02-17 16:38,72559165,"37,759.6010","37,740.0010",20.00 AED,20.00,19.6000,0.4000,564612754,1589188,Success,United Arab Emirates,DU UAE,Transguard Group LLC,API User,E6AEAE12938
2022-02-17 16:44,72559490,"37,740.0010","37,735.1010",05.00 AED,5.00,4.9000,0.1000,564613669,1589198,Success,United Arab Emirates,DU UAE,Transguard Group LLC,API User,E6AEAE17361
2022-02-17 16:48,72559673,"37,735.1010","37,730.2010",05.00 AED,5.00,4.9000,0.1000,564614167,1589205,Success,United Arab Emirates,DU UAE,Transguard Group LLC,API User,E6AEAE17361
2022-02-17 16:48,72559688,"37,730.2010","37,725.3010",05.00 AED,5.00,4.9000,0.1000,564614220,1589208,Success,United Arab Emirates,DU UAE,Transguard Group LLC,API User,E6AEAE17361
2022-02-17 16:49,72559732,"37,725.3010","37,720.4010",05.00 AED,5.00,4.9000,0.1000,564614329,1589214,Success,United Arab Emirates,DU UAE,Transguard Group LLC,API User,E6AEAE17361
2022-02-17 16:51,72559865,"37,720.4010","37,710.6010",10.00 AED,10.00,9.8000,0.2000,564614700,1589220,Success,United Arab Emirates,DU UAE,Transguard Group LLC,API User,E6AEAE22430
2022-02-17 16:53,72559971,"37,710.6010","37,706.4210",150.00 PKR,4.75,4.1800,0.5700,564614983,1589224,Success,Pakistan,Jazz Pakistan,Transguard Group LLC,API User,MBPKPK20699
2022-02-17 16:54,72560011,"37,706.4210","37,696.6210",10.00 AED,10.00,9.8000,0.2000,564615103,1589227,Success,United Arab Emirates,DU UAE,Transguard Group LLC,API User,E6AEAE22430
2022-02-17 16:55,72560129,"37,696.6210","37,686.8210",10.00 AED,10.00,9.8000,0.2000,564615371,1589232,Success,United Arab Emirates,DU UAE,Transguard Group LLC,API User,E6AEAE22430
2022-02-17 16:56,72560136,"37,686.8210","37,681.9210",05.00 AED,5.00,4.9000,0.1000,564615379,1589233,Success,United Arab Emirates,DU UAE,Transguard Group LLC,API User,E6AEAE17361
2022-02-17 16:56,72560166,"37,681.9210","37,677.0210",05.00 AED,5.00,4.9000,0.1000,564615485,1589236,Success,United Arab Emirates,DU UAE,Transguard Group LLC,API User,E6AEAE17361
2022-02-17 16:58,72560278,"37,677.0210","37,667.2210",10.00 AED,10.00,9.8000,0.2000,564615768,1589240,Success,United Arab Emirates,DU UAE,Transguard Group LLC,API User,E6AEAE22430
2022-02-17 17:00,72560410,"37,667.2210","37,662.3210",05.00 AED,5.00,4.9000,0.1000,564616081,1589246,Success,United Arab Emirates,DU UAE,Transguard Group LLC,API User,E6AEAE17361
2022-02-17 17:02,72560551,"37,662.3210","37,657.4210",05.00 AED,5.00,4.9000,0.1000,564616456,1589254,Success,United Arab Emirates,DU UAE,Transguard Group LLC,API User,E6AEAE17361
2022-02-17 17:07,72560902,"37,657.4210","37,652.5210",05.00 AED,5.00,4.9000,0.1000,564617341,1589273,Success,United Arab Emirates,DU UAE,Transguard Group LLC,API User,E6AEAE17361
2022-02-17 17:08,72560964,"37,652.5210","37,647.6210",05.00 AED,5.00,4.9000,0.1000,564617487,1589277,Success,United Arab Emirates,DU UAE,Transguard Group LLC,API User,E6AEAE17361
2022-02-17 17:10,72561111,"37,647.6210","37,642.7210",05.00 AED,5.00,4.9000,0.1000,564617878,1589285,Success,United Arab Emirates,DU UAE,Transguard Group LLC,API User,E6AEAE17361
2022-02-17 17:13,72561276,"37,642.7210","37,632.9210",10.00 AED,10.00,9.8000,0.2000,564618303,1589292,Success,United Arab Emirates,DU UAE,Transguard Group LLC,API User,E6AEAE22430
2022-02-17 17:20,72561758,"37,632.9210","37,628.0210",05.00 AED,5.00,4.9000,0.1000,564619604,1589302,Success,United Arab Emirates,DU UAE,Transguard Group LLC,API User,E6AEAE17361
2022-02-17 17:21,72561807,"37,628.0210","37,623.1210",05.00 AED,5.00,4.9000,0.1000,564619723,1589305,Success,United Arab Emirates,DU UAE,Transguard Group LLC,API User,E6AEAE17361
2022-02-17 17:23,72561934,"37,623.1210","37,593.7210",30.00 AED,30.00,29.4000,0.6000,564620062,1589312,Success,United Arab Emirates,DU UAE,Transguard Group LLC,API User,E6AEAE46146
2022-02-17 17:23,72561935,"37,593.7210","37,588.8210",05.00 AED,5.00,4.9000,0.1000,564620072,1589313,Success,United Arab Emirates,DU UAE,Transguard Group LLC,API User,E6AEAE17361
2022-02-17 17:24,72561973,"37,588.8210","37,582.8810",100.00 INR,6.75,5.9400,0.8100,564620195,1589317,Success,India,Airtel India,Transguard Group LLC,API User,AIININ36410
2022-02-17 17:24,72562023,"37,582.8810","37,573.0810",10.00 AED,10.00,9.8000,0.2000,564620290,1589321,Success,United Arab Emirates,DU UAE,Transguard Group LLC,API User,E6AEAE22430
2022-02-17 17:28,72562264,"37,573.0810","37,563.2810",10.00 AED,10.00,9.8000,0.2000,564620950,1589325,Success,United Arab Emirates,DU UAE,Transguard Group LLC,API User,E6AEAE22430
2022-02-17 17:29,72562306,"37,563.2810","37,558.3810",05.00 AED,5.00,4.9000,0.1000,564621061,1589331,Success,United Arab Emirates,DU UAE,Transguard Group LLC,API User,E6AEAE17361
2022-02-17 17:30,72562430,"37,558.3810","37,553.4810",05.00 AED,5.00,4.9000,0.1000,564621399,1589335,Success,United Arab Emirates,DU UAE,Transguard Group LLC,API User,E6AEAE17361
2022-02-17 17:35,72562705,"37,553.4810","37,548.5810",05.00 AED,5.00,4.9000,0.1000,564622166,1589345,Success,United Arab Emirates,DU UAE,Transguard Group LLC,API User,E6AEAE17361
2022-02-17 17:38,72562953,"37,548.5810","37,538.7810",10.00 AED,10.00,9.8000,0.2000,564622781,1589352,Success,United Arab Emirates,DU UAE,Transguard Group LLC,API User,E6AEAE22430
2022-02-17 17:38,72562969,"37,538.7810","37,533.8810",05.00 AED,5.00,4.9000,0.1000,564622834,1589355,Success,United Arab Emirates,DU UAE,Transguard Group LLC,API User,E6AEAE17361
2022-02-17 17:41,72563206,"37,533.8810","37,524.0810",10.00 AED,10.00,9.8000,0.2000,564623446,1589364,Success,United Arab Emirates,DU UAE,Transguard Group LLC,API User,E6AEAE22430
2022-02-17 17:43,72563295,"37,524.0810","37,519.1810",05.00 AED,5.00,4.9000,0.1000,564623694,1589372,Success,United Arab Emirates,DU UAE,Transguard Group LLC,API User,E6AEAE17361
2022-02-17 17:44,72563365,"37,519.1810","37,509.3810",10.00 AED,10.00,9.8000,0.2000,564623858,1589376,Success,United Arab Emirates,DU UAE,Transguard Group LLC,API User,E6AEAE22430
2022-02-17 17:50,72563779,"37,509.3810","37,504.4810",05.00 AED,5.00,4.9000,0.1000,564624893,1589381,Success,United Arab Emirates,DU UAE,Transguard Group LLC,API User,E6AEAE17361
2022-02-17 17:50,72563830,"37,504.4810","37,494.6810",10.00 AED,10.00,9.8000,0.2000,564625026,1589384,Success,United Arab Emirates,DU UAE,Transguard Group LLC,API User,E6AEAE22430
2022-02-17 17:52,72563990,"37,494.6810","37,481.7010",219.00 INR,14.75,12.9800,1.7700,564625450,1589389,Success,India,Vi India,Transguard Group LLC,API User,VFININ40021
2022-02-17 17:54,72564119,"37,481.7010","37,476.8010",05.00 AED,5.00,4.9000,0.1000,564625791,1589392,Success,United Arab Emirates,DU UAE,Transguard Group LLC,API User,E6AEAE17361
2022-02-17 17:57,72564293,"37,476.8010","37,467.0010",10.00 AED,10.00,9.8000,0.2000,564626268,1589398,Success,United Arab Emirates,DU UAE,Transguard Group LLC,API User,E6AEAE22430
2022-02-17 17:58,72564357,"37,467.0010","37,462.1010",05.00 AED,5.00,4.9000,0.1000,564626418,1589401,Success,United Arab Emirates,DU UAE,Transguard Group LLC,API User,E6AEAE17361
2022-02-17 18:05,72564942,"37,462.1010","37,457.2010",05.00 AED,5.00,4.9000,0.1000,564627955,1589425,Success,United Arab Emirates,DU UAE,Transguard Group LLC,API User,E6AEAE17361
2022-02-17 18:08,72565168,"37,457.2010","37,452.3010",05.00 AED,5.00,4.9000,0.1000,564628534,1589430,Success,United Arab Emirates,DU UAE,Transguard Group LLC,API User,E6AEAE17361
2022-02-17 18:10,72565319,"37,452.3010","37,447.4010",05.00 AED,5.00,4.9000,0.1000,564628953,1589437,Success,United Arab Emirates,DU UAE,Transguard Group LLC,API User,E6AEAE17361
2022-02-17 18:12,72565483,"37,447.4010","37,437.6010",10.00 AED,10.00,9.8000,0.2000,564629342,1589442,Success,United Arab Emirates,DU UAE,Transguard Group LLC,API User,E6AEAE22430
2022-02-17 18:14,72565602,"37,437.6010","37,432.7010",05.00 AED,5.00,4.9000,0.1000,564629628,1589446,Success,United Arab Emirates,DU UAE,Transguard Group LLC,API User,E6AEAE17361
2022-02-17 18:20,72566092,"37,432.7010","37,427.8010",05.00 AED,5.00,4.9000,0.1000,564630981,1589451,Success,United Arab Emirates,DU UAE,Transguard Group LLC,API User,E6AEAE17361
2022-02-17 18:25,72566412,"37,427.8010","37,422.9010",05.00 AED,5.00,4.9000,0.1000,564631799,1589454,Success,United Arab Emirates,DU UAE,Transguard Group LLC,API User,E6AEAE17361
2022-02-17 18:26,72566499,"37,422.9010","37,378.8010",45.00 AED,45.00,44.1000,0.9000,564632040,1589458,Success,United Arab Emirates,DU UAE,Transguard Group LLC,API User,E6AEAE35243
2022-02-17 18:26,72566561,"37,378.8010","37,369.0010",10.00 AED,10.00,9.8000,0.2000,564632201,1589461,Success,United Arab Emirates,DU UAE,Transguard Group LLC,API User,E6AEAE22430
2022-02-17 18:28,72566687,"37,369.0010","37,361.7410",200.00 NPR,8.25,7.2600,0.9900,564632527,1589465,Success,Nepal,Nepal Telecom Nepal,Transguard Group LLC,API User,NP_NE_TopUp_200.00
2022-02-17 18:29,72566749,"37,361.7410","37,356.8410",05.00 AED,5.00,4.9000,0.1000,564632678,1589477,Success,United Arab Emirates,DU UAE,Transguard Group LLC,API User,E6AEAE17361
2022-02-17 18:34,72567161,"37,356.8410","37,327.4410",30.00 AED,30.00,29.4000,0.6000,564633709,1589487,Success,United Arab Emirates,DU UAE,Transguard Group LLC,API User,E6AEAE46146
2022-02-17 18:34,72567165,"37,327.4410","37,322.5410",05.00 AED,5.00,4.9000,0.1000,564633717,1589488,Success,United Arab Emirates,DU UAE,Transguard Group LLC,API User,E6AEAE17361
2022-02-17 18:35,72567230,"37,322.5410","37,317.6410",05.00 AED,5.00,4.9000,0.1000,564633909,1589495,Success,United Arab Emirates,DU UAE,Transguard Group LLC,API User,E6AEAE17361
2022-02-17 18:35,72567266,"37,317.6410","37,312.7410",05.00 AED,5.00,4.9000,0.1000,564633986,1589499,Success,United Arab Emirates,DU UAE,Transguard Group LLC,API User,E6AEAE17361
2022-02-17 18:35,72567280,"37,312.7410","37,302.9410",10.00 AED,10.00,9.8000,0.2000,564634025,1589502,Success,United Arab Emirates,DU UAE,Transguard Group LLC,API User,E6AEAE22430
2022-02-17 18:36,72567348,"37,302.9410","37,293.1410",10.00 AED,10.00,9.8000,0.2000,564634208,1589505,Success,United Arab Emirates,DU UAE,Transguard Group LLC,API User,E6AEAE22430
2022-02-17 18:37,72567451,"37,293.1410","37,288.2410",05.00 AED,5.00,4.9000,0.1000,564634459,1589511,Success,United Arab Emirates,DU UAE,Transguard Group LLC,API User,E6AEAE17361
2022-02-17 18:38,72567508,"37,288.2410","37,283.3410",05.00 AED,5.00,4.9000,0.1000,564634610,1589516,Success,United Arab Emirates,DU UAE,Transguard Group LLC,API User,E6AEAE17361
2022-02-17 18:40,72567692,"37,283.3410","37,278.4410",05.00 AED,5.00,4.9000,0.1000,564635120,1589525,Success,United Arab Emirates,DU UAE,Transguard Group LLC,API User,E6AEAE17361
2022-02-17 18:42,72567868,"37,278.4410","37,273.5410",05.00 AED,5.00,4.9000,0.1000,564635582,1589533,Success,United Arab Emirates,DU UAE,Transguard Group LLC,API User,E6AEAE17361
2022-02-17 18:44,72568042,"37,273.5410","37,268.6410",05.00 AED,5.00,4.9000,0.1000,564636014,1589537,Success,United Arab Emirates,DU UAE,Transguard Group LLC,API User,E6AEAE17361
2022-02-17 18:47,72568267,"37,268.6410","37,258.8410",10.00 AED,10.00,9.8000,0.2000,564636578,1589541,Success,United Arab Emirates,DU UAE,Transguard Group LLC,API User,E6AEAE22430
2022-02-17 18:47,72568304,"37,258.8410","37,249.0410",10.00 AED,10.00,9.8000,0.2000,564636658,1589544,Success,United Arab Emirates,DU UAE,Transguard Group LLC,API User,E6AEAE22430
2022-02-17 18:48,72568393,"37,249.0410","37,244.1410",05.00 AED,5.00,4.9000,0.1000,564636872,1589546,Success,United Arab Emirates,DU UAE,Transguard Group LLC,API User,E6AEAE17361
2022-02-17 18:49,72568494,"37,244.1410","37,234.3410",10.00 AED,10.00,9.8000,0.2000,564637144,1589549,Success,United Arab Emirates,DU UAE,Transguard Group LLC,API User,E6AEAE22430
2022-02-17 18:50,72568600,"37,234.3410","37,229.4410",05.00 AED,5.00,4.9000,0.1000,564637393,1589552,Success,United Arab Emirates,DU UAE,Transguard Group LLC,API User,E6AEAE17361
2022-02-17 18:52,72568726,"37,229.4410","37,219.6410",10.00 AED,10.00,9.8000,0.2000,564637686,1589557,Success,United Arab Emirates,DU UAE,Transguard Group LLC,API User,E6AEAE22430
2022-02-17 18:53,72568826,"37,219.6410","37,209.8410",10.00 AED,10.00,9.8000,0.2000,564637957,1589561,Success,United Arab Emirates,DU UAE,Transguard Group LLC,API User,E6AEAE22430
2022-02-17 18:54,72568923,"37,209.8410","37,204.9410",05.00 AED,5.00,4.9000,0.1000,564638200,1589566,Success,United Arab Emirates,DU UAE,Transguard Group LLC,API User,E6AEAE17361
2022-02-17 18:55,72569021,"37,204.9410","37,200.0410",05.00 AED,5.00,4.9000,0.1000,564638423,1589573,Success,United Arab Emirates,DU UAE,Transguard Group LLC,API User,E6AEAE17361
2022-02-17 18:56,72569116,"37,200.0410","37,195.1410",05.00 AED,5.00,4.9000,0.1000,564638630,1589579,Success,United Arab Emirates,DU UAE,Transguard Group LLC,API User,E6AEAE17361
2022-02-17 18:56,72569152,"37,195.1410","37,187.2210",220.00 NPR,9.00,7.9200,1.0800,564638723,1589581,Success,Nepal,Ncell Nepal,Transguard Group LLC,API User,NCNPNP79518
2022-02-17 18:56,72569204,"37,187.2210","37,182.3210",05.00 AED,5.00,4.9000,0.1000,564638796,1589585,Success,United Arab Emirates,DU UAE,Transguard Group LLC,API User,E6AEAE17361
2022-02-17 18:57,72569229,"37,182.3210","37,177.4210",05.00 AED,5.00,4.9000,0.1000,564638835,1589587,Success,United Arab Emirates,DU UAE,Transguard Group LLC,API User,E6AEAE17361
2022-02-17 18:57,72569261,"37,177.4210","37,172.5210",05.00 AED,5.00,4.9000,0.1000,564638920,1589589,Success,United Arab Emirates,DU UAE,Transguard Group LLC,API User,E6AEAE17361
2022-02-17 18:57,72569318,"37,172.5210","37,167.6210",05.00 AED,5.00,4.9000,0.1000,564639040,1589595,Success,United Arab Emirates,DU UAE,Transguard Group LLC,API User,E6AEAE17361
2022-02-17 18:58,72569342,"37,167.6210","37,162.7210",05.00 AED,5.00,4.9000,0.1000,564639092,1589600,Success,United Arab Emirates,DU UAE,Transguard Group LLC,API User,E6AEAE17361
2022-02-17 18:58,72569364,"37,162.7210","37,157.8210",05.00 AED,5.00,4.9000,0.1000,564639139,1589603,Success,United Arab Emirates,DU UAE,Transguard Group LLC,API User,E6AEAE17361
2022-02-17 18:58,72569389,"37,157.8210","37,128.4210",30.00 AED,30.00,29.4000,0.6000,564639184,1589606,Success,United Arab Emirates,DU UAE,Transguard Group LLC,API User,E6AEAE46146
2022-02-17 18:58,72569412,"37,128.4210","37,123.5210",05.00 AED,5.00,4.9000,0.1000,564639238,1589607,Success,United Arab Emirates,DU UAE,Transguard Group LLC,API User,E6AEAE17361
2022-02-17 19:00,72569603,"37,123.5210","37,113.7210",10.00 AED,10.00,9.8000,0.2000,564639691,1589614,Success,United Arab Emirates,DU UAE,Transguard Group LLC,API User,E6AEAE22430
2022-02-17 19:01,72569680,"37,113.7210","37,108.8210",05.00 AED,5.00,4.9000,0.1000,564639839,1589618,Success,United Arab Emirates,DU UAE,Transguard Group LLC,API User,E6AEAE17361
2022-02-17 19:02,72569879,"37,108.8210","37,103.9210",05.00 AED,5.00,4.9000,0.1000,564640263,1589628,Success,United Arab Emirates,DU UAE,Transguard Group LLC,API User,E6AEAE17361
2022-02-17 19:03,72569979,"37,103.9210","37,099.0210",05.00 AED,5.00,4.9000,0.1000,564640491,1589632,Success,United Arab Emirates,DU UAE,Transguard Group LLC,API User,E6AEAE17361
2022-02-17 19:04,72570091,"37,099.0210","37,094.1210",05.00 AED,5.00,4.9000,0.1000,564640722,1589635,Success,United Arab Emirates,DU UAE,Transguard Group LLC,API User,E6AEAE17361
2022-02-17 19:07,72570489,"37,094.1210","37,089.2210",05.00 AED,5.00,4.9000,0.1000,564641571,1589652,Success,United Arab Emirates,DU UAE,Transguard Group LLC,API User,E6AEAE17361
2022-02-17 19:15,72571403,"37,089.2210","37,079.4210",10.00 AED,10.00,9.8000,0.2000,564643589,1589674,Success,United Arab Emirates,DU UAE,Transguard Group LLC,API User,E6AEAE22430
2022-02-17 19:20,72572003,"37,079.4210","37,074.5210",05.00 AED,5.00,4.9000,0.1000,564644833,1589682,Success,United Arab Emirates,DU UAE,Transguard Group LLC,API User,E6AEAE17361
2022-02-17 19:20,72572052,"37,074.5210","37,054.9210",20.00 AED,20.00,19.6000,0.4000,564644966,1589688,Success,United Arab Emirates,DU UAE,Transguard Group LLC,API User,E6AEAE12938
2022-02-17 19:21,72572146,"37,054.9210","37,035.3210",20.00 AED,20.00,19.6000,0.4000,564645186,1589692,Success,United Arab Emirates,DU UAE,Transguard Group LLC,API User,E6AEAE12938
2022-02-17 19:23,72572300,"37,035.3210","37,025.5210",10.00 AED,10.00,9.8000,0.2000,564645544,1589700,Success,United Arab Emirates,DU UAE,Transguard Group LLC,API User,E6AEAE22430
2022-02-17 19:23,72572314,"37,025.5210","37,005.9210",20.00 AED,20.00,19.6000,0.4000,564645581,1589701,Success,United Arab Emirates,DU UAE,Transguard Group LLC,API User,E6AEAE12938
2022-02-17 19:23,72572384,"37,005.9210","37,001.0210",05.00 AED,5.00,4.9000,0.1000,564645751,1589706,Success,United Arab Emirates,DU UAE,Transguard Group LLC,API User,E6AEAE17361
2022-02-17 19:24,72572479,"37,001.0210","36,996.1210",05.00 AED,5.00,4.9000,0.1000,564645950,1589712,Success,United Arab Emirates,DU UAE,Transguard Group LLC,API User,E6AEAE17361
2022-02-17 19:25,72572552,"36,996.1210","36,991.2210",05.00 AED,5.00,4.9000,0.1000,564646115,1589718,Success,United Arab Emirates,DU UAE,Transguard Group LLC,API User,E6AEAE17361
2022-02-17 19:27,72572753,"36,991.2210","36,986.3210",05.00 AED,5.00,4.9000,0.1000,564646551,1589730,Success,United Arab Emirates,DU UAE,Transguard Group LLC,API User,E6AEAE17361
2022-02-17 19:30,72573069,"36,986.3210","36,976.5210",10.00 AED,10.00,9.8000,0.2000,564647319,1589744,Success,United Arab Emirates,DU UAE,Transguard Group LLC,API User,E6AEAE22430
2022-02-17 19:30,72573106,"36,976.5210","36,966.7210",10.00 AED,10.00,9.8000,0.2000,564647412,1589749,Success,United Arab Emirates,DU UAE,Transguard Group LLC,API User,E6AEAE22430
2022-02-17 19:32,72573271,"36,966.7210","36,956.9210",10.00 AED,10.00,9.8000,0.2000,564647820,1589760,Success,United Arab Emirates,DU UAE,Transguard Group LLC,API User,E6AEAE22430
2022-02-17 19:32,72573295,"36,956.9210","36,947.1210",10.00 AED,10.00,9.8000,0.2000,564647855,1589762,Success,United Arab Emirates,DU UAE,Transguard Group LLC,API User,E6AEAE22430
2022-02-17 19:33,72573382,"36,947.1210","36,937.3210",10.00 AED,10.00,9.8000,0.2000,564648045,1589769,Success,United Arab Emirates,DU UAE,Transguard Group LLC,API User,E6AEAE22430
2022-02-17 19:33,72573394,"36,937.3210","36,927.5210",10.00 AED,10.00,9.8000,0.2000,564648077,1589771,Success,United Arab Emirates,DU UAE,Transguard Group LLC,API User,E6AEAE22430
2022-02-17 19:34,72573489,"36,927.5210","36,922.6210",05.00 AED,5.00,4.9000,0.1000,564648288,1589777,Success,United Arab Emirates,DU UAE,Transguard Group LLC,API User,E6AEAE17361
2022-02-17 19:34,72573499,"36,922.6210","36,917.7210",05.00 AED,5.00,4.9000,0.1000,564648314,1589779,Success,United Arab Emirates,DU UAE,Transguard Group LLC,API User,E6AEAE17361
2022-02-17 19:37,72573737,"36,917.7210","36,907.9210",10.00 AED,10.00,9.8000,0.2000,564648974,1589789,Success,United Arab Emirates,DU UAE,Transguard Group LLC,API User,E6AEAE22430
2022-02-17 19:38,72573820,"36,907.9210","36,903.0210",05.00 AED,5.00,4.9000,0.1000,564649181,1589796,Success,United Arab Emirates,DU UAE,Transguard Group LLC,API User,E6AEAE17361
2022-02-17 19:44,72574411,"36,903.0210","36,893.2210",10.00 AED,10.00,9.8000,0.2000,564650710,1589813,Success,United Arab Emirates,DU UAE,Transguard Group LLC,API User,E6AEAE22430
2022-02-17 19:45,72574452,"36,893.2210","36,883.4210",10.00 AED,10.00,9.8000,0.2000,564650822,1589817,Success,United Arab Emirates,DU UAE,Transguard Group LLC,API User,E6AEAE22430
2022-02-17 19:46,72574597,"36,883.4210","36,873.6210",10.00 AED,10.00,9.8000,0.2000,564651195,1589823,Success,United Arab Emirates,DU UAE,Transguard Group LLC,API User,E6AEAE22430
2022-02-17 19:48,72574751,"36,873.6210","36,868.7210",05.00 AED,5.00,4.9000,0.1000,564651587,1589833,Success,United Arab Emirates,DU UAE,Transguard Group LLC,API User,E6AEAE17361
2022-02-17 19:48,72574781,"36,868.7210","36,863.8210",05.00 AED,5.00,4.9000,0.1000,564651663,1589836,Failure,United Arab Emirates,DU UAE,Transguard Group LLC,API User,E6AEAE17361
2022-02-17 19:48,72574781,"36,863.8210","36,858.9210",05.00 AED,5.00,4.9000,0.1000,564651663,1589836,Failure,United Arab Emirates,DU UAE,Transguard Group LLC,API User,E6AEAE17361
2022-02-17 19:49,72574804,"36,868.7210","36,858.9210",10.00 AED,10.00,9.8000,0.2000,564651702,1589838,Success,United Arab Emirates,DU UAE,Transguard Group LLC,API User,E6AEAE22430
2022-02-17 19:51,72575017,"36,858.9210","36,854.0210",05.00 AED,5.00,4.9000,0.1000,564652272,1589847,Success,United Arab Emirates,DU UAE,Transguard Group LLC,API User,E6AEAE17361
2022-02-17 19:51,72575022,"36,854.0210","36,834.4210",20.00 AED,20.00,19.6000,0.4000,564652289,1589848,Success,United Arab Emirates,DU UAE,Transguard Group LLC,API User,E6AEAE12938
2022-02-17 19:54,72575268,"36,834.4210","36,829.5210",05.00 AED,5.00,4.9000,0.1000,564652943,1589867,Success,United Arab Emirates,DU UAE,Transguard Group LLC,API User,E6AEAE17361
2022-02-17 19:54,72575276,"36,829.5210","36,824.6210",05.00 AED,5.00,4.9000,0.1000,564652957,1589868,Success,United Arab Emirates,DU UAE,Transguard Group LLC,API User,E6AEAE17361
2022-02-17 19:54,72575318,"36,824.6210","36,819.7210",05.00 AED,5.00,4.9000,0.1000,564653057,1589870,Success,United Arab Emirates,DU UAE,Transguard Group LLC,API User,E6AEAE17361
2022-02-17 19:55,72575371,"36,819.7210","36,814.8210",05.00 AED,5.00,4.9000,0.1000,564653218,1589876,Success,United Arab Emirates,DU UAE,Transguard Group LLC,API User,E6AEAE17361
2022-02-17 19:56,72575433,"36,814.8210","36,809.9210",05.00 AED,5.00,4.9000,0.1000,564653419,1589879,Success,United Arab Emirates,DU UAE,Transguard Group LLC,API User,E6AEAE17361
2022-02-17 19:56,72575454,"36,809.9210","36,800.1210",10.00 AED,10.00,9.8000,0.2000,564653463,1589882,Success,United Arab Emirates,DU UAE,Transguard Group LLC,API User,E6AEAE22430
2022-02-17 19:57,72575507,"36,800.1210","36,790.3210",10.00 AED,10.00,9.8000,0.2000,564653616,1589888,Success,United Arab Emirates,DU UAE,Transguard Group LLC,API User,E6AEAE22430
2022-02-17 20:04,72576155,"36,790.3210","36,785.4210",05.00 AED,5.00,4.9000,0.1000,564655241,1589925,Success,United Arab Emirates,DU UAE,Transguard Group LLC,API User,E6AEAE17361
2022-02-17 20:04,72576216,"36,785.4210","36,781.2410",150.00 PKR,4.75,4.1800,0.5700,564655394,1589929,Success,Pakistan,Jazz Pakistan,Transguard Group LLC,API User,MBPKPK20699
2022-02-17 20:04,72576233,"36,781.2410","36,759.0210",800.00 PKR,25.25,22.2200,3.0300,564655424,1589931,Success,Pakistan,Jazz Pakistan,Transguard Group LLC,API User,MBPKPK58682
2022-02-17 20:05,72576310,"36,759.0210","36,754.1210",05.00 AED,5.00,4.9000,0.1000,564655626,1589939,Success,United Arab Emirates,DU UAE,Transguard Group LLC,API User,E6AEAE17361
2022-02-17 20:05,72576325,"36,754.1210","36,749.9410",150.00 PKR,4.75,4.1800,0.5700,564655678,1589942,Success,Pakistan,Jazz Pakistan,Transguard Group LLC,API User,MBPKPK20699
2022-02-17 20:06,72576348,"36,749.9410","36,745.0410",05.00 AED,5.00,4.9000,0.1000,564655720,1589943,Success,United Arab Emirates,DU UAE,Transguard Group LLC,API User,E6AEAE17361
2022-02-17 20:08,72576500,"36,745.0410","36,740.1410",05.00 AED,5.00,4.9000,0.1000,564656164,1589951,Success,United Arab Emirates,DU UAE,Transguard Group LLC,API User,E6AEAE17361
2022-02-17 20:09,72576676,"36,740.1410","36,735.2410",05.00 AED,5.00,4.9000,0.1000,564656614,1589956,Success,United Arab Emirates,DU UAE,Transguard Group LLC,API User,E6AEAE17361
2022-02-17 20:10,72576736,"36,735.2410","36,715.6410",20.00 AED,20.00,19.6000,0.4000,564656788,1589959,Success,United Arab Emirates,DU UAE,Transguard Group LLC,API User,E6AEAE12938
2022-02-17 20:13,72577005,"36,715.6410","36,710.7410",05.00 AED,5.00,4.9000,0.1000,564657461,1589963,Success,United Arab Emirates,DU UAE,Transguard Group LLC,API User,E6AEAE17361
2022-02-17 20:13,72577029,"36,710.7410","36,702.8210",220.00 NPR,9.00,7.9200,1.0800,564657536,1589965,Success,Nepal,Ncell Nepal,Transguard Group LLC,API User,NCNPNP79518
2022-02-17 20:14,72577091,"36,702.8210","36,697.9210",05.00 AED,5.00,4.9000,0.1000,564657687,1589970,Success,United Arab Emirates,DU UAE,Transguard Group LLC,API User,E6AEAE17361
2022-02-17 20:14,72577106,"36,697.9210","36,678.3210",20.00 AED,20.00,19.6000,0.4000,564657699,1589971,Success,United Arab Emirates,DU UAE,Transguard Group LLC,API User,E6AEAE12938
2022-02-17 20:15,72577174,"36,678.3210","36,673.4210",05.00 AED,5.00,4.9000,0.1000,564657908,1589976,Success,United Arab Emirates,DU UAE,Transguard Group LLC,API User,E6AEAE17361
2022-02-17 20:15,72577202,"36,673.4210","36,668.5210",05.00 AED,5.00,4.9000,0.1000,564657967,1589979,Success,United Arab Emirates,DU UAE,Transguard Group LLC,API User,E6AEAE17361
2022-02-17 20:16,72577316,"36,668.5210","36,639.1210",30.00 AED,30.00,29.4000,0.6000,564658265,1589983,Success,United Arab Emirates,DU UAE,Transguard Group LLC,API User,E6AEAE46146
2022-02-17 20:17,72577349,"36,639.1210","36,634.2210",05.00 AED,5.00,4.9000,0.1000,564658357,1589987,Failure,United Arab Emirates,DU UAE,Transguard Group LLC,API User,E6AEAE17361
2022-02-17 20:17,72577349,"36,634.2210","36,629.3210",05.00 AED,5.00,4.9000,0.1000,564658357,1589987,Failure,United Arab Emirates,DU UAE,Transguard Group LLC,API User,E6AEAE17361
2022-02-17 20:18,72577473,"36,639.1210","36,619.5210",20.00 AED,20.00,19.6000,0.4000,564658664,1589992,Success,United Arab Emirates,DU UAE,Transguard Group LLC,API User,E6AEAE12938
2022-02-17 20:19,72577563,"36,619.5210","36,614.6210",05.00 AED,5.00,4.9000,0.1000,564658859,1589998,Success,United Arab Emirates,DU UAE,Transguard Group LLC,API User,E6AEAE17361
2022-02-17 20:19,72577609,"36,614.6210","36,610.8810",151.00 PKR,4.25,3.7400,0.5100,564658986,1590001,Success,Pakistan,Telenor Pakistan,Transguard Group LLC,API User,TPPKPK94108
2022-02-17 20:20,72577651,"36,610.8810","36,606.7010",150.00 PKR,4.75,4.1800,0.5700,564659107,1590005,Success,Pakistan,Jazz Pakistan,Transguard Group LLC,API User,MBPKPK20699
2022-02-17 20:20,72577685,"36,606.7010","36,601.8010",05.00 AED,5.00,4.9000,0.1000,564659217,1590008,Success,United Arab Emirates,DU UAE,Transguard Group LLC,API User,E6AEAE17361
2022-02-17 20:22,72577821,"36,601.8010","36,596.9010",05.00 AED,5.00,4.9000,0.1000,564659592,1590014,Success,United Arab Emirates,DU UAE,Transguard Group LLC,API User,E6AEAE17361
2022-02-17 20:22,72577840,"36,596.9010","36,592.0010",05.00 AED,5.00,4.9000,0.1000,564659634,1590016,Success,United Arab Emirates,DU UAE,Transguard Group LLC,API User,E6AEAE17361
2022-02-17 20:22,72577886,"36,592.0010","36,587.1010",05.00 AED,5.00,4.9000,0.1000,564659745,1590019,Success,United Arab Emirates,DU UAE,Transguard Group LLC,API User,E6AEAE17361
2022-02-17 20:24,72577982,"36,587.1010","36,577.3010",10.00 AED,10.00,9.8000,0.2000,564660045,1590024,Success,United Arab Emirates,DU UAE,Transguard Group LLC,API User,E6AEAE22430
2022-02-17 20:25,72578049,"36,577.3010","36,567.5010",10.00 AED,10.00,9.8000,0.2000,564660225,1590028,Success,United Arab Emirates,DU UAE,Transguard Group LLC,API User,E6AEAE22430
2022-02-17 20:26,72578202,"36,567.5010","36,557.7010",10.00 AED,10.00,9.8000,0.2000,564660646,1590035,Success,United Arab Emirates,DU UAE,Transguard Group LLC,API User,E6AEAE22430
2022-02-17 20:27,72578254,"36,557.7010","36,547.9010",10.00 AED,10.00,9.8000,0.2000,564660782,1590041,Success,United Arab Emirates,DU UAE,Transguard Group LLC,API User,E6AEAE22430
2022-02-17 20:28,72578301,"36,547.9010","36,538.1010",10.00 AED,10.00,9.8000,0.2000,564660912,1590045,Success,United Arab Emirates,DU UAE,Transguard Group LLC,API User,E6AEAE22430
2022-02-17 20:28,72578302,"36,538.1010","36,520.5010",301.00 INR,20.00,17.6000,2.4000,564660916,1590046,Success,India,Jio India,Transguard Group LLC,API User,RJININ16042
2022-02-17 20:28,72578329,"36,520.5010","36,481.3010",40.00 AED,40.00,39.2000,0.8000,564660968,1590048,Success,United Arab Emirates,DU UAE,Transguard Group LLC,API User,E6AEAE64011
2022-02-17 20:29,72578426,"36,481.3010","36,461.7010",20.00 AED,20.00,19.6000,0.4000,564661238,1590051,Success,United Arab Emirates,DU UAE,Transguard Group LLC,API User,E6AEAE12938
2022-02-17 20:29,72578454,"36,461.7010","36,451.9010",10.00 AED,10.00,9.8000,0.2000,564661326,1590054,Success,United Arab Emirates,DU UAE,Transguard Group LLC,API User,E6AEAE22430
2022-02-17 20:30,72578527,"36,451.9010","36,442.1010",10.00 AED,10.00,9.8000,0.2000,564661529,1590058,Success,United Arab Emirates,DU UAE,Transguard Group LLC,API User,E6AEAE22430
2022-02-17 20:31,72578582,"36,442.1010","36,437.9210",150.00 PKR,4.75,4.1800,0.5700,564661718,1590063,Success,Pakistan,Zong Pakistan,Transguard Group LLC,API User,ZNPKPK65621
2022-02-17 20:31,72578601,"36,437.9210","36,433.0210",05.00 AED,5.00,4.9000,0.1000,564661745,1590064,Success,United Arab Emirates,DU UAE,Transguard Group LLC,API User,E6AEAE17361
2022-02-17 20:34,72578835,"36,433.0210","36,423.2210",10.00 AED,10.00,9.8000,0.2000,564662341,1590070,Success,United Arab Emirates,DU UAE,Transguard Group LLC,API User,E6AEAE22430
2022-02-17 20:36,72578983,"36,423.2210","36,419.0410",150.00 PKR,4.75,4.1800,0.5700,564662786,1590081,Success,Pakistan,Jazz Pakistan,Transguard Group LLC,API User,MBPKPK20699
2022-02-17 20:38,72579180,"36,419.0410","36,401.4410",26.41 GHS,20.00,17.6000,2.4000,564663235,1590088,Success,Ghana,MTN Ghana,Transguard Group LLC,API User,GH_MT_TopUp
2022-02-17 20:38,72579238,"36,401.4410","36,392.6410",315.00 PKR,10.00,8.8000,1.2000,564663375,1590092,Success,Pakistan,Telenor Pakistan,Transguard Group LLC,API User,TPPKPK75105
2022-02-17 20:39,72579332,"36,392.6410","36,387.7410",05.00 AED,5.00,4.9000,0.1000,564663622,1590096,Success,United Arab Emirates,DU UAE,Transguard Group LLC,API User,E6AEAE17361
2022-02-17 20:45,72579825,"36,387.7410","36,380.4810",200.00 NPR,8.25,7.2600,0.9900,564664946,1590108,Success,Nepal,Nepal Telecom Nepal,Transguard Group LLC,API User,NP_NE_TopUp_200.00
2022-02-17 20:46,72579921,"36,375.5810","36,355.3410",725.00 PKR,23.00,20.2400,2.7600,564665203,1590116,Success,Pakistan,Telenor Pakistan,Transguard Group LLC,API User,TPPKPK18540
2022-02-17 20:46,72579924,"36,380.4810","36,375.5810",05.00 AED,5.00,4.9000,0.1000,564665201,1590115,Success,United Arab Emirates,DU UAE,Transguard Group LLC,API User,E6AEAE17361
2022-02-17 20:47,72580017,"36,355.3410","36,345.5410",10.00 AED,10.00,9.8000,0.2000,564665448,1590121,Success,United Arab Emirates,DU UAE,Transguard Group LLC,API User,E6AEAE22430
2022-02-17 20:50,72580199,"36,345.5410","36,335.7410",10.00 AED,10.00,9.8000,0.2000,564665965,1590128,Success,United Arab Emirates,DU UAE,Transguard Group LLC,API User,E6AEAE22430
2022-02-17 20:50,72580275,"36,335.7410","36,325.9410",10.00 AED,10.00,9.8000,0.2000,564666175,1590131,Success,United Arab Emirates,DU UAE,Transguard Group LLC,API User,E6AEAE22430
2022-02-17 20:51,72580336,"36,325.9410","36,321.0410",05.00 AED,5.00,4.9000,0.1000,564666329,1590136,Success,United Arab Emirates,DU UAE,Transguard Group LLC,API User,E6AEAE17361
2022-02-17 20:52,72580423,"36,321.0410","36,316.1410",05.00 AED,5.00,4.9000,0.1000,564666559,1590143,Success,United Arab Emirates,DU UAE,Transguard Group LLC,API User,E6AEAE17361
2022-02-17 20:54,72580572,"36,316.1410","36,307.5610",315.00 PKR,9.75,8.5800,1.1700,564666996,1590147,Success,Pakistan,Zong Pakistan,Transguard Group LLC,API User,ZNPKPK29953
2022-02-17 20:56,72580745,"36,307.5610","36,302.6610",05.00 AED,5.00,4.9000,0.1000,564667445,1590154,Success,United Arab Emirates,DU UAE,Transguard Group LLC,API User,E6AEAE17361
2022-02-17 20:59,72580992,"36,302.6610","36,297.7610",05.00 AED,5.00,4.9000,0.1000,564668090,1590162,Success,United Arab Emirates,DU UAE,Transguard Group LLC,API User,E6AEAE17361
2022-02-17 21:03,72581312,"36,297.7610","36,287.9610",10.00 AED,10.00,9.8000,0.2000,564669015,1590167,Success,United Arab Emirates,DU UAE,Transguard Group LLC,API User,E6AEAE22430
2022-02-17 21:05,72581479,"36,287.9610","36,283.0610",05.00 AED,5.00,4.9000,0.1000,564669494,1590173,Success,United Arab Emirates,DU UAE,Transguard Group LLC,API User,E6AEAE17361
2022-02-17 21:08,72581692,"36,283.0610","36,273.2610",10.00 AED,10.00,9.8000,0.2000,564670093,1590178,Success,United Arab Emirates,DU UAE,Transguard Group LLC,API User,E6AEAE22430
2022-02-17 21:11,72581929,"36,273.2610","36,269.0810",150.00 PKR,4.75,4.1800,0.5700,564670764,1590188,Success,Pakistan,Jazz Pakistan,Transguard Group LLC,API User,MBPKPK20699
2022-02-17 21:14,72582170,"36,269.0810","36,252.1410",650.00 PKR,19.25,16.9400,2.3100,564671394,1590197,Success,Pakistan,Telenor Pakistan,Transguard Group LLC,API User,TPPKPK28935
2022-02-17 21:14,72582179,"36,252.1410","36,247.2410",05.00 AED,5.00,4.9000,0.1000,564671408,1590198,Success,United Arab Emirates,DU UAE,Transguard Group LLC,API User,E6AEAE17361
2022-02-17 21:14,72582229,"36,247.2410","36,243.0610",150.00 PKR,4.75,4.1800,0.5700,564671555,1590201,Success,Pakistan,Jazz Pakistan,Transguard Group LLC,API User,MBPKPK20699
2022-02-17 21:16,72582363,"36,243.0610","36,233.2610",10.00 AED,10.00,9.8000,0.2000,564671919,1590207,Success,United Arab Emirates,DU UAE,Transguard Group LLC,API User,E6AEAE22430
2022-02-17 21:17,72582400,"36,233.2610","36,228.3610",05.00 AED,5.00,4.9000,0.1000,564672019,1590210,Success,United Arab Emirates,DU UAE,Transguard Group LLC,API User,E6AEAE17361
2022-02-17 21:17,72582450,"36,228.3610","36,223.4610",05.00 AED,5.00,4.9000,0.1000,564672143,1590213,Success,United Arab Emirates,DU UAE,Transguard Group LLC,API User,E6AEAE17361
2022-02-17 21:18,72582496,"36,223.4610","36,218.5610",05.00 AED,5.00,4.9000,0.1000,564672250,1590216,Success,United Arab Emirates,DU UAE,Transguard Group LLC,API User,E6AEAE17361
2022-02-17 21:18,72582544,"36,218.5610","36,213.6610",05.00 AED,5.00,4.9000,0.1000,564672374,1590219,Success,United Arab Emirates,DU UAE,Transguard Group LLC,API User,E6AEAE17361
2022-02-17 21:26,72583149,"36,213.6610","36,169.5610",45.00 AED,45.00,44.1000,0.9000,564674077,1590236,Success,United Arab Emirates,DU UAE,Transguard Group LLC,API User,E6AEAE35243
2022-02-17 21:26,72583155,"36,169.5610","36,159.0010",179.00 INR,12.00,10.5600,1.4400,564674111,1590238,Success,India,Airtel India,Transguard Group LLC,API User,AIININ72188
2022-02-17 21:27,72583215,"36,159.0010","36,149.2010",10.00 AED,10.00,9.8000,0.2000,564674256,1590245,Success,United Arab Emirates,DU UAE,Transguard Group LLC,API User,E6AEAE22430
2022-02-17 21:27,72583217,"36,149.2010","36,140.4010",315.00 PKR,10.00,8.8000,1.2000,564674287,1590246,Success,Pakistan,Telenor Pakistan,Transguard Group LLC,API User,TPPKPK75105
2022-02-17 21:27,72583236,"36,140.4010","36,135.5010",05.00 AED,5.00,4.9000,0.1000,564674329,1590249,Success,United Arab Emirates,DU UAE,Transguard Group LLC,API User,E6AEAE17361
2022-02-17 21:28,72583342,"36,135.5010","36,125.7010",10.00 AED,10.00,9.8000,0.2000,564674541,1590254,Success,United Arab Emirates,DU UAE,Transguard Group LLC,API User,E6AEAE22430
2022-02-17 21:28,72583384,"36,125.7010","36,106.1010",20.00 AED,20.00,19.6000,0.4000,564674619,1590257,Success,United Arab Emirates,DU UAE,Transguard Group LLC,API User,E6AEAE12938
2022-02-17 21:31,72583546,"36,106.1010","36,096.3010",10.00 AED,10.00,9.8000,0.2000,564675091,1590261,Success,United Arab Emirates,DU UAE,Transguard Group LLC,API User,E6AEAE22430
2022-02-17 21:34,72583803,"36,096.3010","36,091.4010",05.00 AED,5.00,4.9000,0.1000,564675730,1590269,Success,United Arab Emirates,DU UAE,Transguard Group LLC,API User,E6AEAE17361
2022-02-17 21:38,72584163,"36,091.4010","36,086.5010",05.00 AED,5.00,4.9000,0.1000,564676805,1590276,Success,United Arab Emirates,DU UAE,Transguard Group LLC,API User,E6AEAE17361
2022-02-17 21:45,72584610,"36,086.5010","36,076.7010",10.00 AED,10.00,9.8000,0.2000,564678113,1590296,Success,United Arab Emirates,DU UAE,Transguard Group LLC,API User,E6AEAE22430
2022-02-17 21:46,72584717,"36,076.7010","36,071.8010",05.00 AED,5.00,4.9000,0.1000,564678392,1590301,Success,United Arab Emirates,DU UAE,Transguard Group LLC,API User,E6AEAE17361
2022-02-17 21:46,72584734,"36,071.8010","36,066.9010",05.00 AED,5.00,4.9000,0.1000,564678446,1590304,Success,United Arab Emirates,DU UAE,Transguard Group LLC,API User,E6AEAE17361
2022-02-17 21:52,72585168,"36,066.9010","36,062.0010",05.00 AED,5.00,4.9000,0.1000,564679641,1590310,Success,United Arab Emirates,DU UAE,Transguard Group LLC,API User,E6AEAE17361
2022-02-17 21:54,72585348,"36,062.0010","36,057.1010",05.00 AED,5.00,4.9000,0.1000,564680136,1590316,Success,United Arab Emirates,DU UAE,Transguard Group LLC,API User,E6AEAE17361
2022-02-17 21:59,72585675,"36,057.1010","36,042.4010",15.00 AED,15.00,14.7000,0.3000,564681018,1590320,Success,United Arab Emirates,DU UAE,Transguard Group LLC,API User,E6AEAE8527
2022-02-17 22:01,72585809,"36,042.4010","36,037.5010",05.00 AED,5.00,4.9000,0.1000,564681410,1590323,Success,United Arab Emirates,DU UAE,Transguard Group LLC,API User,E6AEAE17361
2022-02-17 22:01,72585850,"36,037.5010","36,032.6010",05.00 AED,5.00,4.9000,0.1000,564681513,1590327,Success,United Arab Emirates,DU UAE,Transguard Group LLC,API User,E6AEAE17361
2022-02-17 22:02,72585924,"36,032.6010","36,027.7010",05.00 AED,5.00,4.9000,0.1000,564681693,1590333,Success,United Arab Emirates,DU UAE,Transguard Group LLC,API User,E6AEAE17361
2022-02-17 22:03,72585998,"36,027.7010","36,022.8010",05.00 AED,5.00,4.9000,0.1000,564681869,1590339,Success,United Arab Emirates,DU UAE,Transguard Group LLC,API User,E6AEAE17361
2022-02-17 22:05,72586094,"36,022.8010","36,013.0010",10.00 AED,10.00,9.8000,0.2000,564682114,1590347,Success,United Arab Emirates,DU UAE,Transguard Group LLC,API User,E6AEAE22430
2022-02-17 22:06,72586214,"36,013.0010","36,003.2010",10.00 AED,10.00,9.8000,0.2000,564682420,1590352,Success,United Arab Emirates,DU UAE,Transguard Group LLC,API User,E6AEAE22430
2022-02-17 22:07,72586238,"36,003.2010","35,988.6810",400.00 NPR,16.50,14.5200,1.9800,564682508,1590356,Success,Nepal,Nepal Telecom Nepal,Transguard Group LLC,API User,NENPNP18292
2022-02-17 22:07,72586249,"35,988.6810","35,983.7810",05.00 AED,5.00,4.9000,0.1000,564682514,1590357,Success,United Arab Emirates,DU UAE,Transguard Group LLC,API User,E6AEAE17361
2022-02-17 22:13,72586651,"35,983.7810","35,978.8810",05.00 AED,5.00,4.9000,0.1000,564683747,1590367,Success,United Arab Emirates,DU UAE,Transguard Group LLC,API User,E6AEAE17361
2022-02-17 22:16,72586858,"35,978.8810","35,973.9810",05.00 AED,5.00,4.9000,0.1000,564684364,1590376,Success,United Arab Emirates,DU UAE,Transguard Group LLC,API User,E6AEAE17361
2022-02-17 22:17,72586898,"35,973.9810","35,964.1810",10.00 AED,10.00,9.8000,0.2000,564684464,1590381,Success,United Arab Emirates,DU UAE,Transguard Group LLC,API User,E6AEAE22430
2022-02-17 22:17,72586899,"35,964.1810","35,954.3810",10.00 AED,10.00,9.8000,0.2000,564684468,1590382,Success,United Arab Emirates,DU UAE,Transguard Group LLC,API User,E6AEAE22430
2022-02-17 22:18,72586986,"35,954.3810","35,949.4810",05.00 AED,5.00,4.9000,0.1000,564684681,1590385,Success,United Arab Emirates,DU UAE,Transguard Group LLC,API User,E6AEAE17361
2022-02-17 22:20,72587090,"35,949.4810","35,944.5810",05.00 AED,5.00,4.9000,0.1000,564685014,1590390,Success,United Arab Emirates,DU UAE,Transguard Group LLC,API User,E6AEAE17361
2022-02-17 22:21,72587135,"35,944.5810","35,939.6810",05.00 AED,5.00,4.9000,0.1000,564685165,1590393,Success,United Arab Emirates,DU UAE,Transguard Group LLC,API User,E6AEAE17361
2022-02-17 22:23,72587284,"35,939.6810","35,934.7810",05.00 AED,5.00,4.9000,0.1000,564685660,1590399,Success,United Arab Emirates,DU UAE,Transguard Group LLC,API User,E6AEAE17361
2022-02-17 22:28,72587569,"35,934.7810","35,929.8810",05.00 AED,5.00,4.9000,0.1000,564686473,1590406,Success,United Arab Emirates,DU UAE,Transguard Group LLC,API User,E6AEAE17361
2022-02-17 22:30,72587677,"35,929.8810","35,921.0810","7,350.82 UGX",10.00,8.8000,1.2000,564686789,1590412,Success,Uganda,MTN Uganda,Transguard Group LLC,API User,UG_MT_TopUp
2022-02-17 22:32,72587797,"35,921.0810","35,916.1810",05.00 AED,5.00,4.9000,0.1000,564687128,1590415,Success,United Arab Emirates,DU UAE,Transguard Group LLC,API User,E6AEAE17361
2022-02-17 22:42,72588369,"35,916.1810","35,911.2810",05.00 AED,5.00,4.9000,0.1000,564688898,1590419,Success,United Arab Emirates,DU UAE,Transguard Group LLC,API User,E6AEAE17361
2022-02-17 22:44,72588488,"35,911.2810","35,901.4810",10.00 AED,10.00,9.8000,0.2000,564689259,1590422,Success,United Arab Emirates,DU UAE,Transguard Group LLC,API User,E6AEAE22430
2022-02-17 22:45,72588576,"35,901.4810","35,891.6810",10.00 AED,10.00,9.8000,0.2000,564689497,1590428,Success,United Arab Emirates,DU UAE,Transguard Group LLC,API User,E6AEAE22430
2022-02-17 22:47,72588662,"35,891.6810","35,881.8810",10.00 AED,10.00,9.8000,0.2000,564689763,1590431,Success,United Arab Emirates,DU UAE,Transguard Group LLC,API User,E6AEAE22430
2022-02-17 22:55,72589135,"35,881.8810","35,876.9810",05.00 AED,5.00,4.9000,0.1000,564691199,1590440,Success,United Arab Emirates,DU UAE,Transguard Group LLC,API User,E6AEAE17361
2022-02-17 22:57,72589250,"35,876.9810","35,872.0810",05.00 AED,5.00,4.9000,0.1000,564691616,1590445,Success,United Arab Emirates,DU UAE,Transguard Group LLC,API User,E6AEAE17361
2022-02-17 22:59,72589321,"35,872.0810","35,862.2810",10.00 AED,10.00,9.8000,0.2000,564691838,1590449,Success,United Arab Emirates,DU UAE,Transguard Group LLC,API User,E6AEAE22430
2022-02-17 22:59,72589340,"35,862.2810","35,852.4810",10.00 AED,10.00,9.8000,0.2000,564691887,1590451,Success,United Arab Emirates,DU UAE,Transguard Group LLC,API User,E6AEAE22430
2022-02-17 23:04,72589632,"35,852.4810","35,813.2810",40.00 AED,40.00,39.2000,0.8000,564692719,1590454,Success,United Arab Emirates,DU UAE,Transguard Group LLC,API User,E6AEAE64011
2022-02-17 23:05,72589678,"35,813.2810","35,783.8810",30.00 AED,30.00,29.4000,0.6000,564692871,1590457,Success,United Arab Emirates,DU UAE,Transguard Group LLC,API User,E6AEAE46146
2022-02-17 23:07,72589787,"35,783.8810","35,778.9810",05.00 AED,5.00,4.9000,0.1000,564693183,1590460,Success,United Arab Emirates,DU UAE,Transguard Group LLC,API User,E6AEAE17361
2022-02-17 23:11,72590015,"35,778.9810","35,774.0810",05.00 AED,5.00,4.9000,0.1000,564693877,1590464,Success,United Arab Emirates,DU UAE,Transguard Group LLC,API User,E6AEAE17361
2022-02-17 23:12,72590058,"35,774.0810","35,764.2810",10.00 AED,10.00,9.8000,0.2000,564693995,1590467,Success,United Arab Emirates,DU UAE,Transguard Group LLC,API User,E6AEAE22430
2022-02-17 23:21,72590511,"35,764.2810","35,759.3810",05.00 AED,5.00,4.9000,0.1000,564695456,1590477,Success,United Arab Emirates,DU UAE,Transguard Group LLC,API User,E6AEAE17361
2022-02-17 23:28,72590855,"35,759.3810","35,754.4810",05.00 AED,5.00,4.9000,0.1000,564696556,1590486,Success,United Arab Emirates,DU UAE,Transguard Group LLC,API User,E6AEAE17361
2022-02-17 23:39,72591412,"35,754.4810","35,744.6810",10.00 AED,10.00,9.8000,0.2000,564698345,1590495,Success,United Arab Emirates,DU UAE,Transguard Group LLC,API User,E6AEAE22430
2022-02-17 23:44,72591621,"35,744.6810","35,734.8810",10.00 AED,10.00,9.8000,0.2000,564699013,1590500,Success,United Arab Emirates,DU UAE,Transguard Group LLC,API User,E6AEAE22430
2022-02-17 23:46,72591697,"35,734.8810","35,695.6810",40.00 AED,40.00,39.2000,0.8000,564699286,1590503,Success,United Arab Emirates,DU UAE,Transguard Group LLC,API User,E6AEAE64011
2022-02-17 23:47,72591739,"35,695.6810","35,676.0810",20.00 AED,20.00,19.6000,0.4000,564699409,1590506,Success,United Arab Emirates,DU UAE,Transguard Group LLC,API User,E6AEAE12938
2022-02-17 23:53,72592006,"35,676.0810","35,666.2810",10.00 AED,10.00,9.8000,0.2000,564700256,1590511,Success,United Arab Emirates,DU UAE,Transguard Group LLC,API User,E6AEAE22430
2022-02-17 23:56,72592146,"35,666.2810","35,656.4810",10.00 AED,10.00,9.8000,0.2000,564700764,1590514,Success,United Arab Emirates,DU UAE,Transguard Group LLC,API User,E6AEAE22430
2022-02-18 00:07,72592586,"35,656.4810","35,651.5810",05.00 AED,5.00,4.9000,0.1000,564702252,1590526,Success,United Arab Emirates,DU UAE,Transguard Group LLC,API User,E6AEAE17361
2022-02-18 00:07,72592593,"35,651.5810","35,641.7810",10.00 AED,10.00,9.8000,0.2000,564702267,1590527,Success,United Arab Emirates,DU UAE,Transguard Group LLC,API User,E6AEAE22430
2022-02-18 00:14,72592917,"35,641.7810","35,636.8810",05.00 AED,5.00,4.9000,0.1000,564703342,1590532,Success,United Arab Emirates,DU UAE,Transguard Group LLC,API User,E6AEAE17361
2022-02-18 00:16,72592992,"35,636.8810","35,627.0810",10.00 AED,10.00,9.8000,0.2000,564703644,1590539,Success,United Arab Emirates,DU UAE,Transguard Group LLC,API User,E6AEAE22430
2022-02-18 00:17,72593004,"35,627.0810","35,618.2810","1,226.00 XOF",10.00,8.8000,1.2000,564703687,1590541,Success,Ivory Coast,MTN Ivory Coast,Transguard Group LLC,API User,CI_MT_TopUp
2022-02-18 00:20,72593147,"35,618.2810","35,613.3810",05.00 AED,5.00,4.9000,0.1000,564704113,1590547,Success,United Arab Emirates,DU UAE,Transguard Group LLC,API User,E6AEAE17361
2022-02-18 00:20,72593171,"35,613.3810","35,603.5810",10.00 AED,10.00,9.8000,0.2000,564704203,1590549,Success,United Arab Emirates,DU UAE,Transguard Group LLC,API User,E6AEAE22430
2022-02-18 00:30,72593546,"35,603.5810","35,593.7810",10.00 AED,10.00,9.8000,0.2000,564705486,1590555,Success,United Arab Emirates,DU UAE,Transguard Group LLC,API User,E6AEAE22430
2022-02-18 00:32,72593610,"35,593.7810","35,574.1810",20.00 AED,20.00,19.6000,0.4000,564705715,1590558,Success,United Arab Emirates,DU UAE,Transguard Group LLC,API User,E6AEAE12938
2022-02-18 00:33,72593635,"35,574.1810","35,569.2810",05.00 AED,5.00,4.9000,0.1000,564705791,1590561,Success,United Arab Emirates,DU UAE,Transguard Group LLC,API User,E6AEAE17361
2022-02-18 00:38,72593914,"35,569.2810","35,559.4810",10.00 AED,10.00,9.8000,0.2000,564706618,1590567,Success,United Arab Emirates,DU UAE,Transguard Group LLC,API User,E6AEAE22430
2022-02-18 00:46,72594223,"35,559.4810","35,554.5810",05.00 AED,5.00,4.9000,0.1000,564707602,1590570,Success,United Arab Emirates,DU UAE,Transguard Group LLC,API User,E6AEAE17361
2022-02-18 00:46,72594240,"35,554.5810","35,550.8410",100.00 NPR,4.25,3.7400,0.5100,564707663,1590574,Success,Nepal,Nepal Telecom Nepal,Transguard Group LLC,API User,NP_NE_TopUp_100.00
2022-02-18 00:52,72594467,"35,550.8410","35,545.9410",05.00 AED,5.00,4.9000,0.1000,564708417,1590580,Success,United Arab Emirates,DU UAE,Transguard Group LLC,API User,E6AEAE17361
2022-02-18 01:20,72595526,"35,545.9410","35,541.0410",05.00 AED,5.00,4.9000,0.1000,564711888,1590583,Success,United Arab Emirates,DU UAE,Transguard Group LLC,API User,E6AEAE17361
2022-02-18 01:22,72595585,"35,541.0410","35,536.1410",05.00 AED,5.00,4.9000,0.1000,564712064,1590586,Success,United Arab Emirates,DU UAE,Transguard Group LLC,API User,E6AEAE17361
2022-02-18 01:23,72595628,"35,536.1410","35,531.2410",05.00 AED,5.00,4.9000,0.1000,564712204,1590589,Success,United Arab Emirates,DU UAE,Transguard Group LLC,API User,E6AEAE17361
2022-02-18 02:29,72598220,"35,531.2410","35,511.6410",20.00 AED,20.00,19.6000,0.4000,564720711,1590596,Success,United Arab Emirates,DU UAE,Transguard Group LLC,API User,E6AEAE12938
2022-02-18 02:34,72598443,"35,511.6410","35,501.8410",10.00 AED,10.00,9.8000,0.2000,564721394,1590599,Success,United Arab Emirates,DU UAE,Transguard Group LLC,API User,E6AEAE22430
2022-02-18 02:35,72598474,"35,501.8410","35,492.0410",10.00 AED,10.00,9.8000,0.2000,564721487,1590602,Success,United Arab Emirates,DU UAE,Transguard Group LLC,API User,E6AEAE22430
2022-02-18 02:37,72598569,"35,492.0410","35,482.2410",10.00 AED,10.00,9.8000,0.2000,564721779,1590605,Success,United Arab Emirates,DU UAE,Transguard Group LLC,API User,E6AEAE22430
2022-02-18 02:59,72599429,"35,482.2410","35,477.3410",05.00 AED,5.00,4.9000,0.1000,564724649,1590608,Success,United Arab Emirates,DU UAE,Transguard Group LLC,API User,E6AEAE17361
2022-02-18 04:36,72603766,"35,477.3410","35,472.4410",05.00 AED,5.00,4.9000,0.1000,564737969,1590636,Success,United Arab Emirates,DU UAE,Transguard Group LLC,API User,E6AEAE17361
2022-02-18 04:45,72604208,"35,472.4410","35,462.6410",10.00 AED,10.00,9.8000,0.2000,564739147,1590641,Success,United Arab Emirates,DU UAE,Transguard Group LLC,API User,E6AEAE22430
2022-02-18 04:55,72604661,"35,462.6410","35,452.8410",10.00 AED,10.00,9.8000,0.2000,564740361,1590646,Success,United Arab Emirates,DU UAE,Transguard Group LLC,API User,E6AEAE22430
2022-02-18 05:01,72604947,"35,452.8410","35,443.0410",10.00 AED,10.00,9.8000,0.2000,564741166,1590655,Success,United Arab Emirates,DU UAE,Transguard Group LLC,API User,E6AEAE22430
2022-02-18 05:02,72605011,"35,443.0410","35,439.3010",100.00 NPR,4.25,3.7400,0.5100,564741343,1590660,Success,Nepal,Nepal Telecom Nepal,Transguard Group LLC,API User,NP_NE_TopUp_100.00
2022-02-18 05:03,72605035,"35,439.3010","35,429.5010",10.00 AED,10.00,9.8000,0.2000,564741395,1590665,Success,United Arab Emirates,DU UAE,Transguard Group LLC,API User,E6AEAE22430
2022-02-18 05:07,72605222,"35,429.5010","35,424.6010",05.00 AED,5.00,4.9000,0.1000,564741941,1590676,Success,United Arab Emirates,DU UAE,Transguard Group LLC,API User,E6AEAE17361
2022-02-18 05:10,72605338,"35,424.6010","35,414.8010",10.00 AED,10.00,9.8000,0.2000,564742228,1590681,Success,United Arab Emirates,DU UAE,Transguard Group LLC,API User,E6AEAE22430
2022-02-18 05:10,72605356,"35,414.8010","35,409.9010",05.00 AED,5.00,4.9000,0.1000,564742301,1590684,Success,United Arab Emirates,DU UAE,Transguard Group LLC,API User,E6AEAE17361
2022-02-18 05:11,72605387,"35,409.9010","35,405.0010",05.00 AED,5.00,4.9000,0.1000,564742406,1590687,Success,United Arab Emirates,DU UAE,Transguard Group LLC,API User,E6AEAE17361
2022-02-18 05:22,72605954,"35,405.0010","35,387.6210",299.00 INR,19.75,17.3800,2.3700,564743826,1590700,Success,India,Airtel India,Transguard Group LLC,API User,AIININ55294
2022-02-18 05:53,72607517,"35,387.6210","35,377.8210",10.00 AED,10.00,9.8000,0.2000,564747621,1590721,Success,United Arab Emirates,DU UAE,Transguard Group LLC,API User,E6AEAE22430
2022-02-18 06:05,72608099,"35,377.8210","35,368.0210",10.00 AED,10.00,9.8000,0.2000,564748948,1590735,Success,United Arab Emirates,DU UAE,Transguard Group LLC,API User,E6AEAE22430
2022-02-18 06:06,72608139,"35,368.0210","35,358.2210",10.00 AED,10.00,9.8000,0.2000,564749057,1590739,Success,United Arab Emirates,DU UAE,Transguard Group LLC,API User,E6AEAE22430
2022-02-18 06:07,72608158,"35,358.2210","35,353.3210",05.00 AED,5.00,4.9000,0.1000,564749084,1590741,Success,United Arab Emirates,DU UAE,Transguard Group LLC,API User,E6AEAE17361
2022-02-18 06:07,72608181,"35,353.3210","35,343.5210",10.00 AED,10.00,9.8000,0.2000,564749136,1590744,Success,United Arab Emirates,DU UAE,Transguard Group LLC,API User,E6AEAE22430
2022-02-18 06:08,72608216,"35,343.5210","35,334.7210",315.00 PKR,10.00,8.8000,1.2000,564749222,1590747,Success,Pakistan,Telenor Pakistan,Transguard Group LLC,API User,TPPKPK75105
2022-02-18 06:10,72608300,"35,334.7210","35,326.3610",300.00 PKR,9.50,8.3600,1.1400,564749415,1590752,Success,Pakistan,Jazz Pakistan,Transguard Group LLC,API User,PK_MB_TopUp_300.00
2022-02-18 06:13,72608473,"35,326.3610","35,322.1810",150.00 PKR,4.75,4.1800,0.5700,564749801,1590762,Success,Pakistan,Jazz Pakistan,Transguard Group LLC,API User,MBPKPK20699
2022-02-18 06:15,72608576,"35,322.1810","35,312.3810",10.00 AED,10.00,9.8000,0.2000,564750068,1590765,Success,United Arab Emirates,DU UAE,Transguard Group LLC,API User,E6AEAE22430
2022-02-18 06:16,72608590,"35,312.3810","35,307.4810",05.00 AED,5.00,4.9000,0.1000,564750100,1590768,Success,United Arab Emirates,DU UAE,Transguard Group LLC,API User,E6AEAE17361
2022-02-18 06:27,72609165,"35,307.4810","35,297.6810",10.00 AED,10.00,9.8000,0.2000,564751364,1590783,Success,United Arab Emirates,DU UAE,Transguard Group LLC,API User,E6AEAE22430
2022-02-18 06:36,72609593,"35,297.6810","35,292.7810",05.00 AED,5.00,4.9000,0.1000,564752420,1590793,Success,United Arab Emirates,DU UAE,Transguard Group LLC,API User,E6AEAE17361
2022-02-18 06:41,72609821,"35,292.7810","35,284.6410",300.00 PKR,9.25,8.1400,1.1100,564752931,1590805,Success,Pakistan,Zong Pakistan,Transguard Group LLC,API User,ZNPKPK70504
2022-02-18 06:42,72609884,"35,284.6410","35,279.7410",05.00 AED,5.00,4.9000,0.1000,564753078,1590808,Success,United Arab Emirates,DU UAE,Transguard Group LLC,API User,E6AEAE17361
2022-02-18 06:43,72609912,"35,279.7410","35,260.1410",20.00 AED,20.00,19.6000,0.4000,564753141,1590811,Success,United Arab Emirates,DU UAE,Transguard Group LLC,API User,E6AEAE12938
2022-02-18 06:44,72609961,"35,260.1410","35,250.3410",10.00 AED,10.00,9.8000,0.2000,564753252,1590815,Success,United Arab Emirates,DU UAE,Transguard Group LLC,API User,E6AEAE22430
2022-02-18 06:45,72610010,"35,250.3410","35,245.4410",05.00 AED,5.00,4.9000,0.1000,564753378,1590822,Success,United Arab Emirates,DU UAE,Transguard Group LLC,API User,E6AEAE17361
2022-02-18 06:47,72610101,"35,245.4410","35,235.6410",10.00 AED,10.00,9.8000,0.2000,564753616,1590827,Success,United Arab Emirates,DU UAE,Transguard Group LLC,API User,E6AEAE22430
2022-02-18 06:48,72610134,"35,235.6410","35,216.0410",20.00 AED,20.00,19.6000,0.4000,564753693,1590830,Success,United Arab Emirates,DU UAE,Transguard Group LLC,API User,E6AEAE12938
2022-02-18 06:51,72610264,"35,216.0410","35,211.1410",05.00 AED,5.00,4.9000,0.1000,564753989,1590835,Success,United Arab Emirates,DU UAE,Transguard Group LLC,API User,E6AEAE17361
2022-02-18 06:52,72610281,"35,211.1410","35,206.2410",05.00 AED,5.00,4.9000,0.1000,564754026,1590838,Success,United Arab Emirates,DU UAE,Transguard Group LLC,API User,E6AEAE17361
2022-02-18 06:53,72610340,"35,206.2410","35,201.3410",05.00 AED,5.00,4.9000,0.1000,564754142,1590842,Success,United Arab Emirates,DU UAE,Transguard Group LLC,API User,E6AEAE17361
2022-02-18 07:00,72610691,"35,201.3410","35,196.9410",222.40 LKR,5.00,4.4000,0.6000,564754913,1590857,Success,Sri Lanka,Dialog Sri Lanka,Transguard Group LLC,API User,LK_DG_TopUp
2022-02-18 07:06,72610956,"35,196.9410","35,157.7410",40.00 AED,40.00,39.2000,0.8000,564755535,1590870,Success,United Arab Emirates,DU UAE,Transguard Group LLC,API User,E6AEAE64011
2022-02-18 07:14,72611270,"35,157.7410","35,147.9410",10.00 AED,10.00,9.8000,0.2000,564756281,1590884,Success,United Arab Emirates,DU UAE,Transguard Group LLC,API User,E6AEAE22430
2022-02-18 07:19,72611478,"35,147.9410","35,143.0410",05.00 AED,5.00,4.9000,0.1000,564756818,1590903,Success,United Arab Emirates,DU UAE,Transguard Group LLC,API User,E6AEAE17361
2022-02-18 07:23,72611663,"35,143.0410","35,138.1410",05.00 AED,5.00,4.9000,0.1000,564757276,1590916,Success,United Arab Emirates,DU UAE,Transguard Group LLC,API User,E6AEAE17361
2022-02-18 07:25,72611738,"35,138.1410","35,133.2410",05.00 AED,5.00,4.9000,0.1000,564757433,1590919,Success,United Arab Emirates,DU UAE,Transguard Group LLC,API User,E6AEAE17361
2022-02-18 07:26,72611799,"35,133.2410","35,128.3410",05.00 AED,5.00,4.9000,0.1000,564757581,1590925,Success,United Arab Emirates,DU UAE,Transguard Group LLC,API User,E6AEAE17361
2022-02-18 07:46,72612674,"35,128.3410","35,123.4410",05.00 AED,5.00,4.9000,0.1000,564759678,1590942,Success,United Arab Emirates,DU UAE,Transguard Group LLC,API User,E6AEAE17361
2022-02-18 07:46,72612694,"35,123.4410","35,118.5410",05.00 AED,5.00,4.9000,0.1000,564759729,1590947,Failure,United Arab Emirates,DU UAE,Transguard Group LLC,API User,E6AEAE17361
2022-02-18 07:46,72612694,"35,118.5410","35,113.6410",05.00 AED,5.00,4.9000,0.1000,564759729,1590947,Failure,United Arab Emirates,DU UAE,Transguard Group LLC,API User,E6AEAE17361
2022-02-18 07:48,72612753,"35,123.4410","35,113.6410",10.00 AED,10.00,9.8000,0.2000,564759832,1590950,Success,United Arab Emirates,DU UAE,Transguard Group LLC,API User,E6AEAE22430
2022-02-18 07:50,72612855,"35,113.6410","35,108.7410",05.00 AED,5.00,4.9000,0.1000,564760066,1590954,Success,United Arab Emirates,DU UAE,Transguard Group LLC,API User,E6AEAE17361
2022-02-18 07:57,72613158,"35,108.7410","35,094.0410",15.00 AED,15.00,14.7000,0.3000,564760767,1590975,Success,United Arab Emirates,DU UAE,Transguard Group LLC,API User,E6AEAE8527
2022-02-18 07:57,72613186,"35,094.0410","35,089.1410",05.00 AED,5.00,4.9000,0.1000,564760841,1590978,Success,United Arab Emirates,DU UAE,Transguard Group LLC,API User,E6AEAE17361
2022-02-18 08:02,72613424,"35,089.1410","35,079.3410",10.00 AED,10.00,9.8000,0.2000,564761359,1590985,Success,United Arab Emirates,DU UAE,Transguard Group LLC,API User,E6AEAE22430
2022-02-18 08:03,72613454,"35,079.3410","35,071.2010",300.00 PKR,9.25,8.1400,1.1100,564761435,1590988,Success,Pakistan,Zong Pakistan,Transguard Group LLC,API User,ZNPKPK70504
2022-02-18 08:07,72613632,"35,071.2010","35,066.3010",05.00 AED,5.00,4.9000,0.1000,564761830,1590996,Success,United Arab Emirates,DU UAE,Transguard Group LLC,API User,E6AEAE17361
2022-02-18 08:08,72613657,"35,066.3010","35,061.4010",05.00 AED,5.00,4.9000,0.1000,564761880,1590999,Success,United Arab Emirates,DU UAE,Transguard Group LLC,API User,E6AEAE17361
2022-02-18 08:08,72613676,"35,061.4010","35,056.5010",05.00 AED,5.00,4.9000,0.1000,564761925,1591002,Success,United Arab Emirates,DU UAE,Transguard Group LLC,API User,E6AEAE17361
2022-02-18 08:09,72613709,"35,056.5010","35,041.8010",15.00 AED,15.00,14.7000,0.3000,564761999,1591005,Success,United Arab Emirates,DU UAE,Transguard Group LLC,API User,E6AEAE8527
2022-02-18 08:14,72613903,"35,041.8010","35,032.0010",10.00 AED,10.00,9.8000,0.2000,564762448,1591010,Success,United Arab Emirates,DU UAE,Transguard Group LLC,API User,E6AEAE22430
2022-02-18 08:14,72613930,"35,032.0010","35,027.1010",05.00 AED,5.00,4.9000,0.1000,564762498,1591014,Success,United Arab Emirates,DU UAE,Transguard Group LLC,API User,E6AEAE17361
2022-02-18 08:15,72613937,"35,027.1010","35,022.2010",05.00 AED,5.00,4.9000,0.1000,564762522,1591016,Success,United Arab Emirates,DU UAE,Transguard Group LLC,API User,E6AEAE17361
2022-02-18 08:15,72613952,"35,022.2010","35,017.3010",05.00 AED,5.00,4.9000,0.1000,564762564,1591021,Success,United Arab Emirates,DU UAE,Transguard Group LLC,API User,E6AEAE17361
2022-02-18 08:16,72613977,"35,017.3010","35,012.4010",05.00 AED,5.00,4.9000,0.1000,564762626,1591029,Success,United Arab Emirates,DU UAE,Transguard Group LLC,API User,E6AEAE17361
2022-02-18 08:16,72613997,"35,012.4010","35,007.5010",05.00 AED,5.00,4.9000,0.1000,564762682,1591033,Success,United Arab Emirates,DU UAE,Transguard Group LLC,API User,E6AEAE17361
2022-02-18 08:17,72614006,"35,007.5010","35,002.6010",05.00 AED,5.00,4.9000,0.1000,564762701,1591036,Success,United Arab Emirates,DU UAE,Transguard Group LLC,API User,E6AEAE17361
2022-02-18 08:18,72614057,"35,002.6010","34,997.7010",05.00 AED,5.00,4.9000,0.1000,564762813,1591041,Success,United Arab Emirates,DU UAE,Transguard Group LLC,API User,E6AEAE17361
2022-02-18 08:19,72614119,"34,997.7010","34,992.8010",05.00 AED,5.00,4.9000,0.1000,564762944,1591044,Success,United Arab Emirates,DU UAE,Transguard Group LLC,API User,E6AEAE17361
2022-02-18 08:21,72614179,"34,992.8010","34,987.9010",05.00 AED,5.00,4.9000,0.1000,564763099,1591048,Success,United Arab Emirates,DU UAE,Transguard Group LLC,API User,E6AEAE17361
2022-02-18 08:22,72614243,"34,987.9010","34,978.1010",10.00 AED,10.00,9.8000,0.2000,564763243,1591052,Success,United Arab Emirates,DU UAE,Transguard Group LLC,API User,E6AEAE22430
2022-02-18 08:23,72614288,"34,978.1010","34,968.3010",10.00 AED,10.00,9.8000,0.2000,564763336,1591055,Success,United Arab Emirates,DU UAE,Transguard Group LLC,API User,E6AEAE22430
2022-02-18 08:28,72614491,"34,968.3010","34,963.4010",05.00 AED,5.00,4.9000,0.1000,564763794,1591062,Success,United Arab Emirates,DU UAE,Transguard Group LLC,API User,E6AEAE17361
2022-02-18 08:30,72614590,"34,963.4010","34,958.5010",05.00 AED,5.00,4.9000,0.1000,564764023,1591065,Success,United Arab Emirates,DU UAE,Transguard Group LLC,API User,E6AEAE17361
2022-02-18 08:33,72614706,"34,958.5010","34,953.6010",05.00 AED,5.00,4.9000,0.1000,564764279,1591072,Success,United Arab Emirates,DU UAE,Transguard Group LLC,API User,E6AEAE17361
2022-02-18 08:35,72614786,"34,953.6010","34,948.7010",05.00 AED,5.00,4.9000,0.1000,564764448,1591075,Success,United Arab Emirates,DU UAE,Transguard Group LLC,API User,E6AEAE17361
2022-02-18 08:36,72614843,"34,948.7010","34,943.8010",05.00 AED,5.00,4.9000,0.1000,564764613,1591080,Success,United Arab Emirates,DU UAE,Transguard Group LLC,API User,E6AEAE17361
2022-02-18 08:43,72615124,"34,943.8010","34,938.9010",05.00 AED,5.00,4.9000,0.1000,564765253,1591087,Success,United Arab Emirates,DU UAE,Transguard Group LLC,API User,E6AEAE17361
2022-02-18 08:47,72615261,"34,938.9010","34,930.5410",300.00 PKR,9.50,8.3600,1.1400,564765619,1591093,Success,Pakistan,Jazz Pakistan,Transguard Group LLC,API User,PK_MB_TopUp_300.00
2022-02-18 08:49,72615323,"34,930.5410","34,915.8410",15.00 AED,15.00,14.7000,0.3000,564765790,72615323,Failure,United Arab Emirates,DU UAE,Transguard Group LLC,mohammed.arafath@transguardgroup.com,E6AEAE8527
2022-02-18 08:49,72615323,"34,915.8410","34,901.1410",15.00 AED,15.00,14.7000,0.3000,564765790,72615323,Failure,United Arab Emirates,DU UAE,Transguard Group LLC,mohammed.arafath@transguardgroup.com,E6AEAE8527
2022-02-18 08:50,72615378,"34,930.5410","34,920.7410",10.00 AED,10.00,9.8000,0.2000,564765905,1591105,Success,United Arab Emirates,DU UAE,Transguard Group LLC,API User,E6AEAE22430
2022-02-18 08:53,72615483,"34,920.7410","34,901.1410",20.00 AED,20.00,19.6000,0.4000,564766178,1591111,Success,United Arab Emirates,DU UAE,Transguard Group LLC,API User,E6AEAE12938
2022-02-18 08:59,72615686,"34,901.1410","34,896.2410",05.00 AED,5.00,4.9000,0.1000,564766682,1591124,Success,United Arab Emirates,DU UAE,Transguard Group LLC,API User,E6AEAE17361
2022-02-18 09:00,72615735,"34,896.2410","34,891.3410",05.00 AED,5.00,4.9000,0.1000,564766827,1591129,Success,United Arab Emirates,DU UAE,Transguard Group LLC,API User,E6AEAE17361
2022-02-18 09:01,72615781,"34,891.3410","34,886.4410",05.00 AED,5.00,4.9000,0.1000,564766928,1591134,Success,United Arab Emirates,DU UAE,Transguard Group LLC,API User,E6AEAE17361
2022-02-18 09:06,72615922,"34,886.4410","34,878.5210",220.00 NPR,9.00,7.9200,1.0800,564767291,1591144,Success,Nepal,Ncell Nepal,Transguard Group LLC,API User,NCNPNP79518
2022-02-18 09:08,72616008,"34,878.5210","34,873.6210",05.00 AED,5.00,4.9000,0.1000,564767488,1591151,Success,United Arab Emirates,DU UAE,Transguard Group LLC,API User,E6AEAE17361
2022-02-18 09:12,72616144,"34,873.6210","34,869.8810",100.00 NPR,4.25,3.7400,0.5100,564767827,1591160,Success,Nepal,Ncell Nepal,Transguard Group LLC,API User,NP_NC_TopUp_100.00
2022-02-18 09:13,72616175,"34,869.8810","34,861.3010",300.00 PKR,9.75,8.5800,1.1700,564767911,72616175,Success,Pakistan,Telenor Pakistan,Transguard Group LLC,mohammed.arafath@transguardgroup.com,PK_TP_TopUp_300.00
2022-02-18 09:19,72616387,"34,861.3010","34,856.4010",05.00 AED,5.00,4.9000,0.1000,564768439,1591165,Success,United Arab Emirates,DU UAE,Transguard Group LLC,API User,E6AEAE17361
2022-02-18 09:21,72616474,"34,856.4010","34,851.5010",05.00 AED,5.00,4.9000,0.1000,564768661,1591168,Success,United Arab Emirates,DU UAE,Transguard Group LLC,API User,E6AEAE17361
2022-02-18 09:24,72616565,"34,851.5010","34,846.6010",05.00 AED,5.00,4.9000,0.1000,564768901,72616565,Success,United Arab Emirates,DU UAE,Transguard Group LLC,mohammed.arafath@transguardgroup.com,E6AEAE17361
2022-02-18 09:30,72616807,"34,846.6010","34,841.7010",05.00 AED,5.00,4.9000,0.1000,564769455,1591177,Success,United Arab Emirates,DU UAE,Transguard Group LLC,API User,E6AEAE17361
2022-02-18 09:32,72616889,"34,841.7010","34,836.8010",05.00 AED,5.00,4.9000,0.1000,564769638,1591180,Success,United Arab Emirates,DU UAE,Transguard Group LLC,API User,E6AEAE17361
2022-02-18 09:33,72616921,"34,836.8010","34,827.0010",10.00 AED,10.00,9.8000,0.2000,564769710,1591185,Success,United Arab Emirates,DU UAE,Transguard Group LLC,API User,E6AEAE22430
2022-02-18 09:36,72617040,"34,827.0010","34,822.1010",05.00 AED,5.00,4.9000,0.1000,564770031,1591191,Success,United Arab Emirates,DU UAE,Transguard Group LLC,API User,E6AEAE17361
2022-02-18 09:36,72617046,"34,822.1010","34,817.2010",05.00 AED,5.00,4.9000,0.1000,564770037,1591192,Success,United Arab Emirates,DU UAE,Transguard Group LLC,API User,E6AEAE17361
2022-02-18 09:39,72617158,"34,817.2010","34,797.6010",20.00 AED,20.00,19.6000,0.4000,564770302,1591205,Success,United Arab Emirates,DU UAE,Transguard Group LLC,API User,E6AEAE12938
2022-02-18 09:40,72617179,"34,797.6010","34,792.7010",05.00 AED,5.00,4.9000,0.1000,564770360,1591207,Success,United Arab Emirates,DU UAE,Transguard Group LLC,API User,E6AEAE17361
2022-02-18 09:42,72617243,"34,792.7010","34,782.9010",10.00 AED,10.00,9.8000,0.2000,564770522,1591215,Success,United Arab Emirates,DU UAE,Transguard Group LLC,API User,E6AEAE22430
2022-02-18 09:46,72617398,"34,782.9010","34,778.0010",05.00 AED,5.00,4.9000,0.1000,564770909,1591219,Success,United Arab Emirates,DU UAE,Transguard Group LLC,API User,E6AEAE17361
2022-02-18 09:46,72617433,"34,778.0010","34,773.1010",05.00 AED,5.00,4.9000,0.1000,564770988,1591222,Success,United Arab Emirates,DU UAE,Transguard Group LLC,API User,E6AEAE17361
2022-02-18 09:47,72617461,"34,773.1010","34,753.5010",20.00 AED,20.00,19.6000,0.4000,564771055,72617461,Success,United Arab Emirates,DU UAE,Transguard Group LLC,mohammed.arafath@transguardgroup.com,E6AEAE12938
2022-02-18 09:47,72617476,"34,753.5010","34,748.6010",05.00 AED,5.00,4.9000,0.1000,564771084,1591229,Success,United Arab Emirates,DU UAE,Transguard Group LLC,API User,E6AEAE17361
2022-02-18 09:47,72617477,"34,748.6010","34,738.8010",10.00 AED,10.00,9.8000,0.2000,564771088,1591230,Success,United Arab Emirates,DU UAE,Transguard Group LLC,API User,E6AEAE22430
2022-02-18 09:48,72617501,"34,738.8010","34,733.9010",05.00 AED,5.00,4.9000,0.1000,564771174,1591237,Success,United Arab Emirates,DU UAE,Transguard Group LLC,API User,E6AEAE17361
2022-02-18 09:48,72617505,"34,733.9010","34,729.0010",05.00 AED,5.00,4.9000,0.1000,564771185,1591238,Success,United Arab Emirates,DU UAE,Transguard Group LLC,API User,E6AEAE17361
2022-02-18 09:50,72617548,"34,729.0010","34,719.2010",10.00 AED,10.00,9.8000,0.2000,564771293,1591241,Success,United Arab Emirates,DU UAE,Transguard Group LLC,API User,E6AEAE22430
2022-02-18 09:50,72617577,"34,719.2010","34,709.4010",10.00 AED,10.00,9.8000,0.2000,564771377,1591245,Success,United Arab Emirates,DU UAE,Transguard Group LLC,API User,E6AEAE22430
2022-02-18 09:51,72617617,"34,709.4010","34,704.5010",05.00 AED,5.00,4.9000,0.1000,564771476,1591251,Success,United Arab Emirates,DU UAE,Transguard Group LLC,API User,E6AEAE17361
2022-02-18 09:54,72617727,"34,704.5010","34,699.6010",05.00 AED,5.00,4.9000,0.1000,564771736,1591258,Success,United Arab Emirates,DU UAE,Transguard Group LLC,API User,E6AEAE17361
2022-02-18 09:54,72617731,"34,699.6010","34,684.9010",15.00 AED,15.00,14.7000,0.3000,564771757,72617731,Success,United Arab Emirates,DU UAE,Transguard Group LLC,mohammed.arafath@transguardgroup.com,E6AEAE8527
2022-02-18 09:57,72617803,"34,684.9010","34,675.1010",10.00 AED,10.00,9.8000,0.2000,564771951,1591263,Success,United Arab Emirates,DU UAE,Transguard Group LLC,API User,E6AEAE22430
2022-02-18 10:01,72617964,"34,675.1010","34,671.3610",100.00 NPR,4.25,3.7400,0.5100,564772351,1591271,Success,Nepal,Ncell Nepal,Transguard Group LLC,API User,NP_NC_TopUp_100.00
2022-02-18 10:03,72618027,"34,671.3610","34,661.5610",10.00 AED,10.00,9.8000,0.2000,564772517,1591279,Success,United Arab Emirates,DU UAE,Transguard Group LLC,API User,E6AEAE22430
2022-02-18 10:10,72618302,"34,661.5610","34,656.6610",05.00 AED,5.00,4.9000,0.1000,564773164,1591305,Success,United Arab Emirates,DU UAE,Transguard Group LLC,API User,E6AEAE17361
2022-02-18 10:11,72618312,"34,656.6610","34,651.7610",05.00 AED,5.00,4.9000,0.1000,564773193,1591308,Success,United Arab Emirates,DU UAE,Transguard Group LLC,API User,E6AEAE17361
2022-02-18 10:12,72618384,"34,651.7610","34,641.9610",10.00 AED,10.00,9.8000,0.2000,564773361,1591312,Success,United Arab Emirates,DU UAE,Transguard Group LLC,API User,E6AEAE22430
2022-02-18 10:13,72618408,"34,641.9610","34,637.0610",05.00 AED,5.00,4.9000,0.1000,564773404,1591315,Success,United Arab Emirates,DU UAE,Transguard Group LLC,API User,E6AEAE17361
2022-02-18 10:13,72618427,"34,637.0610","34,632.6610","3,675.41 UGX",5.00,4.4000,0.6000,564773441,1591317,Success,Uganda,MTN Uganda,Transguard Group LLC,API User,UG_MT_TopUp
2022-02-18 10:14,72618453,"34,632.6610","34,622.8610",10.00 AED,10.00,9.8000,0.2000,564773515,1591322,Success,United Arab Emirates,DU UAE,Transguard Group LLC,API User,E6AEAE22430
2022-02-18 10:14,72618463,"34,622.8610","34,617.9610",05.00 AED,5.00,4.9000,0.1000,564773557,1591325,Success,United Arab Emirates,DU UAE,Transguard Group LLC,API User,E6AEAE17361
2022-02-18 10:17,72618593,"34,617.9610","34,613.0610",05.00 AED,5.00,4.9000,0.1000,564773850,1591330,Success,United Arab Emirates,DU UAE,Transguard Group LLC,API User,E6AEAE17361
2022-02-18 10:19,72618649,"34,613.0610","34,608.1610",05.00 AED,5.00,4.9000,0.1000,564773987,1591336,Success,United Arab Emirates,DU UAE,Transguard Group LLC,API User,E6AEAE17361
2022-02-18 10:19,72618665,"34,608.1610","34,598.3610",10.00 AED,10.00,9.8000,0.2000,564774036,1591338,Success,United Arab Emirates,DU UAE,Transguard Group LLC,API User,E6AEAE22430
2022-02-18 10:20,72618699,"34,598.3610","34,588.5610",10.00 AED,10.00,9.8000,0.2000,564774148,1591341,Success,United Arab Emirates,DU UAE,Transguard Group LLC,API User,E6AEAE22430
2022-02-18 10:21,72618747,"34,588.5610","34,578.7610",10.00 AED,10.00,9.8000,0.2000,564774244,1591346,Success,United Arab Emirates,DU UAE,Transguard Group LLC,API User,E6AEAE22430
2022-02-18 10:25,72618889,"34,578.7610","34,568.9610",10.00 AED,10.00,9.8000,0.2000,564774615,1591352,Success,United Arab Emirates,DU UAE,Transguard Group LLC,API User,E6AEAE22430
2022-02-18 10:31,72619117,"34,568.9610","34,564.0610",05.00 AED,5.00,4.9000,0.1000,564775215,1591362,Success,United Arab Emirates,DU UAE,Transguard Group LLC,API User,E6AEAE17361
2022-02-18 10:31,72619118,"34,564.0610","34,559.1610",05.00 AED,5.00,4.9000,0.1000,564775221,1591363,Success,United Arab Emirates,DU UAE,Transguard Group LLC,API User,E6AEAE17361
2022-02-18 10:39,72619398,"34,559.1610","34,549.3610",10.00 AED,10.00,9.8000,0.2000,564775952,1591384,Success,United Arab Emirates,DU UAE,Transguard Group LLC,API User,E6AEAE22430
2022-02-18 10:42,72619516,"34,549.3610","34,539.5610",10.00 AED,10.00,9.8000,0.2000,564776247,1591395,Success,United Arab Emirates,DU UAE,Transguard Group LLC,API User,E6AEAE22430
2022-02-18 10:42,72619540,"34,539.5610","34,534.6610",05.00 AED,5.00,4.9000,0.1000,564776314,1591398,Success,United Arab Emirates,DU UAE,Transguard Group LLC,API User,E6AEAE17361
2022-02-18 10:43,72619571,"34,534.6610","34,529.7610",05.00 AED,5.00,4.9000,0.1000,564776406,1591402,Success,United Arab Emirates,DU UAE,Transguard Group LLC,API User,E6AEAE17361
2022-02-18 10:51,72619832,"34,529.7610","34,524.8610",05.00 AED,5.00,4.9000,0.1000,564777096,1591408,Success,United Arab Emirates,DU UAE,Transguard Group LLC,API User,E6AEAE17361
2022-02-18 11:00,72620157,"34,524.8610","34,519.9610",05.00 AED,5.00,4.9000,0.1000,564777984,1591430,Success,United Arab Emirates,DU UAE,Transguard Group LLC,API User,E6AEAE17361
2022-02-18 11:03,72620279,"34,519.9610","34,512.0410",220.00 NPR,9.00,7.9200,1.0800,564778292,1591437,Success,Nepal,Ncell Nepal,Transguard Group LLC,API User,NCNPNP79518
2022-02-18 11:05,72620323,"34,512.0410","34,507.1410",05.00 AED,5.00,4.9000,0.1000,564778415,1591441,Success,United Arab Emirates,DU UAE,Transguard Group LLC,API User,E6AEAE17361
2022-02-18 11:08,72620449,"34,507.1410","34,502.2410",05.00 AED,5.00,4.9000,0.1000,564778789,1591447,Success,United Arab Emirates,DU UAE,Transguard Group LLC,API User,E6AEAE17361
2022-02-18 11:12,72620584,"34,502.2410","34,492.4410",10.00 AED,10.00,9.8000,0.2000,564779192,1591452,Success,United Arab Emirates,DU UAE,Transguard Group LLC,API User,E6AEAE22430
2022-02-18 11:15,72620681,"34,492.4410","34,487.5410",05.00 AED,5.00,4.9000,0.1000,564779445,1591455,Success,United Arab Emirates,DU UAE,Transguard Group LLC,API User,E6AEAE17361
2022-02-18 11:16,72620721,"34,487.5410","34,482.6410",05.00 AED,5.00,4.9000,0.1000,564779559,1591462,Success,United Arab Emirates,DU UAE,Transguard Group LLC,API User,E6AEAE17361
2022-02-18 11:16,72620736,"34,482.6410","34,472.8410",10.00 AED,10.00,9.8000,0.2000,564779587,1591463,Success,United Arab Emirates,DU UAE,Transguard Group LLC,API User,E6AEAE22430
2022-02-18 11:18,72620807,"34,472.8410","34,463.0410",10.00 AED,10.00,9.8000,0.2000,564779747,1591468,Success,United Arab Emirates,DU UAE,Transguard Group LLC,API User,E6AEAE22430
2022-02-18 11:18,72620813,"34,463.0410","34,458.1410",05.00 AED,5.00,4.9000,0.1000,564779763,1591471,Success,United Arab Emirates,DU UAE,Transguard Group LLC,API User,E6AEAE17361
2022-02-18 11:19,72620836,"34,458.1410","34,449.7810",300.00 PKR,9.50,8.3600,1.1400,564779850,1591474,Success,Pakistan,Jazz Pakistan,Transguard Group LLC,API User,PK_MB_TopUp_300.00
2022-02-18 11:21,72620917,"34,449.7810","34,430.1810",20.00 AED,20.00,19.6000,0.4000,564780060,1591483,Success,United Arab Emirates,DU UAE,Transguard Group LLC,API User,E6AEAE12938
2022-02-18 11:22,72620944,"34,430.1810","34,420.3810",10.00 AED,10.00,9.8000,0.2000,564780135,1591487,Success,United Arab Emirates,DU UAE,Transguard Group LLC,API User,E6AEAE22430
2022-02-18 11:28,72621150,"34,420.3810","34,415.4810",05.00 AED,5.00,4.9000,0.1000,564780635,1591499,Success,United Arab Emirates,DU UAE,Transguard Group LLC,API User,E6AEAE17361
2022-02-18 11:34,72621385,"34,415.4810","34,405.6810",10.00 AED,10.00,9.8000,0.2000,564781222,1591508,Success,United Arab Emirates,DU UAE,Transguard Group LLC,API User,E6AEAE22430
2022-02-18 11:36,72621447,"34,405.6810","34,400.7810",05.00 AED,5.00,4.9000,0.1000,564781451,1591514,Success,United Arab Emirates,DU UAE,Transguard Group LLC,API User,E6AEAE17361
2022-02-18 11:37,72621460,"34,400.7810","34,390.9810",10.00 AED,10.00,9.8000,0.2000,564781498,1591518,Success,United Arab Emirates,DU UAE,Transguard Group LLC,API User,E6AEAE22430
2022-02-18 11:37,72621483,"34,390.9810","34,386.0810",05.00 AED,5.00,4.9000,0.1000,564781570,1591523,Success,United Arab Emirates,DU UAE,Transguard Group LLC,API User,E6AEAE17361
2022-02-18 11:38,72621506,"34,386.0810","34,361.5810",25.00 AED,25.00,24.5000,0.5000,564781638,1591524,Failure,United Arab Emirates,DU UAE,Transguard Group LLC,API User,E6AEAE25659
2022-02-18 11:38,72621506,"34,361.5810","34,337.0810",25.00 AED,25.00,24.5000,0.5000,564781638,1591524,Failure,United Arab Emirates,DU UAE,Transguard Group LLC,API User,E6AEAE25659
2022-02-18 11:39,72621535,"34,386.0810","34,381.1810",05.00 AED,5.00,4.9000,0.1000,564781729,1591528,Success,United Arab Emirates,DU UAE,Transguard Group LLC,API User,E6AEAE17361
2022-02-18 11:41,72621598,"34,381.1810","34,371.3810",10.00 AED,10.00,9.8000,0.2000,564781915,1591532,Success,United Arab Emirates,DU UAE,Transguard Group LLC,API User,E6AEAE22430
2022-02-18 11:46,72621787,"34,371.3810","34,361.5810",10.00 AED,10.00,9.8000,0.2000,564782473,1591539,Success,United Arab Emirates,DU UAE,Transguard Group LLC,API User,E6AEAE22430
2022-02-18 11:47,72621830,"34,361.5810","34,351.7810",10.00 AED,10.00,9.8000,0.2000,564782572,1591546,Success,United Arab Emirates,DU UAE,Transguard Group LLC,API User,E6AEAE22430
2022-02-18 11:52,72621991,"34,351.7810","34,346.8810",05.00 AED,5.00,4.9000,0.1000,564783036,1591552,Success,United Arab Emirates,DU UAE,Transguard Group LLC,API User,E6AEAE17361
2022-02-18 11:55,72622102,"34,346.8810","34,341.9810",05.00 AED,5.00,4.9000,0.1000,564783382,1591555,Success,United Arab Emirates,DU UAE,Transguard Group LLC,API User,E6AEAE17361
2022-02-18 11:57,72622161,"34,341.9810","34,337.0810",05.00 AED,5.00,4.9000,0.1000,564783551,1591558,Success,United Arab Emirates,DU UAE,Transguard Group LLC,API User,E6AEAE17361
2022-02-18 11:59,72622222,"34,337.0810","34,332.1810",05.00 AED,5.00,4.9000,0.1000,564783716,1591565,Success,United Arab Emirates,DU UAE,Transguard Group LLC,API User,E6AEAE17361
2022-02-18 12:00,72622252,"34,332.1810","34,307.6810",25.00 AED,25.00,24.5000,0.5000,564783814,72622252,Failure,United Arab Emirates,DU UAE,Transguard Group LLC,mohammed.arafath@transguardgroup.com,E6AEAE17343
2022-02-18 12:00,72622252,"34,307.6810","34,283.1810",25.00 AED,25.00,24.5000,0.5000,564783814,72622252,Failure,United Arab Emirates,DU UAE,Transguard Group LLC,mohammed.arafath@transguardgroup.com,E6AEAE17343
2022-02-18 12:01,72622284,"34,332.1810","34,312.5810",20.00 AED,20.00,19.6000,0.4000,564783927,72622284,Failure,United Arab Emirates,DU UAE,Transguard Group LLC,mohammed.arafath@transguardgroup.com,E6AEAE12938
2022-02-18 12:01,72622284,"34,312.5810","34,292.9810",20.00 AED,20.00,19.6000,0.4000,564783927,72622284,Failure,United Arab Emirates,DU UAE,Transguard Group LLC,mohammed.arafath@transguardgroup.com,E6AEAE12938
2022-02-18 12:02,72622326,"34,332.1810","34,327.2810",05.00 AED,5.00,4.9000,0.1000,564784056,1591573,Success,United Arab Emirates,DU UAE,Transguard Group LLC,API User,E6AEAE17361
2022-02-18 12:03,72622335,"34,327.2810","34,302.7810",25.00 AED,25.00,24.5000,0.5000,564784096,72622335,Failure,United Arab Emirates,DU UAE,Transguard Group LLC,mohammed.arafath@transguardgroup.com,E6AEAE17343
2022-02-18 12:03,72622335,"34,302.7810","34,278.2810",25.00 AED,25.00,24.5000,0.5000,564784096,72622335,Failure,United Arab Emirates,DU UAE,Transguard Group LLC,mohammed.arafath@transguardgroup.com,E6AEAE17343
2022-02-18 12:04,72622368,"34,327.2810","34,307.6810",20.00 AED,20.00,19.6000,0.4000,564784187,1591576,Success,United Arab Emirates,DU UAE,Transguard Group LLC,API User,E6AEAE12938
2022-02-18 12:05,72622403,"34,307.6810","34,292.9810",15.00 AED,15.00,14.7000,0.3000,564784282,1591582,Success,United Arab Emirates,DU UAE,Transguard Group LLC,API User,E6AEAE8527
2022-02-18 12:05,72622420,"34,292.9810","34,275.6010",299.00 INR,19.75,17.3800,2.3700,564784336,1591586,Success,India,Jio India,Transguard Group LLC,API User,RJININ63150
2022-02-18 12:06,72622448,"34,275.6010","34,265.8010",10.00 AED,10.00,9.8000,0.2000,564784406,1591593,Success,United Arab Emirates,DU UAE,Transguard Group LLC,API User,E6AEAE22430
2022-02-18 12:06,72622451,"34,265.8010","34,260.9010",05.00 AED,5.00,4.9000,0.1000,564784409,1591594,Success,United Arab Emirates,DU UAE,Transguard Group LLC,API User,E6AEAE17361
2022-02-18 12:09,72622547,"34,260.9010","34,251.1010",10.00 AED,10.00,9.8000,0.2000,564784690,1591601,Success,United Arab Emirates,DU UAE,Transguard Group LLC,API User,E6AEAE22430
2022-02-18 12:11,72622627,"34,251.1010","34,241.3010",10.00 AED,10.00,9.8000,0.2000,564784910,1591606,Success,United Arab Emirates,DU UAE,Transguard Group LLC,API User,E6AEAE22430
2022-02-18 12:14,72622742,"34,241.3010","34,236.4010",05.00 AED,5.00,4.9000,0.1000,564785226,1591609,Success,United Arab Emirates,DU UAE,Transguard Group LLC,API User,E6AEAE17361
2022-02-18 12:15,72622772,"34,236.4010","34,231.5010",05.00 AED,5.00,4.9000,0.1000,564785298,1591612,Success,United Arab Emirates,DU UAE,Transguard Group LLC,API User,E6AEAE17361
2022-02-18 12:21,72622981,"34,231.5010","34,226.6010",05.00 AED,5.00,4.9000,0.1000,564785844,1591622,Success,United Arab Emirates,DU UAE,Transguard Group LLC,API User,E6AEAE17361
2022-02-18 12:21,72622986,"34,226.6010","34,221.7010",05.00 AED,5.00,4.9000,0.1000,564785858,1591624,Success,United Arab Emirates,DU UAE,Transguard Group LLC,API User,E6AEAE17361
2022-02-18 12:23,72623052,"34,221.7010","34,216.8010",05.00 AED,5.00,4.9000,0.1000,564786012,1591628,Success,United Arab Emirates,DU UAE,Transguard Group LLC,API User,E6AEAE17361
2022-02-18 12:40,72623702,"34,216.8010","34,208.4410",100.00 PHP,9.50,8.3600,1.1400,564787697,1591656,Success,Philippines,Smart (SunCellular) Philippines,Transguard Group LLC,API User,PH_SM_TopUp_100.00
2022-02-18 12:43,72623835,"34,208.4410","34,198.6410",10.00 AED,10.00,9.8000,0.2000,564788034,1591663,Success,United Arab Emirates,DU UAE,Transguard Group LLC,API User,E6AEAE22430
2022-02-18 12:45,72623903,"34,198.6410","34,188.8410",10.00 AED,10.00,9.8000,0.2000,564788194,1591668,Success,United Arab Emirates,DU UAE,Transguard Group LLC,API User,E6AEAE22430
2022-02-18 12:46,72623906,"34,188.8410","34,183.9410",05.00 AED,5.00,4.9000,0.1000,564788214,1591670,Success,United Arab Emirates,DU UAE,Transguard Group LLC,API User,E6AEAE17361
2022-02-18 12:47,72623954,"34,183.9410","34,174.1410",10.00 AED,10.00,9.8000,0.2000,564788347,1591674,Success,United Arab Emirates,DU UAE,Transguard Group LLC,API User,E6AEAE22430
2022-02-18 12:48,72623984,"34,174.1410","34,164.3410",10.00 AED,10.00,9.8000,0.2000,564788399,1591678,Success,United Arab Emirates,DU UAE,Transguard Group LLC,API User,E6AEAE22430
2022-02-18 12:48,72623991,"34,164.3410","34,154.5410",10.00 AED,10.00,9.8000,0.2000,564788421,1591679,Success,United Arab Emirates,DU UAE,Transguard Group LLC,API User,E6AEAE22430
2022-02-18 12:49,72624033,"34,154.5410","34,149.6410",05.00 AED,5.00,4.9000,0.1000,564788533,1591686,Success,United Arab Emirates,DU UAE,Transguard Group LLC,API User,E6AEAE17361
2022-02-18 12:55,72624227,"34,149.6410","34,139.8410",10.00 AED,10.00,9.8000,0.2000,564789029,1591694,Success,United Arab Emirates,DU UAE,Transguard Group LLC,API User,E6AEAE22430
2022-02-18 12:56,72624258,"34,139.8410","34,134.9410",05.00 AED,5.00,4.9000,0.1000,564789100,1591698,Success,United Arab Emirates,DU UAE,Transguard Group LLC,API User,E6AEAE17361
2022-02-18 12:57,72624299,"34,134.9410","34,130.0410",05.00 AED,5.00,4.9000,0.1000,564789177,1591703,Success,United Arab Emirates,DU UAE,Transguard Group LLC,API User,E6AEAE17361
2022-02-18 12:58,72624337,"34,130.0410","34,120.2410",10.00 AED,10.00,9.8000,0.2000,564789294,1591709,Success,United Arab Emirates,DU UAE,Transguard Group LLC,API User,E6AEAE22430
2022-02-18 13:00,72624379,"34,120.2410","34,115.3410",05.00 AED,5.00,4.9000,0.1000,564789392,1591713,Success,United Arab Emirates,DU UAE,Transguard Group LLC,API User,E6AEAE17361
2022-02-18 13:00,72624401,"34,115.3410","34,110.4410",05.00 AED,5.00,4.9000,0.1000,564789455,1591718,Success,United Arab Emirates,DU UAE,Transguard Group LLC,API User,E6AEAE17361
2022-02-18 13:02,72624451,"34,110.4410","34,105.5410",05.00 AED,5.00,4.9000,0.1000,564789587,1591723,Success,United Arab Emirates,DU UAE,Transguard Group LLC,API User,E6AEAE17361
2022-02-18 13:02,72624479,"34,105.5410","34,100.6410",05.00 AED,5.00,4.9000,0.1000,564789670,1591727,Success,United Arab Emirates,DU UAE,Transguard Group LLC,API User,E6AEAE17361
2022-02-18 13:06,72624621,"34,100.6410","34,090.8410",10.00 AED,10.00,9.8000,0.2000,564789983,1591731,Success,United Arab Emirates,DU UAE,Transguard Group LLC,API User,E6AEAE22430
2022-02-18 13:06,72624649,"34,090.8410","34,085.9410",05.00 AED,5.00,4.9000,0.1000,564790056,1591734,Success,United Arab Emirates,DU UAE,Transguard Group LLC,API User,E6AEAE17361
2022-02-18 13:07,72624679,"34,085.9410","34,081.0410",05.00 AED,5.00,4.9000,0.1000,564790122,1591739,Success,United Arab Emirates,DU UAE,Transguard Group LLC,API User,E6AEAE17361
2022-02-18 13:09,72624758,"34,081.0410","34,071.2410",10.00 AED,10.00,9.8000,0.2000,564790319,1591743,Success,United Arab Emirates,DU UAE,Transguard Group LLC,API User,E6AEAE22430
2022-02-18 13:11,72624846,"34,071.2410","34,051.6410",20.00 AED,20.00,19.6000,0.4000,564790577,1591748,Failure,United Arab Emirates,DU UAE,Transguard Group LLC,API User,E6AEAE12938
2022-02-18 13:11,72624846,"34,051.6410","34,032.0410",20.00 AED,20.00,19.6000,0.4000,564790577,1591748,Failure,United Arab Emirates,DU UAE,Transguard Group LLC,API User,E6AEAE12938
2022-02-18 13:15,72625002,"34,071.2410","34,061.4410",10.00 AED,10.00,9.8000,0.2000,564790940,1591751,Success,United Arab Emirates,DU UAE,Transguard Group LLC,API User,E6AEAE22430
2022-02-18 13:17,72625036,"34,061.4410","34,056.5410",05.00 AED,5.00,4.9000,0.1000,564791055,1591756,Success,United Arab Emirates,DU UAE,Transguard Group LLC,API User,E6AEAE17361
2022-02-18 13:20,72625158,"34,056.5410","34,046.7410",10.00 AED,10.00,9.8000,0.2000,564791396,1591761,Success,United Arab Emirates,DU UAE,Transguard Group LLC,API User,E6AEAE22430
2022-02-18 13:21,72625195,"34,046.7410","34,041.8410",05.00 AED,5.00,4.9000,0.1000,564791494,1591765,Success,United Arab Emirates,DU UAE,Transguard Group LLC,API User,E6AEAE17361
2022-02-18 13:24,72625278,"34,041.8410","34,036.9410",05.00 AED,5.00,4.9000,0.1000,564791710,1591770,Success,United Arab Emirates,DU UAE,Transguard Group LLC,API User,E6AEAE17361
2022-02-18 13:31,72625528,"34,036.9410","34,032.9810",500.00 XAF,4.50,3.9600,0.5400,564792353,1591784,Success,Cameroon,MTN Cameroon,Transguard Group LLC,API User,CM_MT_TopUp_500.00
2022-02-18 13:33,72625607,"34,032.9810","34,008.4810",25.00 AED,25.00,24.5000,0.5000,564792582,72625607,Failure,United Arab Emirates,DU UAE,Transguard Group LLC,mohammed.arafath@transguardgroup.com,E6AEAE17343
2022-02-18 13:33,72625607,"34,008.4810","33,983.9810",25.00 AED,25.00,24.5000,0.5000,564792582,72625607,Failure,United Arab Emirates,DU UAE,Transguard Group LLC,mohammed.arafath@transguardgroup.com,E6AEAE17343
2022-02-18 13:34,72625635,"34,032.9810","34,013.3810",20.00 AED,20.00,19.6000,0.4000,564792642,1591791,Success,United Arab Emirates,DU UAE,Transguard Group LLC,API User,E6AEAE12938
2022-02-18 13:36,72625715,"34,013.3810","34,003.5810",10.00 AED,10.00,9.8000,0.2000,564792887,1591795,Success,United Arab Emirates,DU UAE,Transguard Group LLC,API User,E6AEAE22430
2022-02-18 13:39,72625794,"34,003.5810","33,998.6810",05.00 AED,5.00,4.9000,0.1000,564793110,1591798,Success,United Arab Emirates,DU UAE,Transguard Group LLC,API User,E6AEAE17361
2022-02-18 13:41,72625900,"33,998.6810","33,979.0810",20.00 AED,20.00,19.6000,0.4000,564793419,1591803,Success,United Arab Emirates,DU UAE,Transguard Group LLC,API User,E6AEAE12938
2022-02-18 13:43,72625974,"33,979.0810","33,969.2810",10.00 AED,10.00,9.8000,0.2000,564793583,1591811,Success,United Arab Emirates,DU UAE,Transguard Group LLC,API User,E6AEAE22430
2022-02-18 13:43,72625975,"33,969.2810","33,964.3810",05.00 AED,5.00,4.9000,0.1000,564793584,1591812,Success,United Arab Emirates,DU UAE,Transguard Group LLC,API User,E6AEAE17361
2022-02-18 13:53,72626477,"33,964.3810","33,954.5810",10.00 AED,10.00,9.8000,0.2000,564794824,1591820,Success,United Arab Emirates,DU UAE,Transguard Group LLC,API User,E6AEAE22430
2022-02-18 13:56,72626644,"33,954.5810","33,949.6810",05.00 AED,5.00,4.9000,0.1000,564795229,1591825,Success,United Arab Emirates,DU UAE,Transguard Group LLC,API User,E6AEAE17361
2022-02-18 13:56,72626669,"33,949.6810","33,939.8810",10.00 AED,10.00,9.8000,0.2000,564795303,1591830,Success,United Arab Emirates,DU UAE,Transguard Group LLC,API User,E6AEAE22430
2022-02-18 13:56,72626675,"33,939.8810","33,934.9810",05.00 AED,5.00,4.9000,0.1000,564795314,1591831,Success,United Arab Emirates,DU UAE,Transguard Group LLC,API User,E6AEAE17361
2022-02-18 13:57,72626702,"33,934.9810","33,930.0810",05.00 AED,5.00,4.9000,0.1000,564795387,1591834,Success,United Arab Emirates,DU UAE,Transguard Group LLC,API User,E6AEAE17361
2022-02-18 13:59,72626787,"33,930.0810","33,925.1810",05.00 AED,5.00,4.9000,0.1000,564795622,1591839,Success,United Arab Emirates,DU UAE,Transguard Group LLC,API User,E6AEAE17361
2022-02-18 14:06,72627096,"33,925.1810","33,920.2810",05.00 AED,5.00,4.9000,0.1000,564796471,1591846,Success,United Arab Emirates,DU UAE,Transguard Group LLC,API User,E6AEAE17361
2022-02-18 14:09,72627251,"33,920.2810","33,915.3810",05.00 AED,5.00,4.9000,0.1000,564796859,1591852,Success,United Arab Emirates,DU UAE,Transguard Group LLC,API User,E6AEAE17361
2022-02-18 14:15,72627554,"33,915.3810","33,910.4810",05.00 AED,5.00,4.9000,0.1000,564797695,1591855,Success,United Arab Emirates,DU UAE,Transguard Group LLC,API User,E6AEAE17361
2022-02-18 14:19,72627721,"33,910.4810","33,900.6810",10.00 AED,10.00,9.8000,0.2000,564798071,1591860,Success,United Arab Emirates,DU UAE,Transguard Group LLC,API User,E6AEAE22430
2022-02-18 14:20,72627791,"33,900.6810","33,890.8810",10.00 AED,10.00,9.8000,0.2000,564798264,1591865,Success,United Arab Emirates,DU UAE,Transguard Group LLC,API User,E6AEAE22430
2022-02-18 14:20,72627810,"33,890.8810","33,881.0810",10.00 AED,10.00,9.8000,0.2000,564798315,1591870,Success,United Arab Emirates,DU UAE,Transguard Group LLC,API User,E6AEAE22430
2022-02-18 14:26,72628106,"33,881.0810","33,876.1810",05.00 AED,5.00,4.9000,0.1000,564799071,1591877,Success,United Arab Emirates,DU UAE,Transguard Group LLC,API User,E6AEAE17361
2022-02-18 14:29,72628272,"33,876.1810","33,871.2810",05.00 AED,5.00,4.9000,0.1000,564799499,1591880,Success,United Arab Emirates,DU UAE,Transguard Group LLC,API User,E6AEAE17361
2022-02-18 14:35,72628625,"33,871.2810","33,861.4810",10.00 AED,10.00,9.8000,0.2000,564800426,1591894,Success,United Arab Emirates,DU UAE,Transguard Group LLC,API User,E6AEAE22430
2022-02-18 14:52,72629468,"33,861.4810","33,841.8810",20.00 AED,20.00,19.6000,0.4000,564802626,1591909,Success,United Arab Emirates,DU UAE,Transguard Group LLC,API User,E6AEAE12938
2022-02-18 14:52,72629499,"33,841.8810","33,832.0810",10.00 AED,10.00,9.8000,0.2000,564802730,1591914,Success,United Arab Emirates,DU UAE,Transguard Group LLC,API User,E6AEAE22430
2022-02-18 15:05,72630123,"33,832.0810","33,827.1810",05.00 AED,5.00,4.9000,0.1000,564804536,1591932,Success,United Arab Emirates,DU UAE,Transguard Group LLC,API User,E6AEAE17361
2022-02-18 15:07,72630201,"33,827.1810","33,822.2810",05.00 AED,5.00,4.9000,0.1000,564804823,1591939,Success,United Arab Emirates,DU UAE,Transguard Group LLC,API User,E6AEAE17361
2022-02-18 15:11,72630409,"33,822.2810","33,817.3810",05.00 AED,5.00,4.9000,0.1000,564805381,1591947,Success,United Arab Emirates,DU UAE,Transguard Group LLC,API User,E6AEAE17361
2022-02-18 15:16,72630661,"33,817.3810","33,811.4410",99.00 INR,6.75,5.9400,0.8100,564806086,1591951,Success,India,Airtel India,Transguard Group LLC,API User,AIININ6418
2022-02-18 15:24,72631110,"33,811.4410","33,806.5410",05.00 AED,5.00,4.9000,0.1000,564807281,1591958,Success,United Arab Emirates,DU UAE,Transguard Group LLC,API User,E6AEAE17361
2022-02-18 15:27,72631288,"33,806.5410","33,796.7410",10.00 AED,10.00,9.8000,0.2000,564807795,1591965,Failure,United Arab Emirates,DU UAE,Transguard Group LLC,API User,E6AEAE22430
2022-02-18 15:27,72631288,"33,796.7410","33,786.9410",10.00 AED,10.00,9.8000,0.2000,564807795,1591965,Failure,United Arab Emirates,DU UAE,Transguard Group LLC,API User,E6AEAE22430
2022-02-18 15:36,72631785,"33,806.5410","33,791.8410",15.00 AED,15.00,14.7000,0.3000,564809133,1591979,Success,United Arab Emirates,DU UAE,Transguard Group LLC,API User,E6AEAE8527
2022-02-18 15:42,72632072,"33,791.8410","33,786.9410",05.00 AED,5.00,4.9000,0.1000,564809889,1591986,Success,United Arab Emirates,DU UAE,Transguard Group LLC,API User,E6AEAE17361
2022-02-18 15:55,72632738,"33,786.9410","33,782.0410",05.00 AED,5.00,4.9000,0.1000,564811849,1591991,Success,United Arab Emirates,DU UAE,Transguard Group LLC,API User,E6AEAE17361
2022-02-18 15:56,72632815,"33,782.0410","33,777.1410",05.00 AED,5.00,4.9000,0.1000,564812055,1591996,Success,United Arab Emirates,DU UAE,Transguard Group LLC,API User,E6AEAE17361
2022-02-18 15:56,72632831,"33,777.1410","33,772.9610",150.00 PKR,4.75,4.1800,0.5700,564812117,1591998,Success,Pakistan,Jazz Pakistan,Transguard Group LLC,API User,MBPKPK20699
2022-02-18 15:58,72632906,"33,772.9610","33,753.3610",20.00 AED,20.00,19.6000,0.4000,564812295,1592001,Success,United Arab Emirates,DU UAE,Transguard Group LLC,API User,E6AEAE12938
2022-02-18 16:02,72633136,"33,753.3610","33,748.4610",05.00 AED,5.00,4.9000,0.1000,564812927,1592012,Success,United Arab Emirates,DU UAE,Transguard Group LLC,API User,E6AEAE17361
2022-02-18 16:04,72633259,"33,748.4610","33,743.5610",05.00 AED,5.00,4.9000,0.1000,564813286,1592019,Success,United Arab Emirates,DU UAE,Transguard Group LLC,API User,E6AEAE17361
2022-02-18 16:04,72633263,"33,743.5610","33,733.7610",10.00 AED,10.00,9.8000,0.2000,564813301,1592020,Failure,United Arab Emirates,DU UAE,Transguard Group LLC,API User,E6AEAE22430
2022-02-18 16:04,72633263,"33,733.7610","33,723.9610",10.00 AED,10.00,9.8000,0.2000,564813301,1592020,Failure,United Arab Emirates,DU UAE,Transguard Group LLC,API User,E6AEAE22430
2022-02-18 16:06,72633352,"33,743.5610","33,738.6610",05.00 AED,5.00,4.9000,0.1000,564813520,1592025,Success,United Arab Emirates,DU UAE,Transguard Group LLC,API User,E6AEAE17361
2022-02-18 16:07,72633399,"33,738.6610","33,704.3610",35.00 AED,35.00,34.3000,0.7000,564813650,1592028,Success,United Arab Emirates,DU UAE,Transguard Group LLC,API User,E6AEAE73954
2022-02-18 16:18,72634015,"33,704.3610","33,699.4610",05.00 AED,5.00,4.9000,0.1000,564815386,1592037,Success,United Arab Emirates,DU UAE,Transguard Group LLC,API User,E6AEAE17361
2022-02-18 16:26,72634535,"33,699.4610","33,689.6610",10.00 AED,10.00,9.8000,0.2000,564816758,1592045,Success,United Arab Emirates,DU UAE,Transguard Group LLC,API User,E6AEAE22430
2022-02-18 16:33,72634934,"33,689.6610","33,684.7610",05.00 AED,5.00,4.9000,0.1000,564817893,1592059,Success,United Arab Emirates,DU UAE,Transguard Group LLC,API User,E6AEAE17361
2022-02-18 16:35,72635014,"33,684.7610","33,674.9610",10.00 AED,10.00,9.8000,0.2000,564818098,1592062,Success,United Arab Emirates,DU UAE,Transguard Group LLC,API User,E6AEAE22430
2022-02-18 16:39,72635269,"33,674.9610","33,670.0610",05.00 AED,5.00,4.9000,0.1000,564818819,1592071,Success,United Arab Emirates,DU UAE,Transguard Group LLC,API User,E6AEAE17361
2022-02-18 16:39,72635305,"33,670.0610","33,666.3210",100.00 NPR,4.25,3.7400,0.5100,564818896,1592074,Success,Nepal,Ncell Nepal,Transguard Group LLC,API User,NP_NC_TopUp_100.00
2022-02-18 16:39,72635313,"33,666.3210","33,661.4210",05.00 AED,5.00,4.9000,0.1000,564818922,1592075,Success,United Arab Emirates,DU UAE,Transguard Group LLC,API User,E6AEAE17361
2022-02-18 16:41,72635383,"33,661.4210","33,643.8210",635.00 PKR,20.00,17.6000,2.4000,564819146,1592080,Success,Pakistan,Ufone Pakistan,Transguard Group LLC,API User,UFPKPK67474
2022-02-18 16:41,72635445,"33,643.8210","33,610.8210","1,200.00 PKR",37.50,33.0000,4.5000,564819294,1592084,Success,Pakistan,Ufone Pakistan,Transguard Group LLC,API User,UFPKPK20435
2022-02-18 16:45,72635677,"33,610.8210","33,602.9010",220.00 NPR,9.00,7.9200,1.0800,564819967,1592095,Success,Nepal,Ncell Nepal,Transguard Group LLC,API User,NCNPNP79518
2022-02-18 16:47,72635753,"33,602.9010","33,598.0010",05.00 AED,5.00,4.9000,0.1000,564820176,1592100,Success,United Arab Emirates,DU UAE,Transguard Group LLC,API User,E6AEAE17361
2022-02-18 16:48,72635876,"33,598.0010","33,588.2010",10.00 AED,10.00,9.8000,0.2000,564820444,1592106,Success,United Arab Emirates,DU UAE,Transguard Group LLC,API User,E6AEAE22430
2022-02-18 16:49,72635920,"33,588.2010","33,583.3010",05.00 AED,5.00,4.9000,0.1000,564820545,1592108,Success,United Arab Emirates,DU UAE,Transguard Group LLC,API User,E6AEAE17361
2022-02-18 16:53,72636208,"33,583.3010","33,578.4010",05.00 AED,5.00,4.9000,0.1000,564821345,1592117,Success,United Arab Emirates,DU UAE,Transguard Group LLC,API User,E6AEAE17361
2022-02-18 16:56,72636379,"33,578.4010","33,573.5010",05.00 AED,5.00,4.9000,0.1000,564821793,1592122,Success,United Arab Emirates,DU UAE,Transguard Group LLC,API User,E6AEAE17361
2022-02-18 16:58,72636528,"33,573.5010","33,568.6010",05.00 AED,5.00,4.9000,0.1000,564822150,1592125,Success,United Arab Emirates,DU UAE,Transguard Group LLC,API User,E6AEAE17361
2022-02-18 17:02,72636817,"33,568.6010","33,563.7010",05.00 AED,5.00,4.9000,0.1000,564822886,1592133,Success,United Arab Emirates,DU UAE,Transguard Group LLC,API User,E6AEAE17361
2022-02-18 17:03,72636869,"33,563.7010","33,553.9010",10.00 AED,10.00,9.8000,0.2000,564823014,1592137,Success,United Arab Emirates,DU UAE,Transguard Group LLC,API User,E6AEAE22430
2022-02-18 17:04,72636928,"33,553.9010","33,549.0010",05.00 AED,5.00,4.9000,0.1000,564823189,1592142,Success,United Arab Emirates,DU UAE,Transguard Group LLC,API User,E6AEAE17361
2022-02-18 17:04,72636972,"33,549.0010","33,544.1010",05.00 AED,5.00,4.9000,0.1000,564823305,1592145,Success,United Arab Emirates,DU UAE,Transguard Group LLC,API User,E6AEAE17361
2022-02-18 17:09,72637243,"33,544.1010","33,534.3010",10.00 AED,10.00,9.8000,0.2000,564824068,1592155,Success,United Arab Emirates,DU UAE,Transguard Group LLC,API User,E6AEAE22430
2022-02-18 17:11,72637428,"33,534.3010","33,524.5010",10.00 AED,10.00,9.8000,0.2000,564824568,1592158,Success,United Arab Emirates,DU UAE,Transguard Group LLC,API User,E6AEAE22430
2022-02-18 17:12,72637474,"33,524.5010","33,514.7010",10.00 AED,10.00,9.8000,0.2000,564824705,1592162,Success,United Arab Emirates,DU UAE,Transguard Group LLC,API User,E6AEAE22430
2022-02-18 17:14,72637635,"33,514.7010","33,509.8010",05.00 AED,5.00,4.9000,0.1000,564825157,1592169,Success,United Arab Emirates,DU UAE,Transguard Group LLC,API User,E6AEAE17361
2022-02-18 17:15,72637647,"33,509.8010","33,504.9010",05.00 AED,5.00,4.9000,0.1000,564825191,1592170,Success,United Arab Emirates,DU UAE,Transguard Group LLC,API User,E6AEAE17361
2022-02-18 17:16,72637777,"33,504.9010","33,485.3010",20.00 AED,20.00,19.6000,0.4000,564825545,1592177,Success,United Arab Emirates,DU UAE,Transguard Group LLC,API User,E6AEAE12938
2022-02-18 17:17,72637802,"33,485.3010","33,480.4010",05.00 AED,5.00,4.9000,0.1000,564825622,1592180,Success,United Arab Emirates,DU UAE,Transguard Group LLC,API User,E6AEAE17361
2022-02-18 17:23,72638248,"33,480.4010","33,475.5010",05.00 AED,5.00,4.9000,0.1000,564826860,1592183,Success,United Arab Emirates,DU UAE,Transguard Group LLC,API User,E6AEAE17361
2022-02-18 17:29,72638613,"33,475.5010","33,465.7010",10.00 AED,10.00,9.8000,0.2000,564827849,1592188,Success,United Arab Emirates,DU UAE,Transguard Group LLC,API User,E6AEAE22430
2022-02-18 17:34,72639049,"33,465.7010","33,460.8010",05.00 AED,5.00,4.9000,0.1000,564828998,1592192,Success,United Arab Emirates,DU UAE,Transguard Group LLC,API User,E6AEAE17361
2022-02-18 17:35,72639100,"33,460.8010","33,451.0010",10.00 AED,10.00,9.8000,0.2000,564829119,1592195,Success,United Arab Emirates,DU UAE,Transguard Group LLC,API User,E6AEAE22430
2022-02-18 17:41,72639561,"33,451.0010","33,446.1010",05.00 AED,5.00,4.9000,0.1000,564830337,1592202,Success,United Arab Emirates,DU UAE,Transguard Group LLC,API User,E6AEAE17361
2022-02-18 17:42,72639621,"33,446.1010","33,441.2010",05.00 AED,5.00,4.9000,0.1000,564830490,1592208,Success,United Arab Emirates,DU UAE,Transguard Group LLC,API User,E6AEAE17361
2022-02-18 17:44,72639800,"33,441.2010","33,431.4010",10.00 AED,10.00,9.8000,0.2000,564830939,1592213,Success,United Arab Emirates,DU UAE,Transguard Group LLC,API User,E6AEAE22430
2022-02-18 17:48,72640085,"33,431.4010","33,422.6010",315.00 PKR,10.00,8.8000,1.2000,564831740,1592220,Success,Pakistan,Telenor Pakistan,Transguard Group LLC,API User,TPPKPK75105
2022-02-18 17:54,72640576,"33,422.6010","33,417.7010",05.00 AED,5.00,4.9000,0.1000,564833090,1592227,Success,United Arab Emirates,DU UAE,Transguard Group LLC,API User,E6AEAE17361
2022-02-18 17:56,72640726,"33,417.7010","33,412.8010",05.00 AED,5.00,4.9000,0.1000,564833489,1592236,Success,United Arab Emirates,DU UAE,Transguard Group LLC,API User,E6AEAE17361
2022-02-18 17:57,72640799,"33,412.8010","33,407.9010",05.00 AED,5.00,4.9000,0.1000,564833691,1592239,Success,United Arab Emirates,DU UAE,Transguard Group LLC,API User,E6AEAE17361
2022-02-18 17:58,72640907,"33,407.9010","33,378.5010",30.00 AED,30.00,29.4000,0.6000,564833991,1592246,Success,United Arab Emirates,DU UAE,Transguard Group LLC,API User,E6AEAE46146
2022-02-18 17:58,72640921,"33,378.5010","33,373.6010",05.00 AED,5.00,4.9000,0.1000,564834034,1592248,Success,United Arab Emirates,DU UAE,Transguard Group LLC,API User,E6AEAE17361
2022-02-18 18:01,72641156,"33,373.6010","33,368.7010",05.00 AED,5.00,4.9000,0.1000,564834678,1592254,Success,United Arab Emirates,DU UAE,Transguard Group LLC,API User,E6AEAE17361
2022-02-18 18:02,72641210,"33,368.7010","33,363.8010",05.00 AED,5.00,4.9000,0.1000,564834820,1592257,Success,United Arab Emirates,DU UAE,Transguard Group LLC,API User,E6AEAE17361
2022-02-18 18:07,72641612,"33,363.8010","33,354.0010",10.00 AED,10.00,9.8000,0.2000,564835940,1592264,Success,United Arab Emirates,DU UAE,Transguard Group LLC,API User,E6AEAE22430
2022-02-18 18:08,72641677,"33,354.0010","33,344.2010",10.00 AED,10.00,9.8000,0.2000,564836110,1592267,Success,United Arab Emirates,DU UAE,Transguard Group LLC,API User,E6AEAE22430
2022-02-18 18:09,72641744,"33,344.2010","33,339.3010",05.00 AED,5.00,4.9000,0.1000,564836277,1592270,Success,United Arab Emirates,DU UAE,Transguard Group LLC,API User,E6AEAE17361
2022-02-18 18:09,72641814,"33,339.3010","33,335.5610",151.00 PKR,4.25,3.7400,0.5100,564836461,1592275,Success,Pakistan,Telenor Pakistan,Transguard Group LLC,API User,TPPKPK94108
2022-02-18 18:11,72641972,"33,335.5610","33,330.6610",05.00 AED,5.00,4.9000,0.1000,564836903,1592278,Success,United Arab Emirates,DU UAE,Transguard Group LLC,API User,E6AEAE17361
2022-02-18 18:12,72642047,"33,330.6610","33,325.7610",05.00 AED,5.00,4.9000,0.1000,564837129,1592281,Success,United Arab Emirates,DU UAE,Transguard Group LLC,API User,E6AEAE17361
2022-02-18 18:15,72642231,"33,325.7610","33,315.9610",10.00 AED,10.00,9.8000,0.2000,564837642,1592292,Success,United Arab Emirates,DU UAE,Transguard Group LLC,API User,E6AEAE22430
2022-02-18 18:17,72642394,"33,315.9610","33,306.1610",10.00 AED,10.00,9.8000,0.2000,564838145,1592297,Success,United Arab Emirates,DU UAE,Transguard Group LLC,API User,E6AEAE22430
2022-02-18 18:18,72642566,"33,306.1610","33,276.7610",30.00 AED,30.00,29.4000,0.6000,564838554,1592305,Success,United Arab Emirates,DU UAE,Transguard Group LLC,API User,E6AEAE46146
2022-02-18 18:19,72642681,"33,276.7610","33,266.9610",10.00 AED,10.00,9.8000,0.2000,564838824,1592312,Success,United Arab Emirates,DU UAE,Transguard Group LLC,API User,E6AEAE22430
2022-02-18 18:20,72642744,"33,266.9610","33,247.3610",20.00 AED,20.00,19.6000,0.4000,564838987,1592314,Success,United Arab Emirates,DU UAE,Transguard Group LLC,API User,E6AEAE12938
2022-02-18 18:28,72643431,"33,247.3610","33,242.4610",05.00 AED,5.00,4.9000,0.1000,564840727,1592317,Success,United Arab Emirates,DU UAE,Transguard Group LLC,API User,E6AEAE17361
2022-02-18 18:30,72643594,"33,242.4610","33,237.5610",05.00 AED,5.00,4.9000,0.1000,564841197,1592327,Success,United Arab Emirates,DU UAE,Transguard Group LLC,API User,E6AEAE17361
2022-02-18 18:37,72644145,"33,237.5610","33,232.6610",05.00 AED,5.00,4.9000,0.1000,564842799,1592339,Success,United Arab Emirates,DU UAE,Transguard Group LLC,API User,E6AEAE17361
2022-02-18 18:38,72644269,"33,232.6610","33,227.7610",05.00 AED,5.00,4.9000,0.1000,564843142,1592344,Success,United Arab Emirates,DU UAE,Transguard Group LLC,API User,E6AEAE17361
2022-02-18 18:47,72645020,"33,227.7610","33,222.8610",05.00 AED,5.00,4.9000,0.1000,564845175,1592353,Success,United Arab Emirates,DU UAE,Transguard Group LLC,API User,E6AEAE17361
2022-02-18 18:54,72645751,"33,222.8610","33,203.2610",20.00 AED,20.00,19.6000,0.4000,564847123,1592367,Success,United Arab Emirates,DU UAE,Transguard Group LLC,API User,E6AEAE12938
2022-02-18 18:56,72645892,"33,203.2610","33,198.3610",05.00 AED,5.00,4.9000,0.1000,564847488,1592375,Success,United Arab Emirates,DU UAE,Transguard Group LLC,API User,E6AEAE17361
2022-02-18 18:57,72645935,"33,198.3610","33,193.4610",05.00 AED,5.00,4.9000,0.1000,564847607,1592377,Success,United Arab Emirates,DU UAE,Transguard Group LLC,API User,E6AEAE17361
2022-02-18 18:58,72646044,"33,193.4610","33,171.6810",800.00 PKR,24.75,21.7800,2.9700,564847869,1592380,Success,Pakistan,Zong Pakistan,Transguard Group LLC,API User,ZNPKPK8195
2022-02-18 19:05,72646948,"33,171.6810","33,167.9410",100.00 NPR,4.25,3.7400,0.5100,564849983,1592391,Success,Nepal,Nepal Telecom Nepal,Transguard Group LLC,API User,NP_NE_TopUp_100.00
2022-02-18 19:06,72647070,"33,167.9410","33,163.0410",05.00 AED,5.00,4.9000,0.1000,564850255,1592396,Success,United Arab Emirates,DU UAE,Transguard Group LLC,API User,E6AEAE17361
2022-02-18 19:10,72647482,"33,163.0410","33,158.1410",05.00 AED,5.00,4.9000,0.1000,564851157,1592412,Success,United Arab Emirates,DU UAE,Transguard Group LLC,API User,E6AEAE17361
2022-02-18 19:11,72647532,"33,158.1410","33,118.9410",40.00 AED,40.00,39.2000,0.8000,564851287,1592414,Success,United Arab Emirates,DU UAE,Transguard Group LLC,API User,E6AEAE64011
2022-02-18 19:11,72647579,"33,118.9410","33,114.0410",05.00 AED,5.00,4.9000,0.1000,564851422,1592417,Success,United Arab Emirates,DU UAE,Transguard Group LLC,API User,E6AEAE17361
2022-02-18 19:11,72647605,"33,114.0410","33,109.1410",05.00 AED,5.00,4.9000,0.1000,564851484,1592419,Success,United Arab Emirates,DU UAE,Transguard Group LLC,API User,E6AEAE17361
2022-02-18 19:12,72647634,"33,109.1410","33,089.5410",20.00 AED,20.00,19.6000,0.4000,564851553,1592422,Success,United Arab Emirates,DU UAE,Transguard Group LLC,API User,E6AEAE12938
2022-02-18 19:12,72647660,"33,089.5410","33,074.8410",15.00 AED,15.00,14.7000,0.3000,564851621,1592423,Success,United Arab Emirates,DU UAE,Transguard Group LLC,API User,E6AEAE8527
2022-02-18 19:13,72647835,"33,074.8410","33,069.9410",05.00 AED,5.00,4.9000,0.1000,564852047,1592430,Success,United Arab Emirates,DU UAE,Transguard Group LLC,API User,E6AEAE17361
2022-02-18 19:14,72647908,"33,069.9410","33,065.0410",05.00 AED,5.00,4.9000,0.1000,564852222,1592434,Success,United Arab Emirates,DU UAE,Transguard Group LLC,API User,E6AEAE17361
2022-02-18 19:17,72648137,"33,065.0410","33,050.3410",15.00 AED,15.00,14.7000,0.3000,564852828,1592439,Success,United Arab Emirates,DU UAE,Transguard Group LLC,API User,E6AEAE8527
2022-02-18 19:19,72648326,"33,050.3410","33,045.4410",05.00 AED,5.00,4.9000,0.1000,564853361,1592446,Success,United Arab Emirates,DU UAE,Transguard Group LLC,API User,E6AEAE17361
2022-02-18 19:21,72648521,"33,045.4410","33,001.4410","36,679.00 UGX",50.00,44.0000,6.0000,564853927,1592451,Success,Uganda,Airtel Uganda,Transguard Group LLC,API User,UG_WA_TopUp
2022-02-18 19:24,72648808,"33,001.4410","32,991.6410",10.00 AED,10.00,9.8000,0.2000,564854608,1592459,Success,United Arab Emirates,DU UAE,Transguard Group LLC,API User,E6AEAE22430
2022-02-18 19:24,72648865,"32,991.6410","32,981.8410",10.00 AED,10.00,9.8000,0.2000,564854745,1592465,Success,United Arab Emirates,DU UAE,Transguard Group LLC,API User,E6AEAE22430
2022-02-18 19:24,72648872,"32,981.8410","32,976.9410",05.00 AED,5.00,4.9000,0.1000,564854762,1592466,Success,United Arab Emirates,DU UAE,Transguard Group LLC,API User,E6AEAE17361
2022-02-18 19:25,72648880,"32,976.9410","32,972.0410",05.00 AED,5.00,4.9000,0.1000,564854792,1592467,Success,United Arab Emirates,DU UAE,Transguard Group LLC,API User,E6AEAE17361
2022-02-18 19:26,72649015,"32,972.0410","32,928.0410","36,679.00 UGX",50.00,44.0000,6.0000,564855150,1592475,Success,Uganda,Airtel Uganda,Transguard Group LLC,API User,UG_WA_TopUp
2022-02-18 19:26,72649042,"32,928.0410","32,923.1410",05.00 AED,5.00,4.9000,0.1000,564855202,1592477,Success,United Arab Emirates,DU UAE,Transguard Group LLC,API User,E6AEAE17361
2022-02-18 19:27,72649127,"32,923.1410","32,913.3410",10.00 AED,10.00,9.8000,0.2000,564855434,1592480,Success,United Arab Emirates,DU UAE,Transguard Group LLC,API User,E6AEAE22430
2022-02-18 19:28,72649208,"32,913.3410","32,903.5410",10.00 AED,10.00,9.8000,0.2000,564855675,1592485,Success,United Arab Emirates,DU UAE,Transguard Group LLC,API User,E6AEAE22430
2022-02-18 19:29,72649309,"32,903.5410","32,898.6410",05.00 AED,5.00,4.9000,0.1000,564855920,1592490,Success,United Arab Emirates,DU UAE,Transguard Group LLC,API User,E6AEAE17361
2022-02-18 19:30,72649433,"32,898.6410","32,893.7410",05.00 AED,5.00,4.9000,0.1000,564856267,1592495,Success,United Arab Emirates,DU UAE,Transguard Group LLC,API User,E6AEAE17361
2022-02-18 19:47,72651009,"32,893.7410","32,879.0410",15.00 AED,15.00,14.7000,0.3000,564860550,1592518,Success,United Arab Emirates,DU UAE,Transguard Group LLC,API User,E6AEAE8527
2022-02-18 19:48,72651166,"32,879.0410","32,862.1010",470.00 NPR,19.25,16.9400,2.3100,564860980,1592526,Success,Nepal,Ncell Nepal,Transguard Group LLC,API User,NCNPNP37643
2022-02-18 19:50,72651292,"32,862.1010","32,852.3010",10.00 AED,10.00,9.8000,0.2000,564861337,1592532,Success,United Arab Emirates,DU UAE,Transguard Group LLC,API User,E6AEAE22430
2022-02-18 19:50,72651336,"32,852.3010","32,847.4010",05.00 AED,5.00,4.9000,0.1000,564861429,1592534,Success,United Arab Emirates,DU UAE,Transguard Group LLC,API User,E6AEAE17361
2022-02-18 19:54,72651712,"32,847.4010","32,842.5010",05.00 AED,5.00,4.9000,0.1000,564862393,1592547,Success,United Arab Emirates,DU UAE,Transguard Group LLC,API User,E6AEAE17361
2022-02-18 19:55,72651726,"32,842.5010","32,832.7010",10.00 AED,10.00,9.8000,0.2000,564862435,1592548,Success,United Arab Emirates,DU UAE,Transguard Group LLC,API User,E6AEAE22430
2022-02-18 19:55,72651786,"32,832.7010","32,827.8010",05.00 AED,5.00,4.9000,0.1000,564862599,1592551,Success,United Arab Emirates,DU UAE,Transguard Group LLC,API User,E6AEAE17361
2022-02-18 19:57,72651986,"32,827.8010","32,823.6210",150.00 PKR,4.75,4.1800,0.5700,564863104,1592554,Success,Pakistan,Zong Pakistan,Transguard Group LLC,API User,ZNPKPK65621
2022-02-18 20:00,72652260,"32,823.6210","32,818.7210",05.00 AED,5.00,4.9000,0.1000,564863788,1592560,Success,United Arab Emirates,DU UAE,Transguard Group LLC,API User,E6AEAE17361
2022-02-18 20:01,72652399,"32,818.7210","32,813.8210",05.00 AED,5.00,4.9000,0.1000,564864160,1592566,Success,United Arab Emirates,DU UAE,Transguard Group LLC,API User,E6AEAE17361
2022-02-18 20:03,72652511,"32,813.8210","32,810.0810",151.00 PKR,4.25,3.7400,0.5100,564864464,1592576,Success,Pakistan,Telenor Pakistan,Transguard Group LLC,API User,TPPKPK94108
2022-02-18 20:05,72652686,"32,810.0810","32,782.5810","1,000.00 PKR",31.25,27.5000,3.7500,564864952,1592580,Success,Pakistan,Ufone Pakistan,Transguard Group LLC,API User,PK_UF_TopUp_1000.00
2022-02-18 20:05,72652762,"32,782.5810","32,772.7810",10.00 AED,10.00,9.8000,0.2000,564865129,1592583,Success,United Arab Emirates,DU UAE,Transguard Group LLC,API User,E6AEAE22430
2022-02-18 20:06,72652849,"32,772.7810","32,767.8810",05.00 AED,5.00,4.9000,0.1000,564865372,1592588,Success,United Arab Emirates,DU UAE,Transguard Group LLC,API User,E6AEAE17361
2022-02-18 20:06,72652875,"32,767.8810","32,762.9810",05.00 AED,5.00,4.9000,0.1000,564865437,1592591,Success,United Arab Emirates,DU UAE,Transguard Group LLC,API User,E6AEAE17361
2022-02-18 20:06,72652884,"32,762.9810","32,758.0810",05.00 AED,5.00,4.9000,0.1000,564865442,1592592,Success,United Arab Emirates,DU UAE,Transguard Group LLC,API User,E6AEAE17361
2022-02-18 20:08,72653033,"32,758.0810","32,753.1810",05.00 AED,5.00,4.9000,0.1000,564865809,1592595,Success,United Arab Emirates,DU UAE,Transguard Group LLC,API User,E6AEAE17361
2022-02-18 20:09,72653154,"32,753.1810","32,748.2810",05.00 AED,5.00,4.9000,0.1000,564866172,1592600,Success,United Arab Emirates,DU UAE,Transguard Group LLC,API User,E6AEAE17361
2022-02-18 20:09,72653157,"32,748.2810","32,743.3810",05.00 AED,5.00,4.9000,0.1000,564866186,1592601,Success,United Arab Emirates,DU UAE,Transguard Group LLC,API User,E6AEAE17361
2022-02-18 20:13,72653480,"32,743.3810","32,738.4810",05.00 AED,5.00,4.9000,0.1000,564867048,1592609,Success,United Arab Emirates,DU UAE,Transguard Group LLC,API User,E6AEAE17361
2022-02-18 20:15,72653695,"32,738.4810","32,718.8810",20.00 AED,20.00,19.6000,0.4000,564867594,1592626,Success,United Arab Emirates,DU UAE,Transguard Group LLC,API User,E6AEAE12938
2022-02-18 20:15,72653697,"32,718.8810","32,713.9810",05.00 AED,5.00,4.9000,0.1000,564867596,1592627,Success,United Arab Emirates,DU UAE,Transguard Group LLC,API User,E6AEAE17361
2022-02-18 20:15,72653781,"32,713.9810","32,684.5810",30.00 AED,30.00,29.4000,0.6000,564867819,1592632,Success,United Arab Emirates,DU UAE,Transguard Group LLC,API User,E6AEAE46146
2022-02-18 20:17,72653942,"32,684.5810","32,674.7810",10.00 AED,10.00,9.8000,0.2000,564868285,1592641,Success,United Arab Emirates,DU UAE,Transguard Group LLC,API User,E6AEAE22430
2022-02-18 20:19,72654083,"32,674.7810","32,669.8810",05.00 AED,5.00,4.9000,0.1000,564868690,1592649,Success,United Arab Emirates,DU UAE,Transguard Group LLC,API User,E6AEAE17361
2022-02-18 20:19,72654126,"32,669.8810","32,664.9810",05.00 AED,5.00,4.9000,0.1000,564868808,1592651,Success,United Arab Emirates,DU UAE,Transguard Group LLC,API User,E6AEAE17361
2022-02-18 20:20,72654158,"32,664.9810","32,660.0810",05.00 AED,5.00,4.9000,0.1000,564868897,1592655,Success,United Arab Emirates,DU UAE,Transguard Group LLC,API User,E6AEAE17361
2022-02-18 20:25,72654610,"32,660.0810","32,655.1810",05.00 AED,5.00,4.9000,0.1000,564870145,1592663,Success,United Arab Emirates,DU UAE,Transguard Group LLC,API User,E6AEAE17361
2022-02-18 20:27,72654786,"32,655.1810","32,645.3810",10.00 AED,10.00,9.8000,0.2000,564870579,1592674,Success,United Arab Emirates,DU UAE,Transguard Group LLC,API User,E6AEAE22430
2022-02-18 20:27,72654813,"32,645.3810","32,635.5810",10.00 AED,10.00,9.8000,0.2000,564870676,1592679,Success,United Arab Emirates,DU UAE,Transguard Group LLC,API User,E6AEAE22430
2022-02-18 20:27,72654844,"32,635.5810","32,630.6810",05.00 AED,5.00,4.9000,0.1000,564870739,1592683,Success,United Arab Emirates,DU UAE,Transguard Group LLC,API User,E6AEAE17361
2022-02-18 20:27,72654847,"32,630.6810","32,611.0810",20.00 AED,20.00,19.6000,0.4000,564870743,1592684,Success,United Arab Emirates,DU UAE,Transguard Group LLC,API User,E6AEAE12938
2022-02-18 20:27,72654858,"32,611.0810","32,601.2810",10.00 AED,10.00,9.8000,0.2000,564870775,1592687,Success,United Arab Emirates,DU UAE,Transguard Group LLC,API User,E6AEAE22430
2022-02-18 20:27,72654866,"32,601.2810","32,596.3810",05.00 AED,5.00,4.9000,0.1000,564870795,1592688,Success,United Arab Emirates,DU UAE,Transguard Group LLC,API User,E6AEAE17361
2022-02-18 20:29,72655055,"32,596.3810","32,591.4810",05.00 AED,5.00,4.9000,0.1000,564871249,1592694,Success,United Arab Emirates,DU UAE,Transguard Group LLC,API User,E6AEAE17361
2022-02-18 20:31,72655181,"32,591.4810","32,586.5810",05.00 AED,5.00,4.9000,0.1000,564871632,1592701,Success,United Arab Emirates,DU UAE,Transguard Group LLC,API User,E6AEAE17361
2022-02-18 20:32,72655268,"32,586.5810","32,581.6810",05.00 AED,5.00,4.9000,0.1000,564871861,1592707,Success,United Arab Emirates,DU UAE,Transguard Group LLC,API User,E6AEAE17361
2022-02-18 20:32,72655275,"32,581.6810","32,576.7810",05.00 AED,5.00,4.9000,0.1000,564871876,1592708,Success,United Arab Emirates,DU UAE,Transguard Group LLC,API User,E6AEAE17361
2022-02-18 20:33,72655382,"32,576.7810","32,571.8810",05.00 AED,5.00,4.9000,0.1000,564872163,1592712,Success,United Arab Emirates,DU UAE,Transguard Group LLC,API User,E6AEAE17361
2022-02-18 20:34,72655503,"32,571.8810","32,562.0810",10.00 AED,10.00,9.8000,0.2000,564872514,1592719,Success,United Arab Emirates,DU UAE,Transguard Group LLC,API User,E6AEAE22430
2022-02-18 20:35,72655549,"32,562.0810","32,552.2810",10.00 AED,10.00,9.8000,0.2000,564872685,1592723,Success,United Arab Emirates,DU UAE,Transguard Group LLC,API User,E6AEAE22430
2022-02-18 20:40,72655974,"32,552.2810","32,542.4810",10.00 AED,10.00,9.8000,0.2000,564873945,1592734,Success,United Arab Emirates,DU UAE,Transguard Group LLC,API User,E6AEAE22430
2022-02-18 20:40,72655996,"32,542.4810","32,532.6810",10.00 AED,10.00,9.8000,0.2000,564874011,1592736,Success,United Arab Emirates,DU UAE,Transguard Group LLC,API User,E6AEAE22430
2022-02-18 20:43,72656205,"32,532.6810","32,522.8810",10.00 AED,10.00,9.8000,0.2000,564874621,1592741,Success,United Arab Emirates,DU UAE,Transguard Group LLC,API User,E6AEAE22430
2022-02-18 20:43,72656231,"32,522.8810","32,517.9810",05.00 AED,5.00,4.9000,0.1000,564874698,1592743,Success,United Arab Emirates,DU UAE,Transguard Group LLC,API User,E6AEAE17361
2022-02-18 20:43,72656270,"32,517.9810","32,498.3810",20.00 AED,20.00,19.6000,0.4000,564874833,1592748,Success,United Arab Emirates,DU UAE,Transguard Group LLC,API User,E6AEAE12938
2022-02-18 20:44,72656326,"32,498.3810","32,493.4810",05.00 AED,5.00,4.9000,0.1000,564874973,1592757,Success,United Arab Emirates,DU UAE,Transguard Group LLC,API User,E6AEAE17361
2022-02-18 20:45,72656401,"32,493.4810","32,488.5810",05.00 AED,5.00,4.9000,0.1000,564875178,1592764,Success,United Arab Emirates,DU UAE,Transguard Group LLC,API User,E6AEAE17361
2022-02-18 20:47,72656619,"32,488.5810","32,483.6810",05.00 AED,5.00,4.9000,0.1000,564875784,1592768,Success,United Arab Emirates,DU UAE,Transguard Group LLC,API User,E6AEAE17361
2022-02-18 20:50,72656834,"32,483.6810","32,478.7810",05.00 AED,5.00,4.9000,0.1000,564876372,1592773,Success,United Arab Emirates,DU UAE,Transguard Group LLC,API User,E6AEAE17361
2022-02-18 20:54,72657255,"32,478.7810","32,473.8810",05.00 AED,5.00,4.9000,0.1000,564877474,1592782,Success,United Arab Emirates,DU UAE,Transguard Group LLC,API User,E6AEAE17361
2022-02-18 20:55,72657348,"32,473.8810","32,464.0810",10.00 AED,10.00,9.8000,0.2000,564877757,1592787,Success,United Arab Emirates,DU UAE,Transguard Group LLC,API User,E6AEAE22430
2022-02-18 20:58,72657575,"32,464.0810","32,459.1810",05.00 AED,5.00,4.9000,0.1000,564878222,1592792,Failure,United Arab Emirates,DU UAE,Transguard Group LLC,API User,E6AEAE17361
2022-02-18 20:58,72657575,"32,459.1810","32,454.2810",05.00 AED,5.00,4.9000,0.1000,564878222,1592792,Failure,United Arab Emirates,DU UAE,Transguard Group LLC,API User,E6AEAE17361
2022-02-18 21:00,72657706,"32,464.0810","32,459.1810",05.00 AED,5.00,4.9000,0.1000,564878767,1592800,Success,United Arab Emirates,DU UAE,Transguard Group LLC,API User,E6AEAE17361
2022-02-18 21:06,72658224,"32,459.1810","32,449.3810",10.00 AED,10.00,9.8000,0.2000,564880231,1592809,Success,United Arab Emirates,DU UAE,Transguard Group LLC,API User,E6AEAE22430
2022-02-18 21:08,72658451,"32,449.3810","32,444.4810",05.00 AED,5.00,4.9000,0.1000,564880834,1592814,Success,United Arab Emirates,DU UAE,Transguard Group LLC,API User,E6AEAE17361
2022-02-18 21:09,72658564,"32,444.4810","32,439.5810",05.00 AED,5.00,4.9000,0.1000,564881116,1592817,Success,United Arab Emirates,DU UAE,Transguard Group LLC,API User,E6AEAE17361
2022-02-18 21:11,72658691,"32,439.5810","32,429.7810",10.00 AED,10.00,9.8000,0.2000,564881438,1592823,Success,United Arab Emirates,DU UAE,Transguard Group LLC,API User,E6AEAE22430
2022-02-18 21:11,72658749,"32,429.7810","32,419.9810",10.00 AED,10.00,9.8000,0.2000,564881580,1592828,Success,United Arab Emirates,DU UAE,Transguard Group LLC,API User,E6AEAE22430
2022-02-18 21:12,72658866,"32,419.9810","32,410.1810",10.00 AED,10.00,9.8000,0.2000,564881870,1592834,Success,United Arab Emirates,DU UAE,Transguard Group LLC,API User,E6AEAE22430
2022-02-18 21:14,72658996,"32,410.1810","32,405.2810",05.00 AED,5.00,4.9000,0.1000,564882239,1592837,Success,United Arab Emirates,DU UAE,Transguard Group LLC,API User,E6AEAE17361
2022-02-18 21:15,72659062,"32,405.2810","32,400.3810",05.00 AED,5.00,4.9000,0.1000,564882399,1592840,Success,United Arab Emirates,DU UAE,Transguard Group LLC,API User,E6AEAE17361
2022-02-18 21:17,72659273,"32,400.3810","32,395.4810",05.00 AED,5.00,4.9000,0.1000,564882990,1592843,Success,United Arab Emirates,DU UAE,Transguard Group LLC,API User,E6AEAE17361
2022-02-18 21:17,72659302,"32,395.4810","32,385.6810",10.00 AED,10.00,9.8000,0.2000,564883085,1592846,Success,United Arab Emirates,DU UAE,Transguard Group LLC,API User,E6AEAE22430
2022-02-18 21:18,72659351,"32,385.6810","32,380.7810",05.00 AED,5.00,4.9000,0.1000,564883219,1592851,Success,United Arab Emirates,DU UAE,Transguard Group LLC,API User,E6AEAE17361
2022-02-18 21:18,72659357,"32,380.7810","32,375.8810",05.00 AED,5.00,4.9000,0.1000,564883227,1592852,Success,United Arab Emirates,DU UAE,Transguard Group LLC,API User,E6AEAE17361
2022-02-18 21:19,72659438,"32,375.8810","32,370.9810",05.00 AED,5.00,4.9000,0.1000,564883458,1592855,Success,United Arab Emirates,DU UAE,Transguard Group LLC,API User,E6AEAE17361
2022-02-18 21:26,72660040,"32,370.9810","32,361.1810",10.00 AED,10.00,9.8000,0.2000,564885158,1592868,Success,United Arab Emirates,DU UAE,Transguard Group LLC,API User,E6AEAE22430
2022-02-18 21:38,72661013,"32,361.1810","32,356.2810",05.00 AED,5.00,4.9000,0.1000,564887894,1592881,Success,United Arab Emirates,DU UAE,Transguard Group LLC,API User,E6AEAE17361
2022-02-18 21:39,72661081,"32,356.2810","32,351.3810",05.00 AED,5.00,4.9000,0.1000,564888105,1592886,Success,United Arab Emirates,DU UAE,Transguard Group LLC,API User,E6AEAE17361
2022-02-18 21:39,72661108,"32,351.3810","32,347.2010",150.00 PKR,4.75,4.1800,0.5700,564888202,1592889,Success,Pakistan,Jazz Pakistan,Transguard Group LLC,API User,MBPKPK20699
2022-02-18 21:41,72661209,"32,347.2010","32,337.4010",10.00 AED,10.00,9.8000,0.2000,564888490,1592892,Success,United Arab Emirates,DU UAE,Transguard Group LLC,API User,E6AEAE22430
2022-02-18 21:42,72661312,"32,337.4010","32,332.5010",05.00 AED,5.00,4.9000,0.1000,564888781,1592898,Success,United Arab Emirates,DU UAE,Transguard Group LLC,API User,E6AEAE17361
2022-02-18 21:42,72661328,"32,332.5010","32,322.7010",10.00 AED,10.00,9.8000,0.2000,564888837,1592900,Success,United Arab Emirates,DU UAE,Transguard Group LLC,API User,E6AEAE22430
2022-02-18 21:42,72661330,"32,322.7010","32,312.9010",10.00 AED,10.00,9.8000,0.2000,564888838,1592901,Success,United Arab Emirates,DU UAE,Transguard Group LLC,API User,E6AEAE22430
2022-02-18 21:44,72661500,"32,312.9010","32,308.0010",05.00 AED,5.00,4.9000,0.1000,564889293,1592909,Success,United Arab Emirates,DU UAE,Transguard Group LLC,API User,E6AEAE17361
2022-02-18 21:49,72661858,"32,308.0010","32,298.2010",10.00 AED,10.00,9.8000,0.2000,564890353,1592920,Success,United Arab Emirates,DU UAE,Transguard Group LLC,API User,E6AEAE22430
2022-02-18 21:53,72662158,"32,298.2010","32,293.3010",05.00 AED,5.00,4.9000,0.1000,564891255,1592926,Success,United Arab Emirates,DU UAE,Transguard Group LLC,API User,E6AEAE17361
2022-02-18 21:53,72662210,"32,293.3010","32,277.2410",575.00 PKR,18.25,16.0600,2.1900,564891395,1592928,Success,Pakistan,Jazz Pakistan,Transguard Group LLC,API User,MBPKPK68304
2022-02-18 21:55,72662305,"32,277.2410","32,267.4410",10.00 AED,10.00,9.8000,0.2000,564891699,1592931,Success,United Arab Emirates,DU UAE,Transguard Group LLC,API User,E6AEAE22430
2022-02-18 21:55,72662339,"32,267.4410","32,262.5410",05.00 AED,5.00,4.9000,0.1000,564891796,1592934,Success,United Arab Emirates,DU UAE,Transguard Group LLC,API User,E6AEAE17361
2022-02-18 21:56,72662415,"32,262.5410","32,257.6410",05.00 AED,5.00,4.9000,0.1000,564892024,1592939,Success,United Arab Emirates,DU UAE,Transguard Group LLC,API User,E6AEAE17361
2022-02-18 21:57,72662432,"32,257.6410","32,247.8410",10.00 AED,10.00,9.8000,0.2000,564892055,1592940,Success,United Arab Emirates,DU UAE,Transguard Group LLC,API User,E6AEAE22430
2022-02-18 21:57,72662491,"32,247.8410","32,238.0410",10.00 AED,10.00,9.8000,0.2000,564892209,1592944,Success,United Arab Emirates,DU UAE,Transguard Group LLC,API User,E6AEAE22430
2022-02-18 21:58,72662516,"32,238.0410","32,230.1210",220.00 NPR,9.00,7.9200,1.0800,564892299,1592946,Success,Nepal,Ncell Nepal,Transguard Group LLC,API User,NCNPNP79518
2022-02-18 21:58,72662566,"32,230.1210","32,225.2210",05.00 AED,5.00,4.9000,0.1000,564892434,1592949,Success,United Arab Emirates,DU UAE,Transguard Group LLC,API User,E6AEAE17361
2022-02-18 22:04,72663013,"32,225.2210","32,217.0810",300.00 PKR,9.25,8.1400,1.1100,564893718,1592959,Failure,Pakistan,Zong Pakistan,Transguard Group LLC,API User,ZNPKPK70504
2022-02-18 22:04,72663013,"32,217.0810","32,208.9410",300.00 PKR,9.25,8.1400,1.1100,564893718,1592959,Failure,Pakistan,Zong Pakistan,Transguard Group LLC,API User,ZNPKPK70504
2022-02-18 22:05,72663071,"32,225.2210","32,220.3210",05.00 AED,5.00,4.9000,0.1000,564893878,1592965,Success,United Arab Emirates,DU UAE,Transguard Group LLC,API User,E6AEAE17361
2022-02-18 22:05,72663076,"32,220.3210","32,200.7210",20.00 AED,20.00,19.6000,0.4000,564893903,1592967,Success,United Arab Emirates,DU UAE,Transguard Group LLC,API User,E6AEAE12938
2022-02-18 22:05,72663082,"32,200.7210","32,195.8210",05.00 AED,5.00,4.9000,0.1000,564893930,1592968,Success,United Arab Emirates,DU UAE,Transguard Group LLC,API User,E6AEAE17361
2022-02-18 22:07,72663224,"32,195.8210","32,187.4610",300.00 PKR,9.50,8.3600,1.1400,564894380,1592975,Success,Pakistan,Jazz Pakistan,Transguard Group LLC,API User,PK_MB_TopUp_300.00
2022-02-18 22:09,72663418,"32,187.4610","32,182.5610",05.00 AED,5.00,4.9000,0.1000,564894948,1592983,Success,United Arab Emirates,DU UAE,Transguard Group LLC,API User,E6AEAE17361
2022-02-18 22:15,72663839,"32,182.5610","32,177.6610",05.00 AED,5.00,4.9000,0.1000,564896132,1592996,Success,United Arab Emirates,DU UAE,Transguard Group LLC,API User,E6AEAE17361
2022-02-18 22:18,72664067,"32,177.6610","32,172.7610",05.00 AED,5.00,4.9000,0.1000,564896782,1593004,Success,United Arab Emirates,DU UAE,Transguard Group LLC,API User,E6AEAE17361
2022-02-18 22:18,72664088,"32,172.7610","32,162.9610",10.00 AED,10.00,9.8000,0.2000,564896836,1593006,Success,United Arab Emirates,DU UAE,Transguard Group LLC,API User,E6AEAE22430
2022-02-18 22:24,72664491,"32,162.9610","32,158.0610",05.00 AED,5.00,4.9000,0.1000,564897976,1593012,Success,United Arab Emirates,DU UAE,Transguard Group LLC,API User,E6AEAE17361
2022-02-18 22:25,72664590,"32,158.0610","32,148.2610",10.00 AED,10.00,9.8000,0.2000,564898287,1593015,Success,United Arab Emirates,DU UAE,Transguard Group LLC,API User,E6AEAE22430
2022-02-18 22:29,72664802,"32,148.2610","32,143.3610",05.00 AED,5.00,4.9000,0.1000,564898921,1593022,Success,United Arab Emirates,DU UAE,Transguard Group LLC,API User,E6AEAE17361
2022-02-18 22:29,72664844,"32,143.3610","32,138.4610",05.00 AED,5.00,4.9000,0.1000,564899030,1593025,Success,United Arab Emirates,DU UAE,Transguard Group LLC,API User,E6AEAE17361
2022-02-18 22:36,72665338,"32,138.4610","32,133.5610",05.00 AED,5.00,4.9000,0.1000,564900414,1593030,Success,United Arab Emirates,DU UAE,Transguard Group LLC,API User,E6AEAE17361
2022-02-18 22:36,72665379,"32,133.5610","32,128.6610",05.00 AED,5.00,4.9000,0.1000,564900530,1593033,Success,United Arab Emirates,DU UAE,Transguard Group LLC,API User,E6AEAE17361
2022-02-18 22:43,72665810,"32,128.6610","32,118.8610",10.00 AED,10.00,9.8000,0.2000,564901871,1593042,Success,United Arab Emirates,DU UAE,Transguard Group LLC,API User,E6AEAE22430
2022-02-18 22:56,72666624,"32,118.8610","32,109.0610",10.00 AED,10.00,9.8000,0.2000,564904423,1593046,Success,United Arab Emirates,DU UAE,Transguard Group LLC,API User,E6AEAE22430
2022-02-18 23:05,72667178,"32,109.0610","32,104.1610",05.00 AED,5.00,4.9000,0.1000,564906090,1593055,Success,United Arab Emirates,DU UAE,Transguard Group LLC,API User,E6AEAE17361
2022-02-18 23:09,72667379,"32,104.1610","32,094.3610",10.00 AED,10.00,9.8000,0.2000,564906802,1593058,Success,United Arab Emirates,DU UAE,Transguard Group LLC,API User,E6AEAE22430
2022-02-18 23:17,72667799,"32,094.3610","32,084.5610",10.00 AED,10.00,9.8000,0.2000,564908203,1593061,Success,United Arab Emirates,DU UAE,Transguard Group LLC,API User,E6AEAE22430
2022-02-18 23:20,72667995,"32,084.5610","32,079.6610",05.00 AED,5.00,4.9000,0.1000,564908812,1593064,Success,United Arab Emirates,DU UAE,Transguard Group LLC,API User,E6AEAE17361
2022-02-18 23:21,72668056,"32,079.6610","32,074.7610",05.00 AED,5.00,4.9000,0.1000,564908990,1593067,Success,United Arab Emirates,DU UAE,Transguard Group LLC,API User,E6AEAE17361
2022-02-18 23:22,72668074,"32,074.7610","32,069.8610",05.00 AED,5.00,4.9000,0.1000,564909044,1593071,Success,United Arab Emirates,DU UAE,Transguard Group LLC,API User,E6AEAE17361
2022-02-18 23:22,72668111,"32,069.8610","32,064.9610",05.00 AED,5.00,4.9000,0.1000,564909143,1593075,Success,United Arab Emirates,DU UAE,Transguard Group LLC,API User,E6AEAE17361
2022-02-18 23:25,72668308,"32,064.9610","32,060.0610",05.00 AED,5.00,4.9000,0.1000,564909713,1593078,Success,United Arab Emirates,DU UAE,Transguard Group LLC,API User,E6AEAE17361
2022-02-18 23:27,72668370,"32,060.0610","32,055.1610",05.00 AED,5.00,4.9000,0.1000,564909935,1593081,Success,United Arab Emirates,DU UAE,Transguard Group LLC,API User,E6AEAE17361
2022-02-18 23:29,72668502,"32,055.1610","32,050.2610",05.00 AED,5.00,4.9000,0.1000,564910335,1593088,Failure,United Arab Emirates,DU UAE,Transguard Group LLC,API User,E6AEAE17361
2022-02-18 23:29,72668502,"32,050.2610","32,045.3610",05.00 AED,5.00,4.9000,0.1000,564910335,1593088,Failure,United Arab Emirates,DU UAE,Transguard Group LLC,API User,E6AEAE17361
2022-02-18 23:34,72668783,"32,055.1610","32,050.2610",05.00 AED,5.00,4.9000,0.1000,564911332,1593091,Success,United Arab Emirates,DU UAE,Transguard Group LLC,API User,E6AEAE17361
2022-02-18 23:36,72668837,"32,050.2610","32,045.3610",05.00 AED,5.00,4.9000,0.1000,564911589,1593096,Success,United Arab Emirates,DU UAE,Transguard Group LLC,API User,E6AEAE17361
2022-02-18 23:37,72668888,"32,045.3610","32,035.5610",10.00 AED,10.00,9.8000,0.2000,564911776,1593097,Success,United Arab Emirates,DU UAE,Transguard Group LLC,API User,E6AEAE22430
2022-02-18 23:39,72669026,"32,035.5610","32,027.4210",300.00 PKR,9.25,8.1400,1.1100,564912228,1593104,Success,Pakistan,Zong Pakistan,Transguard Group LLC,API User,ZNPKPK70504
2022-02-18 23:41,72669135,"32,027.4210","32,022.5210",05.00 AED,5.00,4.9000,0.1000,564912606,1593110,Success,United Arab Emirates,DU UAE,Transguard Group LLC,API User,E6AEAE17361
2022-02-18 23:41,72669145,"32,022.5210","32,017.6210",05.00 AED,5.00,4.9000,0.1000,564912650,1593112,Success,United Arab Emirates,DU UAE,Transguard Group LLC,API User,E6AEAE17361
2022-02-18 23:49,72669499,"32,017.6210","32,013.8810",151.00 PKR,4.25,3.7400,0.5100,564913834,1593115,Success,Pakistan,Telenor Pakistan,Transguard Group LLC,API User,TPPKPK94108
2022-02-19 00:20,72671003,"32,013.8810","32,004.0810",10.00 AED,10.00,9.8000,0.2000,564918746,1593121,Success,United Arab Emirates,DU UAE,Transguard Group LLC,API User,E6AEAE22430
2022-02-19 00:38,72671908,"32,004.0810","31,994.2810",10.00 AED,10.00,9.8000,0.2000,564921632,1593126,Success,United Arab Emirates,DU UAE,Transguard Group LLC,API User,E6AEAE22430
2022-02-19 00:43,72672143,"31,994.2810","31,974.6810",20.00 AED,20.00,19.6000,0.4000,564922397,1593129,Success,United Arab Emirates,DU UAE,Transguard Group LLC,API User,E6AEAE12938
2022-02-19 00:54,72672612,"31,974.6810","31,969.7810",05.00 AED,5.00,4.9000,0.1000,564923938,1593134,Success,United Arab Emirates,DU UAE,Transguard Group LLC,API User,E6AEAE17361
2022-02-19 00:55,72672701,"31,969.7810","31,964.8810",05.00 AED,5.00,4.9000,0.1000,564924222,1593138,Success,United Arab Emirates,DU UAE,Transguard Group LLC,API User,E6AEAE17361
2022-02-19 01:19,72673785,"31,964.8810","31,959.9810",05.00 AED,5.00,4.9000,0.1000,564927780,1593151,Success,United Arab Emirates,DU UAE,Transguard Group LLC,API User,E6AEAE17361
2022-02-19 01:37,72674609,"31,959.9810","31,951.8410",99.00 PHP,9.25,8.1400,1.1100,564930494,1593160,Success,Philippines,Smart (SunCellular) Philippines,Transguard Group LLC,API User,SMPHPH2618
2022-02-19 01:52,72675251,"31,951.8410","31,942.0410",10.00 AED,10.00,9.8000,0.2000,564932621,1593171,Success,United Arab Emirates,DU UAE,Transguard Group LLC,API User,E6AEAE22430
2022-02-19 02:01,72675718,"31,942.0410","31,922.4410",20.00 AED,20.00,19.6000,0.4000,564934032,1593174,Success,United Arab Emirates,DU UAE,Transguard Group LLC,API User,E6AEAE12938
2022-02-19 02:13,72676295,"31,922.4410","31,912.6410",10.00 AED,10.00,9.8000,0.2000,564935971,1593178,Success,United Arab Emirates,DU UAE,Transguard Group LLC,API User,E6AEAE22430
2022-02-19 02:30,72677160,"31,912.6410","31,907.7410",05.00 AED,5.00,4.9000,0.1000,564938523,1593185,Success,United Arab Emirates,DU UAE,Transguard Group LLC,API User,E6AEAE17361
2022-02-19 02:38,72677577,"31,907.7410","31,897.9410",10.00 AED,10.00,9.8000,0.2000,564939826,1593188,Success,United Arab Emirates,DU UAE,Transguard Group LLC,API User,E6AEAE22430
2022-02-19 03:12,72679326,"31,897.9410","31,893.0410",05.00 AED,5.00,4.9000,0.1000,564945415,1593198,Success,United Arab Emirates,DU UAE,Transguard Group LLC,API User,E6AEAE17361
2022-02-19 04:26,72683400,"31,893.0410","31,883.2410",10.00 AED,10.00,9.8000,0.2000,564957643,1593213,Success,United Arab Emirates,DU UAE,Transguard Group LLC,API User,E6AEAE22430
2022-02-19 04:41,72684196,"31,883.2410","31,878.3410",05.00 AED,5.00,4.9000,0.1000,564959967,1593222,Success,United Arab Emirates,DU UAE,Transguard Group LLC,API User,E6AEAE17361
2022-02-19 04:44,72684355,"31,878.3410","31,873.4410",05.00 AED,5.00,4.9000,0.1000,564960373,1593227,Success,United Arab Emirates,DU UAE,Transguard Group LLC,API User,E6AEAE17361
2022-02-19 04:51,72684742,"31,873.4410","31,868.5410",05.00 AED,5.00,4.9000,0.1000,564961483,1593230,Success,United Arab Emirates,DU UAE,Transguard Group LLC,API User,E6AEAE17361
2022-02-19 04:52,72684798,"31,868.5410","31,863.6410",05.00 AED,5.00,4.9000,0.1000,564961645,1593234,Success,United Arab Emirates,DU UAE,Transguard Group LLC,API User,E6AEAE17361
2022-02-19 04:53,72684819,"31,863.6410","31,858.7410",05.00 AED,5.00,4.9000,0.1000,564961718,1593236,Success,United Arab Emirates,DU UAE,Transguard Group LLC,API User,E6AEAE17361
2022-02-19 05:01,72685323,"31,858.7410","31,853.8410",05.00 AED,5.00,4.9000,0.1000,564963052,1593247,Success,United Arab Emirates,DU UAE,Transguard Group LLC,API User,E6AEAE17361
2022-02-19 05:03,72685384,"31,853.8410","31,848.9410",05.00 AED,5.00,4.9000,0.1000,564963206,1593250,Success,United Arab Emirates,DU UAE,Transguard Group LLC,API User,E6AEAE17361
2022-02-19 05:04,72685461,"31,848.9410","31,839.1410",10.00 AED,10.00,9.8000,0.2000,564963381,1593253,Success,United Arab Emirates,DU UAE,Transguard Group LLC,API User,E6AEAE22430
2022-02-19 05:07,72685629,"31,839.1410","31,829.3410",10.00 AED,10.00,9.8000,0.2000,564963833,1593257,Success,United Arab Emirates,DU UAE,Transguard Group LLC,API User,E6AEAE22430
2022-02-19 05:09,72685748,"31,829.3410","31,819.5410",10.00 AED,10.00,9.8000,0.2000,564964130,1593263,Success,United Arab Emirates,DU UAE,Transguard Group LLC,API User,E6AEAE22430
2022-02-19 05:14,72686024,"31,819.5410","31,814.6410",05.00 AED,5.00,4.9000,0.1000,564964797,1593266,Success,United Arab Emirates,DU UAE,Transguard Group LLC,API User,E6AEAE17361
2022-02-19 05:15,72686092,"31,814.6410","31,809.7410",05.00 AED,5.00,4.9000,0.1000,564964969,1593269,Success,United Arab Emirates,DU UAE,Transguard Group LLC,API User,E6AEAE17361
2022-02-19 05:16,72686156,"31,809.7410","31,799.9410",10.00 AED,10.00,9.8000,0.2000,564965131,1593274,Success,United Arab Emirates,DU UAE,Transguard Group LLC,API User,E6AEAE22430
2022-02-19 05:17,72686180,"31,799.9410","31,796.2010",98.00 NPR,4.25,3.7400,0.5100,564965199,1593277,Success,Nepal,Ncell Nepal,Transguard Group LLC,API User,NCNPNP3715
2022-02-19 05:18,72686247,"31,796.2010","31,791.3010",05.00 AED,5.00,4.9000,0.1000,564965362,1593280,Success,United Arab Emirates,DU UAE,Transguard Group LLC,API User,E6AEAE17361
2022-02-19 05:24,72686679,"31,791.3010","31,752.1010",40.00 AED,40.00,39.2000,0.8000,564966320,1593287,Success,United Arab Emirates,DU UAE,Transguard Group LLC,API User,E6AEAE64011
2022-02-19 05:26,72686788,"31,752.1010","31,747.2010",05.00 AED,5.00,4.9000,0.1000,564966634,1593290,Success,United Arab Emirates,DU UAE,Transguard Group LLC,API User,E6AEAE17361
2022-02-19 05:28,72686865,"31,747.2010","31,742.3010",05.00 AED,5.00,4.9000,0.1000,564966802,1593293,Success,United Arab Emirates,DU UAE,Transguard Group LLC,API User,E6AEAE17361
2022-02-19 05:29,72686980,"31,742.3010","31,738.1210",150.00 PKR,4.75,4.1800,0.5700,564967064,1593296,Success,Pakistan,Ufone Pakistan,Transguard Group LLC,API User,UFPKPK90336
2022-02-19 05:51,72688285,"31,738.1210","31,733.2210",05.00 AED,5.00,4.9000,0.1000,564970133,1593309,Success,United Arab Emirates,DU UAE,Transguard Group LLC,API User,E6AEAE17361
2022-02-19 05:55,72688494,"31,733.2210","31,728.3210",05.00 AED,5.00,4.9000,0.1000,564970614,1593318,Success,United Arab Emirates,DU UAE,Transguard Group LLC,API User,E6AEAE17361
2022-02-19 05:58,72688703,"31,728.3210","31,723.4210",05.00 AED,5.00,4.9000,0.1000,564971093,1593322,Success,United Arab Emirates,DU UAE,Transguard Group LLC,API User,E6AEAE17361
2022-02-19 05:59,72688763,"31,723.4210","31,718.5210",05.00 AED,5.00,4.9000,0.1000,564971212,1593327,Success,United Arab Emirates,DU UAE,Transguard Group LLC,API User,E6AEAE17361
2022-02-19 06:01,72688857,"31,718.5210","31,713.6210",05.00 AED,5.00,4.9000,0.1000,564971412,1593330,Success,United Arab Emirates,DU UAE,Transguard Group LLC,API User,E6AEAE17361
2022-02-19 06:05,72689108,"31,713.6210","31,706.3610",200.00 NPR,8.25,7.2600,0.9900,564971985,1593338,Success,Nepal,Nepal Telecom Nepal,Transguard Group LLC,API User,NP_NE_TopUp_200.00
2022-02-19 06:11,72689445,"31,706.3610","31,686.7610",20.00 AED,20.00,19.6000,0.4000,564972714,1593348,Success,United Arab Emirates,DU UAE,Transguard Group LLC,API User,E6AEAE12938
2022-02-19 06:21,72690008,"31,686.7610","31,681.8610",05.00 AED,5.00,4.9000,0.1000,564973991,1593355,Success,United Arab Emirates,DU UAE,Transguard Group LLC,API User,E6AEAE17361
2022-02-19 06:25,72690239,"31,681.8610","31,676.9610",05.00 AED,5.00,4.9000,0.1000,564974527,1593366,Success,United Arab Emirates,DU UAE,Transguard Group LLC,API User,E6AEAE17361
2022-02-19 06:28,72690410,"31,676.9610","31,672.0610",05.00 AED,5.00,4.9000,0.1000,564974926,1593372,Success,United Arab Emirates,DU UAE,Transguard Group LLC,API User,E6AEAE17361
2022-02-19 06:29,72690443,"31,672.0610","31,662.2610",10.00 AED,10.00,9.8000,0.2000,564974995,1593374,Success,United Arab Emirates,DU UAE,Transguard Group LLC,API User,E6AEAE22430
2022-02-19 06:32,72690606,"31,662.2610","31,657.3610",05.00 AED,5.00,4.9000,0.1000,564975348,1593381,Success,United Arab Emirates,DU UAE,Transguard Group LLC,API User,E6AEAE17361
2022-02-19 06:34,72690730,"31,657.3610","31,647.5610",10.00 AED,10.00,9.8000,0.2000,564975613,1593387,Success,United Arab Emirates,DU UAE,Transguard Group LLC,API User,E6AEAE22430
2022-02-19 06:35,72690789,"31,647.5610","31,641.6210",99.00 INR,6.75,5.9400,0.8100,564975745,1593390,Success,India,Airtel India,Transguard Group LLC,API User,AIININ6418
2022-02-19 06:39,72691002,"31,641.6210","31,636.7210",05.00 AED,5.00,4.9000,0.1000,564976222,1593396,Success,United Arab Emirates,DU UAE,Transguard Group LLC,API User,E6AEAE17361
2022-02-19 06:41,72691133,"31,636.7210","31,626.9210",10.00 AED,10.00,9.8000,0.2000,564976528,1593404,Success,United Arab Emirates,DU UAE,Transguard Group LLC,API User,E6AEAE22430
2022-02-19 06:42,72691167,"31,626.9210","31,592.6210",35.00 AED,35.00,34.3000,0.7000,564976605,1593407,Success,United Arab Emirates,DU UAE,Transguard Group LLC,API User,E6AEAE73954
2022-02-19 06:44,72691247,"31,592.6210","31,587.7210",05.00 AED,5.00,4.9000,0.1000,564976844,1593412,Success,United Arab Emirates,DU UAE,Transguard Group LLC,API User,E6AEAE17361
2022-02-19 06:45,72691298,"31,587.7210","31,577.9210",10.00 AED,10.00,9.8000,0.2000,564976960,1593417,Success,United Arab Emirates,DU UAE,Transguard Group LLC,API User,E6AEAE22430
2022-02-19 06:45,72691301,"31,577.9210","31,569.5610",300.00 PKR,9.50,8.3600,1.1400,564976962,1593418,Success,Pakistan,Jazz Pakistan,Transguard Group LLC,API User,PK_MB_TopUp_300.00
2022-02-19 06:46,72691380,"31,569.5610","31,549.9610",20.00 AED,20.00,19.6000,0.4000,564977150,1593421,Success,United Arab Emirates,DU UAE,Transguard Group LLC,API User,E6AEAE12938
2022-02-19 06:47,72691406,"31,549.9610","31,545.7810",150.00 PKR,4.75,4.1800,0.5700,564977215,1593424,Success,Pakistan,Jazz Pakistan,Transguard Group LLC,API User,MBPKPK20699
2022-02-19 06:51,72691617,"31,545.7810","31,535.9810",10.00 AED,10.00,9.8000,0.2000,564977684,1593429,Success,United Arab Emirates,DU UAE,Transguard Group LLC,API User,E6AEAE22430
2022-02-19 06:58,72692027,"31,535.9810","31,526.1810",10.00 AED,10.00,9.8000,0.2000,564978558,1593442,Success,United Arab Emirates,DU UAE,Transguard Group LLC,API User,E6AEAE22430
2022-02-19 06:59,72692096,"31,526.1810","31,516.3810",10.00 AED,10.00,9.8000,0.2000,564978723,1593449,Success,United Arab Emirates,DU UAE,Transguard Group LLC,API User,E6AEAE22430
2022-02-19 07:01,72692184,"31,516.3810","31,511.4810",05.00 AED,5.00,4.9000,0.1000,564978943,1593455,Success,United Arab Emirates,DU UAE,Transguard Group LLC,API User,E6AEAE17361
2022-02-19 07:02,72692226,"31,511.4810","31,506.5810",05.00 AED,5.00,4.9000,0.1000,564979050,1593460,Success,United Arab Emirates,DU UAE,Transguard Group LLC,API User,E6AEAE17361
2022-02-19 07:08,72692523,"31,506.5810","31,501.6810",05.00 AED,5.00,4.9000,0.1000,564979747,1593471,Success,United Arab Emirates,DU UAE,Transguard Group LLC,API User,E6AEAE17361
2022-02-19 07:22,72693204,"31,501.6810","31,484.0810",313.00 INR,20.00,17.6000,2.4000,564981322,1593488,Success,India,Tata Sky DTH India,Transguard Group LLC,API User,IN_1S_IN_TopUp
2022-02-19 07:23,72693260,"31,484.0810","31,479.1810",05.00 AED,5.00,4.9000,0.1000,564981477,1593494,Success,United Arab Emirates,DU UAE,Transguard Group LLC,API User,E6AEAE17361
2022-02-19 07:24,72693326,"31,479.1810","31,461.5810",301.00 INR,20.00,17.6000,2.4000,564981616,1593497,Success,India,Jio India,Transguard Group LLC,API User,RJININ16042
2022-02-19 07:25,72693338,"31,461.5810","31,457.4010",150.00 PKR,4.75,4.1800,0.5700,564981644,1593499,Success,Pakistan,Zong Pakistan,Transguard Group LLC,API User,ZNPKPK65621
2022-02-19 07:26,72693419,"31,457.4010","31,428.0010",30.00 AED,30.00,29.4000,0.6000,564981812,1593502,Success,United Arab Emirates,DU UAE,Transguard Group LLC,API User,E6AEAE46146
2022-02-19 07:27,72693452,"31,428.0010","31,398.6010",30.00 AED,30.00,29.4000,0.6000,564981905,1593505,Success,United Arab Emirates,DU UAE,Transguard Group LLC,API User,E6AEAE46146
2022-02-19 07:33,72693733,"31,398.6010","31,393.7010",05.00 AED,5.00,4.9000,0.1000,564982547,1593520,Success,United Arab Emirates,DU UAE,Transguard Group LLC,API User,E6AEAE17361
2022-02-19 07:40,72694075,"31,393.7010","31,388.8010",05.00 AED,5.00,4.9000,0.1000,564983366,1593532,Success,United Arab Emirates,DU UAE,Transguard Group LLC,API User,E6AEAE17361
2022-02-19 07:42,72694153,"31,388.8010","31,383.9010",05.00 AED,5.00,4.9000,0.1000,564983574,1593542,Success,United Arab Emirates,DU UAE,Transguard Group LLC,API User,E6AEAE17361
2022-02-19 07:43,72694163,"31,383.9010","31,379.0010",05.00 AED,5.00,4.9000,0.1000,564983596,1593544,Success,United Arab Emirates,DU UAE,Transguard Group LLC,API User,E6AEAE17361
2022-02-19 07:45,72694284,"31,379.0010","31,374.1010",05.00 AED,5.00,4.9000,0.1000,564983873,1593550,Success,United Arab Emirates,DU UAE,Transguard Group LLC,API User,E6AEAE17361
2022-02-19 07:51,72694537,"31,374.1010","31,369.2010",05.00 AED,5.00,4.9000,0.1000,564984513,1593554,Success,United Arab Emirates,DU UAE,Transguard Group LLC,API User,E6AEAE17361
2022-02-19 07:55,72694716,"31,369.2010","31,364.3010",05.00 AED,5.00,4.9000,0.1000,564984972,1593560,Success,United Arab Emirates,DU UAE,Transguard Group LLC,API User,E6AEAE17361
2022-02-19 07:56,72694730,"31,364.3010","31,359.4010",05.00 AED,5.00,4.9000,0.1000,564985000,1593562,Success,United Arab Emirates,DU UAE,Transguard Group LLC,API User,E6AEAE17361
2022-02-19 07:58,72694851,"31,359.4010","31,354.5010",05.00 AED,5.00,4.9000,0.1000,564985267,1593570,Success,United Arab Emirates,DU UAE,Transguard Group LLC,API User,E6AEAE17361
2022-02-19 08:03,72695039,"31,354.5010","31,349.6010",05.00 AED,5.00,4.9000,0.1000,564985724,1593573,Success,United Arab Emirates,DU UAE,Transguard Group LLC,API User,E6AEAE17361
2022-02-19 08:07,72695206,"31,349.6010","31,344.7010",05.00 AED,5.00,4.9000,0.1000,564986131,1593584,Success,United Arab Emirates,DU UAE,Transguard Group LLC,API User,E6AEAE17361
2022-02-19 08:08,72695223,"31,344.7010","31,320.2010",25.00 AED,25.00,24.5000,0.5000,564986170,1593587,Success,United Arab Emirates,DU UAE,Transguard Group LLC,API User,E6AEAE17343
2022-02-19 08:10,72695344,"31,320.2010","31,315.3010",05.00 AED,5.00,4.9000,0.1000,564986460,1593594,Success,United Arab Emirates,DU UAE,Transguard Group LLC,API User,E6AEAE17361
2022-02-19 08:14,72695478,"31,315.3010","31,310.4010",05.00 AED,5.00,4.9000,0.1000,564986774,1593599,Success,United Arab Emirates,DU UAE,Transguard Group LLC,API User,E6AEAE17361
2022-02-19 08:17,72695648,"31,310.4010","31,300.6010",10.00 AED,10.00,9.8000,0.2000,564987164,1593610,Failure,United Arab Emirates,DU UAE,Transguard Group LLC,API User,E6AEAE22430
2022-02-19 08:17,72695648,"31,300.6010","31,290.8010",10.00 AED,10.00,9.8000,0.2000,564987164,1593610,Failure,United Arab Emirates,DU UAE,Transguard Group LLC,API User,E6AEAE22430
2022-02-19 08:18,72695674,"31,310.4010","31,305.5010",05.00 AED,5.00,4.9000,0.1000,564987232,1593613,Success,United Arab Emirates,DU UAE,Transguard Group LLC,API User,E6AEAE17361
2022-02-19 08:19,72695736,"31,305.5010","31,300.6010",05.00 AED,5.00,4.9000,0.1000,564987374,1593622,Success,United Arab Emirates,DU UAE,Transguard Group LLC,API User,E6AEAE17361
2022-02-19 08:21,72695791,"31,300.6010","31,295.7010",05.00 AED,5.00,4.9000,0.1000,564987513,1593627,Success,United Arab Emirates,DU UAE,Transguard Group LLC,API User,E6AEAE17361
2022-02-19 08:21,72695827,"31,295.7010","31,290.8010",05.00 AED,5.00,4.9000,0.1000,564987572,1593630,Success,United Arab Emirates,DU UAE,Transguard Group LLC,API User,E6AEAE17361
2022-02-19 08:22,72695863,"31,290.8010","31,285.9010",05.00 AED,5.00,4.9000,0.1000,564987653,1593633,Success,United Arab Emirates,DU UAE,Transguard Group LLC,API User,E6AEAE17361
2022-02-19 08:27,72696043,"31,285.9010","31,281.0010",05.00 AED,5.00,4.9000,0.1000,564988098,1593639,Success,United Arab Emirates,DU UAE,Transguard Group LLC,API User,E6AEAE17361
2022-02-19 08:27,72696071,"31,281.0010","31,271.2010",10.00 AED,10.00,9.8000,0.2000,564988157,1593642,Success,United Arab Emirates,DU UAE,Transguard Group LLC,API User,E6AEAE22430
2022-02-19 08:28,72696129,"31,271.2010","31,266.3010",05.00 AED,5.00,4.9000,0.1000,564988272,1593645,Success,United Arab Emirates,DU UAE,Transguard Group LLC,API User,E6AEAE17361
2022-02-19 08:33,72696333,"31,266.3010","31,261.4010",05.00 AED,5.00,4.9000,0.1000,564988732,1593654,Success,United Arab Emirates,DU UAE,Transguard Group LLC,API User,E6AEAE17361
2022-02-19 08:34,72696374,"31,261.4010","31,241.8010",20.00 AED,20.00,19.6000,0.4000,564988829,1593659,Success,United Arab Emirates,DU UAE,Transguard Group LLC,API User,E6AEAE12938
2022-02-19 08:35,72696432,"31,241.8010","31,236.9010",05.00 AED,5.00,4.9000,0.1000,564988936,1593662,Success,United Arab Emirates,DU UAE,Transguard Group LLC,API User,E6AEAE17361
2022-02-19 08:37,72696531,"31,236.9010","31,233.1610",100.00 NPR,4.25,3.7400,0.5100,564989161,1593667,Success,Nepal,Ncell Nepal,Transguard Group LLC,API User,NP_NC_TopUp_100.00
2022-02-19 08:38,72696561,"31,233.1610","31,208.6610",25.00 AED,25.00,24.5000,0.5000,564989246,72696561,Failure,United Arab Emirates,DU UAE,Transguard Group LLC,mohammed.arafath@transguardgroup.com,E6AEAE17343
2022-02-19 08:38,72696561,"31,208.6610","31,184.1610",25.00 AED,25.00,24.5000,0.5000,564989246,72696561,Failure,United Arab Emirates,DU UAE,Transguard Group LLC,mohammed.arafath@transguardgroup.com,E6AEAE17343
2022-02-19 08:41,72696674,"31,233.1610","31,223.3610",10.00 AED,10.00,9.8000,0.2000,564989522,1593674,Success,United Arab Emirates,DU UAE,Transguard Group LLC,API User,E6AEAE22430
2022-02-19 08:43,72696746,"31,223.3610","31,218.4610",05.00 AED,5.00,4.9000,0.1000,564989702,1593684,Success,United Arab Emirates,DU UAE,Transguard Group LLC,API User,E6AEAE17361
2022-02-19 08:44,72696826,"31,218.4610","31,213.5360",05.00 AED,5.00,4.9250,0.0750,564989909,72696826,Success,United Arab Emirates,Etisalat UAE,Transguard Group LLC,mohammed.arafath@transguardgroup.com,ETAEAE54031
2022-02-19 08:45,72696863,"31,213.5360","31,203.7360",10.00 AED,10.00,9.8000,0.2000,564989992,1593689,Success,United Arab Emirates,DU UAE,Transguard Group LLC,API User,E6AEAE22430
2022-02-19 08:46,72696897,"31,203.7360","31,193.8860",10.00 AED,10.00,9.8500,0.1500,564990059,72696897,Success,United Arab Emirates,Etisalat UAE,Transguard Group LLC,mohammed.arafath@transguardgroup.com,ETAEAE95904
2022-02-19 08:54,72697199,"31,193.8860","31,149.7860",45.00 AED,45.00,44.1000,0.9000,564990795,1593701,Success,United Arab Emirates,DU UAE,Transguard Group LLC,API User,E6AEAE35243
2022-02-19 08:58,72697325,"31,149.7860","31,144.8860",05.00 AED,5.00,4.9000,0.1000,564991113,1593707,Success,United Arab Emirates,DU UAE,Transguard Group LLC,API User,E6AEAE17361
2022-02-19 08:59,72697365,"31,144.8860","31,139.9860",05.00 AED,5.00,4.9000,0.1000,564991215,1593716,Success,United Arab Emirates,DU UAE,Transguard Group LLC,API User,E6AEAE17361
2022-02-19 09:01,72697455,"31,139.9860","31,130.1860",10.00 AED,10.00,9.8000,0.2000,564991453,1593724,Success,United Arab Emirates,DU UAE,Transguard Group LLC,API User,E6AEAE22430
2022-02-19 09:02,72697464,"31,130.1860","31,125.2860",05.00 AED,5.00,4.9000,0.1000,564991471,1593726,Success,United Arab Emirates,DU UAE,Transguard Group LLC,API User,E6AEAE17361
2022-02-19 09:04,72697562,"31,125.2860","31,115.4860",10.00 AED,10.00,9.8000,0.2000,564991739,1593734,Success,United Arab Emirates,DU UAE,Transguard Group LLC,API User,E6AEAE22430
2022-02-19 09:09,72697747,"31,115.4860","31,105.6860",10.00 AED,10.00,9.8000,0.2000,564992207,1593744,Success,United Arab Emirates,DU UAE,Transguard Group LLC,API User,E6AEAE22430
2022-02-19 09:14,72697933,"31,105.6860","31,100.7860",05.00 AED,5.00,4.9000,0.1000,564992642,1593752,Success,United Arab Emirates,DU UAE,Transguard Group LLC,API User,E6AEAE17361
2022-02-19 09:15,72697986,"31,100.7860","31,091.9860",149.00 INR,10.00,8.8000,1.2000,564992773,1593755,Success,India,Vi India,Transguard Group LLC,API User,VFININ21772
2022-02-19 09:16,72698009,"31,091.9860","31,082.1360",10.00 AED,10.00,9.8500,0.1500,564992842,72698009,Success,United Arab Emirates,Etisalat UAE,Transguard Group LLC,mohammed.arafath@transguardgroup.com,ETAEAE95904
2022-02-19 09:16,72698025,"31,082.1360","31,077.2360",05.00 AED,5.00,4.9000,0.1000,564992881,1593759,Success,United Arab Emirates,DU UAE,Transguard Group LLC,API User,E6AEAE17361
2022-02-19 09:17,72698040,"31,077.2360","31,071.2960",100.00 INR,6.75,5.9400,0.8100,564992924,1593761,Success,India,Airtel India,Transguard Group LLC,API User,AIININ36410
2022-02-19 09:18,72698084,"31,071.2960","31,066.3960",05.00 AED,5.00,4.9000,0.1000,564993015,1593766,Success,United Arab Emirates,DU UAE,Transguard Group LLC,API User,E6AEAE17361
2022-02-19 09:23,72698238,"31,066.3960","31,061.4960",05.00 AED,5.00,4.9000,0.1000,564993414,1593778,Success,United Arab Emirates,DU UAE,Transguard Group LLC,API User,E6AEAE17361
2022-02-19 09:23,72698271,"31,061.4960","31,056.5960",05.00 AED,5.00,4.9000,0.1000,564993488,1593782,Success,United Arab Emirates,DU UAE,Transguard Group LLC,API User,E6AEAE17361
2022-02-19 09:25,72698360,"31,056.5960","31,051.6960",05.00 AED,5.00,4.9000,0.1000,564993670,1593786,Success,United Arab Emirates,DU UAE,Transguard Group LLC,API User,E6AEAE17361
2022-02-19 09:26,72698413,"31,051.6960","31,046.7960",05.00 AED,5.00,4.9000,0.1000,564993785,1593787,Success,United Arab Emirates,DU UAE,Transguard Group LLC,API User,E6AEAE17361
2022-02-19 09:31,72698573,"31,046.7960","31,041.8960",05.00 AED,5.00,4.9000,0.1000,564994177,1593792,Success,United Arab Emirates,DU UAE,Transguard Group LLC,API User,E6AEAE17361
2022-02-19 09:32,72698601,"31,041.8960","31,036.9960",05.00 AED,5.00,4.9000,0.1000,564994246,1593800,Success,United Arab Emirates,DU UAE,Transguard Group LLC,API User,E6AEAE17361
2022-02-19 09:32,72698606,"31,036.9960","31,032.0960",05.00 AED,5.00,4.9000,0.1000,564994266,1593801,Success,United Arab Emirates,DU UAE,Transguard Group LLC,API User,E6AEAE17361
2022-02-19 09:32,72698612,"31,032.0960","31,027.1960",05.00 AED,5.00,4.9000,0.1000,564994281,1593803,Success,United Arab Emirates,DU UAE,Transguard Group LLC,API User,E6AEAE17361
2022-02-19 09:39,72698830,"31,027.1960","31,017.3960",10.00 AED,10.00,9.8000,0.2000,564994840,1593810,Success,United Arab Emirates,DU UAE,Transguard Group LLC,API User,E6AEAE22430
2022-02-19 09:50,72699306,"31,017.3960","31,007.5960",10.00 AED,10.00,9.8000,0.2000,564995928,1593818,Success,United Arab Emirates,DU UAE,Transguard Group LLC,API User,E6AEAE22430
2022-02-19 09:53,72699408,"31,007.5960","30,997.7960",10.00 AED,10.00,9.8000,0.2000,564996180,1593827,Success,United Arab Emirates,DU UAE,Transguard Group LLC,API User,E6AEAE22430
2022-02-19 09:55,72699475,"30,997.7960","30,992.8960",05.00 AED,5.00,4.9000,0.1000,564996352,1593832,Success,United Arab Emirates,DU UAE,Transguard Group LLC,API User,E6AEAE17361
2022-02-19 09:58,72699607,"30,992.8960","30,987.9960",05.00 AED,5.00,4.9000,0.1000,564996647,1593839,Success,United Arab Emirates,DU UAE,Transguard Group LLC,API User,E6AEAE17361
2022-02-19 10:00,72699670,"30,987.9960","30,978.1960",10.00 AED,10.00,9.8000,0.2000,564996835,72699670,Success,United Arab Emirates,DU UAE,Transguard Group LLC,mohammed.arafath@transguardgroup.com,E6AEAE22430
2022-02-19 10:04,72699834,"30,978.1960","30,973.2960",05.00 AED,5.00,4.9000,0.1000,564997188,1593856,Success,United Arab Emirates,DU UAE,Transguard Group LLC,API User,E6AEAE17361
2022-02-19 10:04,72699835,"30,973.2960","30,968.3960",05.00 AED,5.00,4.9000,0.1000,564997189,1593857,Success,United Arab Emirates,DU UAE,Transguard Group LLC,API User,E6AEAE17361
2022-02-19 10:04,72699854,"30,968.3960","30,963.4960",05.00 AED,5.00,4.9000,0.1000,564997224,1593859,Success,United Arab Emirates,DU UAE,Transguard Group LLC,API User,E6AEAE17361
2022-02-19 10:09,72700017,"30,963.4960","30,938.9960",25.00 AED,25.00,24.5000,0.5000,564997619,1593868,Success,United Arab Emirates,DU UAE,Transguard Group LLC,API User,E6AEAE17343
2022-02-19 10:09,72700033,"30,938.9960","30,929.1960",10.00 AED,10.00,9.8000,0.2000,564997659,1593870,Success,United Arab Emirates,DU UAE,Transguard Group LLC,API User,E6AEAE22430
2022-02-19 10:09,72700051,"30,929.1960","30,919.3960",10.00 AED,10.00,9.8000,0.2000,564997698,1593875,Success,United Arab Emirates,DU UAE,Transguard Group LLC,API User,E6AEAE22430
2022-02-19 10:10,72700065,"30,919.3960","30,894.8960",25.00 AED,25.00,24.5000,0.5000,564997731,1593876,Success,United Arab Emirates,DU UAE,Transguard Group LLC,API User,E6AEAE17343
2022-02-19 10:11,72700106,"30,894.8960","30,885.0960",10.00 AED,10.00,9.8000,0.2000,564997840,1593880,Success,United Arab Emirates,DU UAE,Transguard Group LLC,API User,E6AEAE22430
2022-02-19 10:13,72700182,"30,885.0960","30,845.8960",40.00 AED,40.00,39.2000,0.8000,564998032,1593890,Success,United Arab Emirates,DU UAE,Transguard Group LLC,API User,E6AEAE64011
2022-02-19 10:14,72700221,"30,845.8960","30,836.0960",10.00 AED,10.00,9.8000,0.2000,564998132,1593893,Success,United Arab Emirates,DU UAE,Transguard Group LLC,API User,E6AEAE22430
2022-02-19 10:17,72700325,"30,836.0960","30,826.2960",10.00 AED,10.00,9.8000,0.2000,564998344,1593900,Success,United Arab Emirates,DU UAE,Transguard Group LLC,API User,E6AEAE22430
2022-02-19 10:21,72700489,"30,826.2960","30,821.3960",05.00 AED,5.00,4.9000,0.1000,564998764,1593906,Success,United Arab Emirates,DU UAE,Transguard Group LLC,API User,E6AEAE17361
2022-02-19 10:24,72700597,"30,821.3960","30,811.5960",10.00 AED,10.00,9.8000,0.2000,564998991,1593911,Success,United Arab Emirates,DU UAE,Transguard Group LLC,API User,E6AEAE22430
2022-02-19 10:24,72700602,"30,811.5960","30,806.6960",05.00 AED,5.00,4.9000,0.1000,564999004,1593912,Success,United Arab Emirates,DU UAE,Transguard Group LLC,API User,E6AEAE17361
2022-02-19 10:26,72700715,"30,806.6960","30,796.8960",10.00 AED,10.00,9.8000,0.2000,564999266,1593926,Success,United Arab Emirates,DU UAE,Transguard Group LLC,API User,E6AEAE22430
2022-02-19 10:27,72700729,"30,796.8960","30,787.0960",10.00 AED,10.00,9.8000,0.2000,564999320,1593927,Success,United Arab Emirates,DU UAE,Transguard Group LLC,API User,E6AEAE22430
2022-02-19 10:28,72700772,"30,787.0960","30,782.1960",05.00 AED,5.00,4.9000,0.1000,564999413,1593930,Success,United Arab Emirates,DU UAE,Transguard Group LLC,API User,E6AEAE17361
2022-02-19 10:37,72701099,"30,782.1960","30,772.3960",10.00 AED,10.00,9.8000,0.2000,565000189,1593945,Success,United Arab Emirates,DU UAE,Transguard Group LLC,API User,E6AEAE22430
2022-02-19 10:37,72701111,"30,772.3960","30,767.4960",05.00 AED,5.00,4.9000,0.1000,565000241,1593951,Success,United Arab Emirates,DU UAE,Transguard Group LLC,API User,E6AEAE17361
2022-02-19 10:37,72701114,"30,767.4960","30,757.6960",10.00 AED,10.00,9.8000,0.2000,565000247,1593952,Success,United Arab Emirates,DU UAE,Transguard Group LLC,API User,E6AEAE22430
2022-02-19 10:38,72701166,"30,757.6960","30,752.7960",05.00 AED,5.00,4.9000,0.1000,565000372,1593958,Success,United Arab Emirates,DU UAE,Transguard Group LLC,API User,E6AEAE17361
2022-02-19 10:38,72701173,"30,752.7960","30,747.8960",05.00 AED,5.00,4.9000,0.1000,565000391,1593960,Success,United Arab Emirates,DU UAE,Transguard Group LLC,API User,E6AEAE17361
2022-02-19 10:39,72701209,"30,747.8960","30,742.9960",05.00 AED,5.00,4.9000,0.1000,565000467,1593967,Success,United Arab Emirates,DU UAE,Transguard Group LLC,API User,E6AEAE17361
2022-02-19 10:41,72701252,"30,742.9960","30,738.0960",05.00 AED,5.00,4.9000,0.1000,565000596,1593973,Success,United Arab Emirates,DU UAE,Transguard Group LLC,API User,E6AEAE17361
2022-02-19 10:43,72701346,"30,738.0960","30,733.1960",05.00 AED,5.00,4.9000,0.1000,565000820,1593986,Success,United Arab Emirates,DU UAE,Transguard Group LLC,API User,E6AEAE17361
2022-02-19 10:43,72701362,"30,733.1960","30,723.3960",10.00 AED,10.00,9.8000,0.2000,565000846,1593988,Success,United Arab Emirates,DU UAE,Transguard Group LLC,API User,E6AEAE22430
2022-02-19 10:43,72701365,"30,723.3960","30,718.4960",05.00 AED,5.00,4.9000,0.1000,565000859,1593989,Success,United Arab Emirates,DU UAE,Transguard Group LLC,API User,E6AEAE17361
2022-02-19 10:47,72701536,"30,718.4960","30,713.5960",05.00 AED,5.00,4.9000,0.1000,565001227,1593994,Success,United Arab Emirates,DU UAE,Transguard Group LLC,API User,E6AEAE17361
2022-02-19 10:48,72701568,"30,713.5960","30,708.6960",05.00 AED,5.00,4.9000,0.1000,565001307,1593998,Success,United Arab Emirates,DU UAE,Transguard Group LLC,API User,E6AEAE17361
2022-02-19 10:49,72701600,"30,708.6960","30,698.8960",10.00 AED,10.00,9.8000,0.2000,565001393,1594001,Success,United Arab Emirates,DU UAE,Transguard Group LLC,API User,E6AEAE22430
2022-02-19 10:51,72701695,"30,698.8960","30,689.0960",10.00 AED,10.00,9.8000,0.2000,565001614,1594004,Success,United Arab Emirates,DU UAE,Transguard Group LLC,API User,E6AEAE22430
2022-02-19 10:59,72701991,"30,689.0960","30,664.6760",899.00 PKR,27.75,24.4200,3.3300,565002311,1594015,Success,Pakistan,Zong Pakistan,Transguard Group LLC,API User,ZNPKPK48367
2022-02-19 11:01,72702089,"30,664.6760","30,654.8760",10.00 AED,10.00,9.8000,0.2000,565002549,1594020,Success,United Arab Emirates,DU UAE,Transguard Group LLC,API User,E6AEAE22430
2022-02-19 11:02,72702120,"30,654.8760","30,649.9760",05.00 AED,5.00,4.9000,0.1000,565002624,1594027,Success,United Arab Emirates,DU UAE,Transguard Group LLC,API User,E6AEAE17361
2022-02-19 11:04,72702187,"30,649.9760","30,645.0760",05.00 AED,5.00,4.9000,0.1000,565002778,1594032,Success,United Arab Emirates,DU UAE,Transguard Group LLC,API User,E6AEAE17361
2022-02-19 11:09,72702354,"30,645.0760","30,635.2760",10.00 AED,10.00,9.8000,0.2000,565003187,1594040,Success,United Arab Emirates,DU UAE,Transguard Group LLC,API User,E6AEAE22430
2022-02-19 11:11,72702434,"30,635.2760","30,625.4760",10.00 AED,10.00,9.8000,0.2000,565003372,1594049,Success,United Arab Emirates,DU UAE,Transguard Group LLC,API User,E6AEAE22430
2022-02-19 11:12,72702450,"30,625.4760","30,615.6760",10.00 AED,10.00,9.8000,0.2000,565003411,1594051,Success,United Arab Emirates,DU UAE,Transguard Group LLC,API User,E6AEAE22430
2022-02-19 11:12,72702455,"30,615.6760","30,605.8760",10.00 AED,10.00,9.8000,0.2000,565003420,1594052,Success,United Arab Emirates,DU UAE,Transguard Group LLC,API User,E6AEAE22430
2022-02-19 11:14,72702534,"30,605.8760","30,596.0760",10.00 AED,10.00,9.8000,0.2000,565003601,1594061,Success,United Arab Emirates,DU UAE,Transguard Group LLC,API User,E6AEAE22430
2022-02-19 11:15,72702579,"30,596.0760","30,586.2760",10.00 AED,10.00,9.8000,0.2000,565003730,1594066,Success,United Arab Emirates,DU UAE,Transguard Group LLC,API User,E6AEAE22430
2022-02-19 11:16,72702608,"30,586.2760","30,576.4760",10.00 AED,10.00,9.8000,0.2000,565003829,1594069,Success,United Arab Emirates,DU UAE,Transguard Group LLC,API User,E6AEAE22430
2022-02-19 11:21,72702774,"30,576.4760","30,556.8760",20.00 AED,20.00,19.6000,0.4000,565004223,1594074,Success,United Arab Emirates,DU UAE,Transguard Group LLC,API User,E6AEAE12938
2022-02-19 11:23,72702859,"30,556.8760","30,551.9760",05.00 AED,5.00,4.9000,0.1000,565004437,1594079,Success,United Arab Emirates,DU UAE,Transguard Group LLC,API User,E6AEAE17361
2022-02-19 11:25,72702935,"30,551.9760","30,543.1760",100.00 PHP,10.00,8.8000,1.2000,565004615,1594084,Success,Philippines,BS_Globe Philippines,Transguard Group LLC,API User,PH_GB_TopUp_100.00
2022-02-19 11:26,72702978,"30,543.1760","30,534.8160",100.00 PHP,9.50,8.3600,1.1400,565004734,1594087,Success,Philippines,Smart (SunCellular) Philippines,Transguard Group LLC,API User,PH_SM_TopUp_100.00
2022-02-19 11:27,72703003,"30,534.8160","30,529.9160",05.00 AED,5.00,4.9000,0.1000,565004790,1594090,Success,United Arab Emirates,DU UAE,Transguard Group LLC,API User,E6AEAE17361
2022-02-19 11:29,72703099,"30,529.9160","30,520.1160",10.00 AED,10.00,9.8000,0.2000,565004988,1594098,Success,United Arab Emirates,DU UAE,Transguard Group LLC,API User,E6AEAE22430
2022-02-19 11:29,72703109,"30,520.1160","30,510.3160",10.00 AED,10.00,9.8000,0.2000,565005018,1594099,Success,United Arab Emirates,DU UAE,Transguard Group LLC,API User,E6AEAE22430
2022-02-19 11:30,72703121,"30,510.3160","30,505.4160",05.00 AED,5.00,4.9000,0.1000,565005047,1594103,Success,United Arab Emirates,DU UAE,Transguard Group LLC,API User,E6AEAE17361
2022-02-19 11:30,72703139,"30,505.4160","30,500.5160",05.00 AED,5.00,4.9000,0.1000,565005088,1594106,Success,United Arab Emirates,DU UAE,Transguard Group LLC,API User,E6AEAE17361
2022-02-19 11:32,72703198,"30,500.5160","30,490.7160",10.00 AED,10.00,9.8000,0.2000,565005252,1594110,Success,United Arab Emirates,DU UAE,Transguard Group LLC,API User,E6AEAE22430
2022-02-19 11:34,72703282,"30,490.7160","30,471.1160",20.00 AED,20.00,19.6000,0.4000,565005440,1594119,Success,United Arab Emirates,DU UAE,Transguard Group LLC,API User,E6AEAE12938
2022-02-19 11:34,72703284,"30,471.1160","30,466.2160",05.00 AED,5.00,4.9000,0.1000,565005441,1594120,Success,United Arab Emirates,DU UAE,Transguard Group LLC,API User,E6AEAE17361
2022-02-19 11:35,72703328,"30,466.2160","30,456.4160",10.00 AED,10.00,9.8000,0.2000,565005554,1594123,Success,United Arab Emirates,DU UAE,Transguard Group LLC,API User,E6AEAE22430
2022-02-19 11:36,72703350,"30,456.4160","30,451.5160",05.00 AED,5.00,4.9000,0.1000,565005596,1594126,Success,United Arab Emirates,DU UAE,Transguard Group LLC,API User,E6AEAE17361
2022-02-19 11:38,72703448,"30,451.5160","30,441.7160",10.00 AED,10.00,9.8000,0.2000,565005839,1594134,Success,United Arab Emirates,DU UAE,Transguard Group LLC,API User,E6AEAE22430
2022-02-19 11:40,72703527,"30,441.7160","30,431.9160",10.00 AED,10.00,9.8000,0.2000,565006010,1594143,Success,United Arab Emirates,DU UAE,Transguard Group LLC,API User,E6AEAE22430
2022-02-19 11:40,72703535,"30,431.9160","30,427.0160",05.00 AED,5.00,4.9000,0.1000,565006036,1594145,Success,United Arab Emirates,DU UAE,Transguard Group LLC,API User,E6AEAE17361
2022-02-19 11:45,72703710,"30,427.0160","30,422.1160",05.00 AED,5.00,4.9000,0.1000,565006411,1594151,Success,United Arab Emirates,DU UAE,Transguard Group LLC,API User,E6AEAE17361
2022-02-19 11:45,72703740,"30,422.1160","30,417.2160",05.00 AED,5.00,4.9000,0.1000,565006481,1594155,Success,United Arab Emirates,DU UAE,Transguard Group LLC,API User,E6AEAE17361
2022-02-19 11:50,72703903,"30,417.2160","30,407.4160",10.00 AED,10.00,9.8000,0.2000,565006905,1594164,Success,United Arab Emirates,DU UAE,Transguard Group LLC,API User,E6AEAE22430
2022-02-19 11:51,72703940,"30,407.4160","30,387.8160",20.00 AED,20.00,19.6000,0.4000,565006988,1594167,Success,United Arab Emirates,DU UAE,Transguard Group LLC,API User,E6AEAE12938
2022-02-19 11:54,72704049,"30,387.8160","30,382.9160",05.00 AED,5.00,4.9000,0.1000,565007280,1594170,Success,United Arab Emirates,DU UAE,Transguard Group LLC,API User,E6AEAE17361
2022-02-19 11:55,72704101,"30,382.9160","30,358.4160",25.00 AED,25.00,24.5000,0.5000,565007428,72704101,Failure,United Arab Emirates,DU UAE,Transguard Group LLC,mohammed.arafath@transguardgroup.com,E6AEAE17343
2022-02-19 11:55,72704101,"30,358.4160","30,333.9160",25.00 AED,25.00,24.5000,0.5000,565007428,72704101,Failure,United Arab Emirates,DU UAE,Transguard Group LLC,mohammed.arafath@transguardgroup.com,E6AEAE17343
2022-02-19 11:57,72704139,"30,382.9160","30,378.0160",05.00 AED,5.00,4.9000,0.1000,565007528,1594176,Success,United Arab Emirates,DU UAE,Transguard Group LLC,API User,E6AEAE17361
2022-02-19 11:57,72704151,"30,378.0160","30,373.1160",05.00 AED,5.00,4.9000,0.1000,565007558,1594179,Success,United Arab Emirates,DU UAE,Transguard Group LLC,API User,E6AEAE17361
2022-02-19 12:02,72704331,"30,373.1160","30,363.3160",10.00 AED,10.00,9.8000,0.2000,565008031,1594186,Success,United Arab Emirates,DU UAE,Transguard Group LLC,API User,E6AEAE22430
2022-02-19 12:06,72704459,"30,363.3160","30,358.4160",05.00 AED,5.00,4.9000,0.1000,565008336,1594198,Success,United Arab Emirates,DU UAE,Transguard Group LLC,API User,E6AEAE17361
2022-02-19 12:06,72704462,"30,358.4160","30,353.5160",05.00 AED,5.00,4.9000,0.1000,565008339,1594199,Success,United Arab Emirates,DU UAE,Transguard Group LLC,API User,E6AEAE17361
2022-02-19 12:12,72704684,"30,353.5160","30,343.7160",10.00 AED,10.00,9.8000,0.2000,565008909,1594206,Success,United Arab Emirates,DU UAE,Transguard Group LLC,API User,E6AEAE22430
2022-02-19 12:12,72704704,"30,343.7160","30,338.8160",05.00 AED,5.00,4.9000,0.1000,565008959,1594210,Success,United Arab Emirates,DU UAE,Transguard Group LLC,API User,E6AEAE17361
2022-02-19 12:13,72704716,"30,338.8160","30,309.4160",30.00 AED,30.00,29.4000,0.6000,565008998,1594215,Success,United Arab Emirates,DU UAE,Transguard Group LLC,API User,E6AEAE46146
2022-02-19 12:13,72704720,"30,309.4160","30,299.6160",10.00 AED,10.00,9.8000,0.2000,565009008,1594216,Success,United Arab Emirates,DU UAE,Transguard Group LLC,API User,E6AEAE22430
2022-02-19 12:14,72704751,"30,299.6160","30,294.7160",05.00 AED,5.00,4.9000,0.1000,565009079,1594225,Success,United Arab Emirates,DU UAE,Transguard Group LLC,API User,E6AEAE17361
2022-02-19 12:14,72704762,"30,294.7160","30,289.8160",05.00 AED,5.00,4.9000,0.1000,565009098,1594227,Success,United Arab Emirates,DU UAE,Transguard Group LLC,API User,E6AEAE17361
2022-02-19 12:14,72704772,"30,289.8160","30,282.5560",200.00 NPR,8.25,7.2600,0.9900,565009134,1594228,Success,Nepal,Nepal Telecom Nepal,Transguard Group LLC,API User,NP_NE_TopUp_200.00
2022-02-19 12:15,72704803,"30,282.5560","30,277.6560",05.00 AED,5.00,4.9000,0.1000,565009193,1594233,Success,United Arab Emirates,DU UAE,Transguard Group LLC,API User,E6AEAE17361
2022-02-19 12:16,72704842,"30,277.6560","30,269.2960",300.00 PKR,9.50,8.3600,1.1400,565009285,1594236,Success,Pakistan,Jazz Pakistan,Transguard Group LLC,API User,PK_MB_TopUp_300.00
2022-02-19 12:19,72704963,"30,269.2960","30,264.3960",05.00 AED,5.00,4.9000,0.1000,565009535,1594239,Success,United Arab Emirates,DU UAE,Transguard Group LLC,API User,E6AEAE17361
2022-02-19 12:20,72705014,"30,264.3960","30,254.5960",10.00 AED,10.00,9.8000,0.2000,565009662,1594242,Success,United Arab Emirates,DU UAE,Transguard Group LLC,API User,E6AEAE22430
2022-02-19 12:22,72705111,"30,254.5960","30,244.7960",10.00 AED,10.00,9.8000,0.2000,565009902,1594248,Success,United Arab Emirates,DU UAE,Transguard Group LLC,API User,E6AEAE22430
2022-02-19 12:28,72705343,"30,244.7960","30,239.8960",05.00 AED,5.00,4.9000,0.1000,565010454,1594251,Success,United Arab Emirates,DU UAE,Transguard Group LLC,API User,E6AEAE17361
2022-02-19 12:29,72705370,"30,239.8960","30,210.4960",30.00 AED,30.00,29.4000,0.6000,565010531,1594254,Success,United Arab Emirates,DU UAE,Transguard Group LLC,API User,E6AEAE46146
2022-02-19 12:35,72705590,"30,210.4960","30,205.5960",05.00 AED,5.00,4.9000,0.1000,565011055,1594266,Success,United Arab Emirates,DU UAE,Transguard Group LLC,API User,E6AEAE17361
2022-02-19 12:37,72705715,"30,205.5960","30,200.6960",05.00 AED,5.00,4.9000,0.1000,565011307,1594275,Success,United Arab Emirates,DU UAE,Transguard Group LLC,API User,E6AEAE17361
2022-02-19 12:42,72705891,"30,200.6960","30,195.7960",05.00 AED,5.00,4.9000,0.1000,565011743,1594283,Success,United Arab Emirates,DU UAE,Transguard Group LLC,API User,E6AEAE17361
2022-02-19 12:42,72705901,"30,195.7960","30,185.9960",10.00 AED,10.00,9.8000,0.2000,565011756,1594285,Success,United Arab Emirates,DU UAE,Transguard Group LLC,API User,E6AEAE22430
2022-02-19 12:44,72705953,"30,185.9960","30,181.0960",05.00 AED,5.00,4.9000,0.1000,565011883,1594292,Success,United Arab Emirates,DU UAE,Transguard Group LLC,API User,E6AEAE17361
2022-02-19 12:46,72706038,"30,181.0960","30,176.1960",05.00 AED,5.00,4.9000,0.1000,565012061,1594299,Success,United Arab Emirates,DU UAE,Transguard Group LLC,API User,E6AEAE17361
2022-02-19 12:51,72706255,"30,176.1960","30,166.3960",10.00 AED,10.00,9.8000,0.2000,565012608,1594311,Success,United Arab Emirates,DU UAE,Transguard Group LLC,API User,E6AEAE22430
2022-02-19 12:54,72706370,"30,166.3960","30,156.5960",10.00 AED,10.00,9.8000,0.2000,565012864,1594325,Success,United Arab Emirates,DU UAE,Transguard Group LLC,API User,E6AEAE22430
2022-02-19 12:54,72706377,"30,156.5960","30,151.6960",05.00 AED,5.00,4.9000,0.1000,565012881,1594327,Success,United Arab Emirates,DU UAE,Transguard Group LLC,API User,E6AEAE17361
2022-02-19 12:54,72706388,"30,151.6960","30,147.5160",150.00 PKR,4.75,4.1800,0.5700,565012909,1594329,Success,Pakistan,Zong Pakistan,Transguard Group LLC,API User,ZNPKPK65621
2022-02-19 12:55,72706426,"30,147.5160","30,142.6160",05.00 AED,5.00,4.9000,0.1000,565013012,1594335,Success,United Arab Emirates,DU UAE,Transguard Group LLC,API User,E6AEAE17361
2022-02-19 12:55,72706432,"30,142.6160","30,137.7160",05.00 AED,5.00,4.9000,0.1000,565013019,1594336,Success,United Arab Emirates,DU UAE,Transguard Group LLC,API User,E6AEAE17361
2022-02-19 12:59,72706540,"30,137.7160","30,127.9160",10.00 AED,10.00,9.8000,0.2000,565013278,1594349,Success,United Arab Emirates,DU UAE,Transguard Group LLC,API User,E6AEAE22430
2022-02-19 13:01,72706631,"30,127.9160","30,118.1160",10.00 AED,10.00,9.8000,0.2000,565013534,1594354,Success,United Arab Emirates,DU UAE,Transguard Group LLC,API User,E6AEAE22430
2022-02-19 13:01,72706640,"30,118.1160","30,108.3160",10.00 AED,10.00,9.8000,0.2000,565013555,1594357,Success,United Arab Emirates,DU UAE,Transguard Group LLC,API User,E6AEAE22430
2022-02-19 13:05,72706816,"30,108.3160","30,103.4160",05.00 AED,5.00,4.9000,0.1000,565013966,1594370,Success,United Arab Emirates,DU UAE,Transguard Group LLC,API User,E6AEAE17361
2022-02-19 13:06,72706849,"30,103.4160","30,088.7160",15.00 AED,15.00,14.7000,0.3000,565014039,1594373,Success,United Arab Emirates,DU UAE,Transguard Group LLC,API User,E6AEAE8527
2022-02-19 13:13,72707141,"30,088.7160","30,083.8160",05.00 AED,5.00,4.9000,0.1000,565014721,1594381,Success,United Arab Emirates,DU UAE,Transguard Group LLC,API User,E6AEAE17361
2022-02-19 13:14,72707187,"30,083.8160","30,074.0160",10.00 AED,10.00,9.8000,0.2000,565014835,1594384,Success,United Arab Emirates,DU UAE,Transguard Group LLC,API User,E6AEAE22430
2022-02-19 13:16,72707296,"30,074.0160","30,064.2160",10.00 AED,10.00,9.8000,0.2000,565015104,1594391,Success,United Arab Emirates,DU UAE,Transguard Group LLC,API User,E6AEAE22430
2022-02-19 13:17,72707321,"30,064.2160","30,059.3160",05.00 AED,5.00,4.9000,0.1000,565015154,1594394,Success,United Arab Emirates,DU UAE,Transguard Group LLC,API User,E6AEAE17361
2022-02-19 13:21,72707484,"30,059.3160","30,050.7360",315.00 PKR,9.75,8.5800,1.1700,565015579,1594407,Success,Pakistan,Zong Pakistan,Transguard Group LLC,API User,ZNPKPK29953
2022-02-19 13:22,72707503,"30,050.7360","30,045.8360",05.00 AED,5.00,4.9000,0.1000,565015635,1594410,Success,United Arab Emirates,DU UAE,Transguard Group LLC,API User,E6AEAE17361
2022-02-19 13:26,72707701,"30,045.8360","30,036.0360",10.00 AED,10.00,9.8000,0.2000,565016137,1594416,Success,United Arab Emirates,DU UAE,Transguard Group LLC,API User,E6AEAE22430
2022-02-19 13:32,72707926,"30,036.0360","30,031.1360",05.00 AED,5.00,4.9000,0.1000,565016711,1594422,Success,United Arab Emirates,DU UAE,Transguard Group LLC,API User,E6AEAE17361
2022-02-19 13:35,72708034,"30,031.1360","30,026.2360",05.00 AED,5.00,4.9000,0.1000,565017024,1594426,Success,United Arab Emirates,DU UAE,Transguard Group LLC,API User,E6AEAE17361
2022-02-19 13:36,72708105,"30,026.2360","30,006.6360",20.00 AED,20.00,19.6000,0.4000,565017206,1594433,Success,United Arab Emirates,DU UAE,Transguard Group LLC,API User,E6AEAE12938
2022-02-19 13:38,72708157,"30,006.6360","29,987.0360",20.00 AED,20.00,19.6000,0.4000,565017337,1594439,Success,United Arab Emirates,DU UAE,Transguard Group LLC,API User,E6AEAE12938
2022-02-19 13:39,72708197,"29,987.0360","29,977.2360",10.00 AED,10.00,9.8000,0.2000,565017432,1594443,Success,United Arab Emirates,DU UAE,Transguard Group LLC,API User,E6AEAE22430
2022-02-19 13:39,72708217,"29,977.2360","29,957.6360",20.00 AED,20.00,19.6000,0.4000,565017477,1594446,Success,United Arab Emirates,DU UAE,Transguard Group LLC,API User,E6AEAE12938
2022-02-19 13:45,72708448,"29,957.6360","29,952.7360",05.00 AED,5.00,4.9000,0.1000,565018080,1594456,Success,United Arab Emirates,DU UAE,Transguard Group LLC,API User,E6AEAE17361
2022-02-19 13:48,72708609,"29,952.7360","29,947.8360",05.00 AED,5.00,4.9000,0.1000,565018413,1594459,Success,United Arab Emirates,DU UAE,Transguard Group LLC,API User,E6AEAE17361
2022-02-19 13:54,72708835,"29,947.8360","29,938.0360",10.00 AED,10.00,9.8000,0.2000,565018959,1594470,Success,United Arab Emirates,DU UAE,Transguard Group LLC,API User,E6AEAE22430
2022-02-19 13:54,72708845,"29,938.0360","29,932.0960",100.00 INR,6.75,5.9400,0.8100,565018995,1594472,Success,India,Airtel India,Transguard Group LLC,API User,AIININ36410
2022-02-19 13:58,72709019,"29,932.0960","29,922.2960",10.00 AED,10.00,9.8000,0.2000,565019392,1594479,Success,United Arab Emirates,DU UAE,Transguard Group LLC,API User,E6AEAE22430
2022-02-19 13:59,72709068,"29,922.2960","29,917.3960",05.00 AED,5.00,4.9000,0.1000,565019505,1594484,Success,United Arab Emirates,DU UAE,Transguard Group LLC,API User,E6AEAE17361
2022-02-19 14:00,72709112,"29,917.3960","29,907.5960",10.00 AED,10.00,9.8000,0.2000,565019625,1594488,Success,United Arab Emirates,DU UAE,Transguard Group LLC,API User,E6AEAE22430
2022-02-19 14:02,72709190,"29,907.5960","29,897.7960",10.00 AED,10.00,9.8000,0.2000,565019792,1594491,Success,United Arab Emirates,DU UAE,Transguard Group LLC,API User,E6AEAE22430
2022-02-19 14:03,72709251,"29,897.7960","29,892.8960",05.00 AED,5.00,4.9000,0.1000,565019915,1594494,Success,United Arab Emirates,DU UAE,Transguard Group LLC,API User,E6AEAE17361
2022-02-19 14:05,72709308,"29,892.8960","29,887.9960",05.00 AED,5.00,4.9000,0.1000,565020077,1594498,Success,United Arab Emirates,DU UAE,Transguard Group LLC,API User,E6AEAE17361
2022-02-19 14:07,72709416,"29,887.9960","29,863.4960",25.00 AED,25.00,24.5000,0.5000,565020318,1594502,Success,United Arab Emirates,DU UAE,Transguard Group LLC,API User,E6AEAE17343
2022-02-19 14:09,72709517,"29,863.4960","29,858.5960",05.00 AED,5.00,4.9000,0.1000,565020565,1594512,Success,United Arab Emirates,DU UAE,Transguard Group LLC,API User,E6AEAE17361
2022-02-19 14:10,72709548,"29,858.5960","29,849.7960",13.20 GHS,10.00,8.8000,1.2000,565020628,1594518,Success,Ghana,MTN Ghana,Transguard Group LLC,API User,GH_MT_TopUp
2022-02-19 14:17,72709826,"29,849.7960","29,844.8960",05.00 AED,5.00,4.9000,0.1000,565021424,1594528,Success,United Arab Emirates,DU UAE,Transguard Group LLC,API User,E6AEAE17361
2022-02-19 14:21,72709973,"29,844.8960","29,825.2960",20.00 AED,20.00,19.6000,0.4000,565021822,1594534,Success,United Arab Emirates,DU UAE,Transguard Group LLC,API User,E6AEAE12938
2022-02-19 14:24,72710077,"29,825.2960","29,820.3960",05.00 AED,5.00,4.9000,0.1000,565022140,1594539,Success,United Arab Emirates,DU UAE,Transguard Group LLC,API User,E6AEAE17361
2022-02-19 14:31,72710378,"29,820.3960","29,815.4960",05.00 AED,5.00,4.9000,0.1000,565022984,1594546,Success,United Arab Emirates,DU UAE,Transguard Group LLC,API User,E6AEAE17361
2022-02-19 14:32,72710399,"29,815.4960","29,806.6960",149.00 INR,10.00,8.8000,1.2000,565023035,1594548,Success,India,Vi India,Transguard Group LLC,API User,VFININ21772
2022-02-19 14:34,72710497,"29,806.6960","29,801.7960",05.00 AED,5.00,4.9000,0.1000,565023301,1594555,Success,United Arab Emirates,DU UAE,Transguard Group LLC,API User,E6AEAE17361
2022-02-19 14:34,72710505,"29,801.7960","29,796.8960",05.00 AED,5.00,4.9000,0.1000,565023323,1594556,Success,United Arab Emirates,DU UAE,Transguard Group LLC,API User,E6AEAE17361
2022-02-19 14:37,72710632,"29,796.8960","29,791.9960",05.00 AED,5.00,4.9000,0.1000,565023668,1594561,Success,United Arab Emirates,DU UAE,Transguard Group LLC,API User,E6AEAE17361
2022-02-19 14:40,72710760,"29,791.9960","29,787.0960",05.00 AED,5.00,4.9000,0.1000,565024014,1594564,Success,United Arab Emirates,DU UAE,Transguard Group LLC,API User,E6AEAE17361
2022-02-19 14:44,72710960,"29,787.0960","29,777.2960",10.00 AED,10.00,9.8000,0.2000,565024549,1594567,Success,United Arab Emirates,DU UAE,Transguard Group LLC,API User,E6AEAE22430
2022-02-19 14:45,72711013,"29,777.2960","29,767.4960",10.00 AED,10.00,9.8000,0.2000,565024670,1594570,Success,United Arab Emirates,DU UAE,Transguard Group LLC,API User,E6AEAE22430
2022-02-19 14:53,72711327,"29,767.4960","29,747.8960",20.00 AED,20.00,19.6000,0.4000,565025534,1594577,Success,United Arab Emirates,DU UAE,Transguard Group LLC,API User,E6AEAE12938
2022-02-19 14:57,72711474,"29,747.8960","29,738.0960",10.00 AED,10.00,9.8000,0.2000,565025933,1594580,Success,United Arab Emirates,DU UAE,Transguard Group LLC,API User,E6AEAE22430
2022-02-19 15:13,72712075,"29,738.0960","29,733.1960",05.00 AED,5.00,4.9000,0.1000,565027677,1594588,Success,United Arab Emirates,DU UAE,Transguard Group LLC,API User,E6AEAE17361
2022-02-19 15:15,72712139,"29,733.1960","29,728.2960",05.00 AED,5.00,4.9000,0.1000,565027884,1594593,Success,United Arab Emirates,DU UAE,Transguard Group LLC,API User,E6AEAE17361
2022-02-19 15:15,72712174,"29,728.2960","29,723.3960",05.00 AED,5.00,4.9000,0.1000,565027984,1594597,Success,United Arab Emirates,DU UAE,Transguard Group LLC,API User,E6AEAE17361
2022-02-19 15:20,72712356,"29,723.3960","29,718.4960",05.00 AED,5.00,4.9000,0.1000,565028495,1594602,Success,United Arab Emirates,DU UAE,Transguard Group LLC,API User,E6AEAE17361
2022-02-19 15:25,72712563,"29,718.4960","29,713.5960",05.00 AED,5.00,4.9000,0.1000,565029091,1594611,Success,United Arab Emirates,DU UAE,Transguard Group LLC,API User,E6AEAE17361
2022-02-19 15:25,72712575,"29,713.5960","29,708.6960",05.00 AED,5.00,4.9000,0.1000,565029130,1594615,Success,United Arab Emirates,DU UAE,Transguard Group LLC,API User,E6AEAE17361
2022-02-19 15:30,72712770,"29,708.6960","29,698.8960",10.00 AED,10.00,9.8000,0.2000,565029699,1594629,Success,United Arab Emirates,DU UAE,Transguard Group LLC,API User,E6AEAE22430
2022-02-19 15:30,72712781,"29,698.8960","29,693.9960",05.00 AED,5.00,4.9000,0.1000,565029732,1594631,Success,United Arab Emirates,DU UAE,Transguard Group LLC,API User,E6AEAE17361
2022-02-19 15:35,72712955,"29,693.9960","29,684.1960",10.00 AED,10.00,9.8000,0.2000,565030254,1594634,Success,United Arab Emirates,DU UAE,Transguard Group LLC,API User,E6AEAE22430
2022-02-19 15:39,72713145,"29,684.1960","29,679.2960",05.00 AED,5.00,4.9000,0.1000,565030738,1594644,Success,United Arab Emirates,DU UAE,Transguard Group LLC,API User,E6AEAE17361
2022-02-19 15:49,72713573,"29,679.2960","29,674.3960",05.00 AED,5.00,4.9000,0.1000,565031992,1594653,Success,United Arab Emirates,DU UAE,Transguard Group LLC,API User,E6AEAE17361
2022-02-19 15:49,72713574,"29,674.3960","29,669.4960",05.00 AED,5.00,4.9000,0.1000,565031999,1594654,Success,United Arab Emirates,DU UAE,Transguard Group LLC,API User,E6AEAE17361
2022-02-19 15:56,72713863,"29,669.4960","29,660.6960",149.00 INR,10.00,8.8000,1.2000,565032777,1594658,Success,India,Vi India,Transguard Group LLC,API User,VFININ21772
2022-02-19 15:56,72713883,"29,660.6960","29,655.7960",05.00 AED,5.00,4.9000,0.1000,565032809,1594660,Success,United Arab Emirates,DU UAE,Transguard Group LLC,API User,E6AEAE17361
2022-02-19 15:58,72713994,"29,655.7960","29,651.6160",150.00 PKR,4.75,4.1800,0.5700,565033079,1594665,Success,Pakistan,Zong Pakistan,Transguard Group LLC,API User,ZNPKPK65621
2022-02-19 16:00,72714058,"29,651.6160","29,641.8160",10.00 AED,10.00,9.8000,0.2000,565033253,1594669,Success,United Arab Emirates,DU UAE,Transguard Group LLC,API User,E6AEAE22430
2022-02-19 16:01,72714097,"29,641.8160","29,636.9160",05.00 AED,5.00,4.9000,0.1000,565033395,1594673,Success,United Arab Emirates,DU UAE,Transguard Group LLC,API User,E6AEAE17361
2022-02-19 16:02,72714179,"29,636.9160","29,632.0160",05.00 AED,5.00,4.9000,0.1000,565033603,1594679,Success,United Arab Emirates,DU UAE,Transguard Group LLC,API User,E6AEAE17361
2022-02-19 16:12,72714597,"29,632.0160","29,612.4160",20.00 AED,20.00,19.6000,0.4000,565034818,1594699,Success,United Arab Emirates,DU UAE,Transguard Group LLC,API User,E6AEAE12938
2022-02-19 16:13,72714637,"29,612.4160","29,602.6160",10.00 AED,10.00,9.8000,0.2000,565034944,1594702,Success,United Arab Emirates,DU UAE,Transguard Group LLC,API User,E6AEAE22430
2022-02-19 16:13,72714684,"29,602.6160","29,592.8160",10.00 AED,10.00,9.8000,0.2000,565035052,1594705,Success,United Arab Emirates,DU UAE,Transguard Group LLC,API User,E6AEAE22430
2022-02-19 16:14,72714730,"29,592.8160","29,587.9160",05.00 AED,5.00,4.9000,0.1000,565035171,1594708,Success,United Arab Emirates,DU UAE,Transguard Group LLC,API User,E6AEAE17361
2022-02-19 16:17,72714868,"29,587.9160","29,583.0160",05.00 AED,5.00,4.9000,0.1000,565035586,1594714,Success,United Arab Emirates,DU UAE,Transguard Group LLC,API User,E6AEAE17361
2022-02-19 16:19,72714966,"29,583.0160","29,573.2160",10.00 AED,10.00,9.8000,0.2000,565035892,1594721,Success,United Arab Emirates,DU UAE,Transguard Group LLC,API User,E6AEAE22430
2022-02-19 16:27,72715342,"29,573.2160","29,568.3160",05.00 AED,5.00,4.9000,0.1000,565037009,1594734,Success,United Arab Emirates,DU UAE,Transguard Group LLC,API User,E6AEAE17361
2022-02-19 16:30,72715511,"29,568.3160","29,558.5160",10.00 AED,10.00,9.8000,0.2000,565037475,1594739,Success,United Arab Emirates,DU UAE,Transguard Group LLC,API User,E6AEAE22430
2022-02-19 16:31,72715540,"29,558.5160","29,548.7160",10.00 AED,10.00,9.8000,0.2000,565037556,1594744,Success,United Arab Emirates,DU UAE,Transguard Group LLC,API User,E6AEAE22430
2022-02-19 16:31,72715572,"29,548.7160","29,543.8160",05.00 AED,5.00,4.9000,0.1000,565037645,1594748,Success,United Arab Emirates,DU UAE,Transguard Group LLC,API User,E6AEAE17361
2022-02-19 16:35,72715770,"29,543.8160","29,538.9160",05.00 AED,5.00,4.9000,0.1000,565038226,1594754,Success,United Arab Emirates,DU UAE,Transguard Group LLC,API User,E6AEAE17361
2022-02-19 16:37,72715904,"29,538.9160","29,534.0160",05.00 AED,5.00,4.9000,0.1000,565038575,1594757,Success,United Arab Emirates,DU UAE,Transguard Group LLC,API User,E6AEAE17361
2022-02-19 16:39,72716022,"29,534.0160","29,530.2760",151.00 PKR,4.25,3.7400,0.5100,565038875,1594763,Success,Pakistan,Telenor Pakistan,Transguard Group LLC,API User,TPPKPK94108
2022-02-19 16:45,72716331,"29,530.2760","29,520.4760",10.00 AED,10.00,9.8000,0.2000,565039693,1594768,Success,United Arab Emirates,DU UAE,Transguard Group LLC,API User,E6AEAE22430
2022-02-19 16:49,72716563,"29,520.4760","29,510.6760",10.00 AED,10.00,9.8000,0.2000,565040265,1594775,Success,United Arab Emirates,DU UAE,Transguard Group LLC,API User,E6AEAE22430
2022-02-19 16:58,72717116,"29,510.6760","29,495.9760",15.00 AED,15.00,14.7000,0.3000,565041737,1594786,Success,United Arab Emirates,DU UAE,Transguard Group LLC,API User,E6AEAE8527
2022-02-19 16:58,72717120,"29,495.9760","29,491.0760",05.00 AED,5.00,4.9000,0.1000,565041763,1594788,Success,United Arab Emirates,DU UAE,Transguard Group LLC,API User,E6AEAE17361
2022-02-19 17:00,72717227,"29,491.0760","29,486.1760",05.00 AED,5.00,4.9000,0.1000,565042087,1594793,Success,United Arab Emirates,DU UAE,Transguard Group LLC,API User,E6AEAE17361
2022-02-19 17:00,72717229,"29,486.1760","29,476.3760",10.00 AED,10.00,9.8000,0.2000,565042091,1594794,Success,United Arab Emirates,DU UAE,Transguard Group LLC,API User,E6AEAE22430
2022-02-19 17:01,72717291,"29,476.3760","29,471.4760",05.00 AED,5.00,4.9000,0.1000,565042227,1594797,Success,United Arab Emirates,DU UAE,Transguard Group LLC,API User,E6AEAE17361
2022-02-19 17:02,72717313,"29,471.4760","29,461.6760",10.00 AED,10.00,9.8000,0.2000,565042275,1594800,Success,United Arab Emirates,DU UAE,Transguard Group LLC,API User,E6AEAE22430
2022-02-19 17:03,72717403,"29,461.6760","29,451.8760",10.00 AED,10.00,9.8000,0.2000,565042501,1594805,Success,United Arab Emirates,DU UAE,Transguard Group LLC,API User,E6AEAE22430
2022-02-19 17:03,72717410,"29,451.8760","29,442.0760",10.00 AED,10.00,9.8000,0.2000,565042518,1594806,Success,United Arab Emirates,DU UAE,Transguard Group LLC,API User,E6AEAE22430
2022-02-19 17:05,72717504,"29,442.0760","29,437.8960",150.00 PKR,4.75,4.1800,0.5700,565042762,1594809,Success,Pakistan,Jazz Pakistan,Transguard Group LLC,API User,MBPKPK20699
2022-02-19 17:07,72717627,"29,437.8960","29,428.0960",10.00 AED,10.00,9.8000,0.2000,565043093,1594817,Success,United Arab Emirates,DU UAE,Transguard Group LLC,API User,E6AEAE22430
2022-02-19 17:07,72717653,"29,428.0960","29,418.2960",10.00 AED,10.00,9.8000,0.2000,565043160,1594819,Success,United Arab Emirates,DU UAE,Transguard Group LLC,API User,E6AEAE22430
2022-02-19 17:09,72717796,"29,418.2960","29,408.4960",10.00 AED,10.00,9.8000,0.2000,565043553,1594832,Success,United Arab Emirates,DU UAE,Transguard Group LLC,API User,E6AEAE22430
2022-02-19 17:10,72717844,"29,408.4960","29,403.5960",05.00 AED,5.00,4.9000,0.1000,565043707,1594835,Success,United Arab Emirates,DU UAE,Transguard Group LLC,API User,E6AEAE17361
2022-02-19 17:12,72717974,"29,403.5960","29,398.6960",05.00 AED,5.00,4.9000,0.1000,565044027,1594842,Success,United Arab Emirates,DU UAE,Transguard Group LLC,API User,E6AEAE17361
2022-02-19 17:15,72718127,"29,398.6960","29,393.7960",05.00 AED,5.00,4.9000,0.1000,565044476,1594851,Success,United Arab Emirates,DU UAE,Transguard Group LLC,API User,E6AEAE17361
2022-02-19 17:16,72718157,"29,393.7960","29,383.9960",10.00 AED,10.00,9.8000,0.2000,565044553,1594853,Success,United Arab Emirates,DU UAE,Transguard Group LLC,API User,E6AEAE22430
2022-02-19 17:18,72718311,"29,383.9960","29,379.0960",05.00 AED,5.00,4.9000,0.1000,565044974,1594858,Success,United Arab Emirates,DU UAE,Transguard Group LLC,API User,E6AEAE17361
2022-02-19 17:18,72718317,"29,379.0960","29,374.1960",05.00 AED,5.00,4.9000,0.1000,565044984,1594859,Success,United Arab Emirates,DU UAE,Transguard Group LLC,API User,E6AEAE17361
2022-02-19 17:19,72718391,"29,374.1960","29,364.3960",10.00 AED,10.00,9.8000,0.2000,565045197,1594865,Success,United Arab Emirates,DU UAE,Transguard Group LLC,API User,E6AEAE22430
2022-02-19 17:19,72718408,"29,364.3960","29,359.4960",05.00 AED,5.00,4.9000,0.1000,565045234,1594867,Success,United Arab Emirates,DU UAE,Transguard Group LLC,API User,E6AEAE17361
2022-02-19 17:21,72718535,"29,359.4960","29,354.5960",05.00 AED,5.00,4.9000,0.1000,565045576,1594872,Success,United Arab Emirates,DU UAE,Transguard Group LLC,API User,E6AEAE17361
2022-02-19 17:27,72718880,"29,354.5960","29,334.9960",20.00 AED,20.00,19.6000,0.4000,565046571,1594881,Success,United Arab Emirates,DU UAE,Transguard Group LLC,API User,E6AEAE12938
2022-02-19 17:27,72718888,"29,334.9960","29,325.1960",10.00 AED,10.00,9.8000,0.2000,565046586,1594882,Success,United Arab Emirates,DU UAE,Transguard Group LLC,API User,E6AEAE22430
2022-02-19 17:31,72719143,"29,325.1960","29,320.2960",05.00 AED,5.00,4.9000,0.1000,565047307,1594894,Success,United Arab Emirates,DU UAE,Transguard Group LLC,API User,E6AEAE17361
2022-02-19 17:33,72719297,"29,320.2960","29,310.4960",10.00 AED,10.00,9.8000,0.2000,565047729,1594900,Success,United Arab Emirates,DU UAE,Transguard Group LLC,API User,E6AEAE22430
2022-02-19 17:34,72719347,"29,310.4960","29,300.6960",10.00 AED,10.00,9.8000,0.2000,565047862,1594904,Success,United Arab Emirates,DU UAE,Transguard Group LLC,API User,E6AEAE22430
2022-02-19 17:35,72719398,"29,300.6960","29,295.7960",05.00 AED,5.00,4.9000,0.1000,565048020,1594907,Success,United Arab Emirates,DU UAE,Transguard Group LLC,API User,E6AEAE17361
2022-02-19 17:45,72720057,"29,295.7960","29,290.8960",05.00 AED,5.00,4.9000,0.1000,565049808,1594919,Success,United Arab Emirates,DU UAE,Transguard Group LLC,API User,E6AEAE17361
2022-02-19 17:45,72720108,"29,290.8960","29,285.9960",05.00 AED,5.00,4.9000,0.1000,565049903,1594923,Success,United Arab Emirates,DU UAE,Transguard Group LLC,API User,E6AEAE17361
2022-02-19 17:46,72720185,"29,285.9960","29,281.0960",05.00 AED,5.00,4.9000,0.1000,565050113,1594926,Success,United Arab Emirates,DU UAE,Transguard Group LLC,API User,E6AEAE17361
2022-02-19 17:48,72720320,"29,281.0960","29,271.2960",10.00 AED,10.00,9.8000,0.2000,565050436,1594931,Success,United Arab Emirates,DU UAE,Transguard Group LLC,API User,E6AEAE22430
2022-02-19 17:48,72720327,"29,271.2960","29,261.4960",10.00 AED,10.00,9.8000,0.2000,565050448,1594932,Success,United Arab Emirates,DU UAE,Transguard Group LLC,API User,E6AEAE22430
2022-02-19 17:59,72721130,"29,261.4960","29,256.5960",05.00 AED,5.00,4.9000,0.1000,565052593,1594945,Success,United Arab Emirates,DU UAE,Transguard Group LLC,API User,E6AEAE17361
2022-02-19 18:00,72721158,"29,256.5960","29,247.7960",315.00 PKR,10.00,8.8000,1.2000,565052674,1594951,Success,Pakistan,Telenor Pakistan,Transguard Group LLC,API User,TPPKPK75105
2022-02-19 18:01,72721226,"29,247.7960","29,228.1960",20.00 AED,20.00,19.6000,0.4000,565052907,1594958,Success,United Arab Emirates,DU UAE,Transguard Group LLC,API User,E6AEAE12938
2022-02-19 18:03,72721383,"29,228.1960","29,223.2960",05.00 AED,5.00,4.9000,0.1000,565053342,1594961,Success,United Arab Emirates,DU UAE,Transguard Group LLC,API User,E6AEAE17361
2022-02-19 18:07,72721764,"29,223.2960","29,213.4960",10.00 AED,10.00,9.8000,0.2000,565054367,1594966,Success,United Arab Emirates,DU UAE,Transguard Group LLC,API User,E6AEAE22430
2022-02-19 18:10,72721981,"29,213.4960","29,208.5960",05.00 AED,5.00,4.9000,0.1000,565054997,1594972,Success,United Arab Emirates,DU UAE,Transguard Group LLC,API User,E6AEAE17361
2022-02-19 18:11,72722015,"29,208.5960","29,198.7960",10.00 AED,10.00,9.8000,0.2000,565055085,1594978,Success,United Arab Emirates,DU UAE,Transguard Group LLC,API User,E6AEAE22430
2022-02-19 18:11,72722037,"29,198.7960","29,193.8960",05.00 AED,5.00,4.9000,0.1000,565055136,1594979,Success,United Arab Emirates,DU UAE,Transguard Group LLC,API User,E6AEAE17361
2022-02-19 18:12,72722135,"29,193.8960","29,188.9960",05.00 AED,5.00,4.9000,0.1000,565055386,1594984,Success,United Arab Emirates,DU UAE,Transguard Group LLC,API User,E6AEAE17361
2022-02-19 18:13,72722202,"29,188.9960","29,184.0960",05.00 AED,5.00,4.9000,0.1000,565055565,1594987,Success,United Arab Emirates,DU UAE,Transguard Group LLC,API User,E6AEAE17361
2022-02-19 18:14,72722267,"29,184.0960","29,174.2960",10.00 AED,10.00,9.8000,0.2000,565055715,1594992,Success,United Arab Emirates,DU UAE,Transguard Group LLC,API User,E6AEAE22430
2022-02-19 18:15,72722354,"29,174.2960","29,164.4960",10.00 AED,10.00,9.8000,0.2000,565055975,1594997,Success,United Arab Emirates,DU UAE,Transguard Group LLC,API User,E6AEAE22430
2022-02-19 18:19,72722719,"29,164.4960","29,154.6960",10.00 AED,10.00,9.8000,0.2000,565056859,1595002,Success,United Arab Emirates,DU UAE,Transguard Group LLC,API User,E6AEAE22430
2022-02-19 18:22,72722924,"29,154.6960","29,149.7960",05.00 AED,5.00,4.9000,0.1000,565057434,1595005,Success,United Arab Emirates,DU UAE,Transguard Group LLC,API User,E6AEAE17361
2022-02-19 18:23,72723021,"29,149.7960","29,139.9960",10.00 AED,10.00,9.8000,0.2000,565057695,1595008,Success,United Arab Emirates,DU UAE,Transguard Group LLC,API User,E6AEAE22430
2022-02-19 18:24,72723102,"29,139.9960","29,135.0960",05.00 AED,5.00,4.9000,0.1000,565057956,1595013,Success,United Arab Emirates,DU UAE,Transguard Group LLC,API User,E6AEAE17361
2022-02-19 18:26,72723296,"29,135.0960","29,130.1960",05.00 AED,5.00,4.9000,0.1000,565058504,1595027,Success,United Arab Emirates,DU UAE,Transguard Group LLC,API User,E6AEAE17361
2022-02-19 18:28,72723402,"29,130.1960","29,125.2960",05.00 AED,5.00,4.9000,0.1000,565058774,1595033,Success,United Arab Emirates,DU UAE,Transguard Group LLC,API User,E6AEAE17361
2022-02-19 18:28,72723460,"29,125.2960","29,115.4960",10.00 AED,10.00,9.8000,0.2000,565058917,1595037,Success,United Arab Emirates,DU UAE,Transguard Group LLC,API User,E6AEAE22430
2022-02-19 18:29,72723478,"29,115.4960","29,110.5960",05.00 AED,5.00,4.9000,0.1000,565058960,1595041,Success,United Arab Emirates,DU UAE,Transguard Group LLC,API User,E6AEAE17361
2022-02-19 18:32,72723807,"29,110.5960","29,105.6960",05.00 AED,5.00,4.9000,0.1000,565059827,1595050,Success,United Arab Emirates,DU UAE,Transguard Group LLC,API User,E6AEAE17361
2022-02-19 18:33,72723834,"29,105.6960","29,095.8960",10.00 AED,10.00,9.8000,0.2000,565059886,1595053,Success,United Arab Emirates,DU UAE,Transguard Group LLC,API User,E6AEAE22430
2022-02-19 18:33,72723881,"29,095.8960","29,090.9960",05.00 AED,5.00,4.9000,0.1000,565060000,1595056,Success,United Arab Emirates,DU UAE,Transguard Group LLC,API User,E6AEAE17361
2022-02-19 18:34,72723949,"29,090.9960","29,081.1960",10.00 AED,10.00,9.8000,0.2000,565060176,1595061,Success,United Arab Emirates,DU UAE,Transguard Group LLC,API User,E6AEAE22430
2022-02-19 18:37,72724199,"29,081.1960","29,076.2960",05.00 AED,5.00,4.9000,0.1000,565060806,1595074,Success,United Arab Emirates,DU UAE,Transguard Group LLC,API User,E6AEAE17361
2022-02-19 18:39,72724403,"29,076.2960","29,066.4960",10.00 AED,10.00,9.8000,0.2000,565061259,1595084,Success,United Arab Emirates,DU UAE,Transguard Group LLC,API User,E6AEAE22430
2022-02-19 18:40,72724503,"29,066.4960","29,056.6960",10.00 AED,10.00,9.8000,0.2000,565061538,1595091,Success,United Arab Emirates,DU UAE,Transguard Group LLC,API User,E6AEAE22430
2022-02-19 18:42,72724731,"29,056.6960","29,052.9560",100.00 NPR,4.25,3.7400,0.5100,565062069,1595097,Success,Nepal,Ncell Nepal,Transguard Group LLC,API User,NP_NC_TopUp_100.00
2022-02-19 18:46,72725121,"29,052.9560","29,043.1560",10.00 AED,10.00,9.8000,0.2000,565063025,1595102,Success,United Arab Emirates,DU UAE,Transguard Group LLC,API User,E6AEAE22430
2022-02-19 18:47,72725226,"29,043.1560","29,035.0160",300.00 PKR,9.25,8.1400,1.1100,565063330,1595107,Success,Pakistan,Zong Pakistan,Transguard Group LLC,API User,ZNPKPK70504
2022-02-19 18:50,72725540,"29,035.0160","29,025.2160",10.00 AED,10.00,9.8000,0.2000,565064131,1595118,Success,United Arab Emirates,DU UAE,Transguard Group LLC,API User,E6AEAE22430
2022-02-19 18:51,72725560,"29,025.2160","29,015.4160",10.00 AED,10.00,9.8000,0.2000,565064194,1595119,Success,United Arab Emirates,DU UAE,Transguard Group LLC,API User,E6AEAE22430
2022-02-19 18:51,72725607,"29,015.4160","29,006.8360",315.00 PKR,9.75,8.5800,1.1700,565064316,1595122,Success,Pakistan,Zong Pakistan,Transguard Group LLC,API User,ZNPKPK29953
2022-02-19 18:53,72725733,"29,006.8360","28,998.4760",300.00 PKR,9.50,8.3600,1.1400,565064645,1595128,Success,Pakistan,Ufone Pakistan,Transguard Group LLC,API User,PK_UF_TopUp_300.00
2022-02-19 18:53,72725777,"28,998.4760","28,988.6760",10.00 AED,10.00,9.8000,0.2000,565064719,1595131,Success,United Arab Emirates,DU UAE,Transguard Group LLC,API User,E6AEAE22430
2022-02-19 18:53,72725781,"28,988.6760","28,946.6560","1,500.00 PKR",47.75,42.0200,5.7300,565064773,1595133,Success,Pakistan,Telenor Pakistan,Transguard Group LLC,API User,TPPKPK91237
2022-02-19 18:53,72725803,"28,946.6560","28,941.7560",05.00 AED,5.00,4.9000,0.1000,565064831,1595136,Success,United Arab Emirates,DU UAE,Transguard Group LLC,API User,E6AEAE17361
2022-02-19 19:02,72726645,"28,941.7560","28,936.8560",05.00 AED,5.00,4.9000,0.1000,565066911,1595144,Success,United Arab Emirates,DU UAE,Transguard Group LLC,API User,E6AEAE17361
2022-02-19 19:02,72726688,"28,936.8560","28,931.9560",05.00 AED,5.00,4.9000,0.1000,565067018,1595148,Success,United Arab Emirates,DU UAE,Transguard Group LLC,API User,E6AEAE17361
2022-02-19 19:06,72727116,"28,931.9560","28,927.0560",05.00 AED,5.00,4.9000,0.1000,565067991,1595158,Success,United Arab Emirates,DU UAE,Transguard Group LLC,API User,E6AEAE17361
2022-02-19 19:06,72727117,"28,927.0560","28,917.2560",10.00 AED,10.00,9.8000,0.2000,565068008,1595159,Success,United Arab Emirates,DU UAE,Transguard Group LLC,API User,E6AEAE22430
2022-02-19 19:08,72727279,"28,917.2560","28,912.8560",06.60 GHS,5.00,4.4000,0.6000,565068431,1595164,Success,Ghana,MTN Ghana,Transguard Group LLC,API User,GH_MT_TopUp
2022-02-19 19:10,72727457,"28,912.8560","28,893.2560",20.00 AED,20.00,19.6000,0.4000,565068950,1595171,Success,United Arab Emirates,DU UAE,Transguard Group LLC,API User,E6AEAE12938
2022-02-19 19:13,72727679,"28,893.2560","28,888.3560",05.00 AED,5.00,4.9000,0.1000,565069564,1595181,Success,United Arab Emirates,DU UAE,Transguard Group LLC,API User,E6AEAE17361
2022-02-19 19:13,72727710,"28,888.3560","28,878.5560",10.00 AED,10.00,9.8000,0.2000,565069654,1595185,Success,United Arab Emirates,DU UAE,Transguard Group LLC,API User,E6AEAE22430
2022-02-19 19:13,72727735,"28,878.5560","28,873.6560",05.00 AED,5.00,4.9000,0.1000,565069712,1595189,Success,United Arab Emirates,DU UAE,Transguard Group LLC,API User,E6AEAE17361
2022-02-19 19:15,72727871,"28,873.6560","28,863.8560",10.00 AED,10.00,9.8000,0.2000,565070068,1595192,Success,United Arab Emirates,DU UAE,Transguard Group LLC,API User,E6AEAE22430
2022-02-19 19:19,72728313,"28,863.8560","28,858.9560",05.00 AED,5.00,4.9000,0.1000,565071177,1595197,Success,United Arab Emirates,DU UAE,Transguard Group LLC,API User,E6AEAE17361
2022-02-19 19:19,72728315,"28,858.9560","28,854.0560",05.00 AED,5.00,4.9000,0.1000,565071186,1595198,Success,United Arab Emirates,DU UAE,Transguard Group LLC,API User,E6AEAE17361
2022-02-19 19:20,72728423,"28,854.0560","28,849.1560",05.00 AED,5.00,4.9000,0.1000,565071483,1595201,Success,United Arab Emirates,DU UAE,Transguard Group LLC,API User,E6AEAE17361
2022-02-19 19:21,72728498,"28,849.1560","28,844.2560",05.00 AED,5.00,4.9000,0.1000,565071702,1595204,Success,United Arab Emirates,DU UAE,Transguard Group LLC,API User,E6AEAE17361
2022-02-19 19:24,72728769,"28,844.2560","28,839.3560",05.00 AED,5.00,4.9000,0.1000,565072377,1595207,Success,United Arab Emirates,DU UAE,Transguard Group LLC,API User,E6AEAE17361
2022-02-19 19:25,72728884,"28,839.3560","28,834.4560",05.00 AED,5.00,4.9000,0.1000,565072686,1595212,Success,United Arab Emirates,DU UAE,Transguard Group LLC,API User,E6AEAE17361
2022-02-19 19:25,72728892,"28,834.4560","28,829.5560",05.00 AED,5.00,4.9000,0.1000,565072730,1595213,Success,United Arab Emirates,DU UAE,Transguard Group LLC,API User,E6AEAE17361
2022-02-19 19:27,72729000,"28,829.5560","28,824.6560",05.00 AED,5.00,4.9000,0.1000,565072993,1595218,Success,United Arab Emirates,DU UAE,Transguard Group LLC,API User,E6AEAE17361
2022-02-19 19:27,72729013,"28,824.6560","28,814.8560",10.00 AED,10.00,9.8000,0.2000,565073005,1595219,Success,United Arab Emirates,DU UAE,Transguard Group LLC,API User,E6AEAE22430
2022-02-19 19:29,72729169,"28,814.8560","28,805.0560",10.00 AED,10.00,9.8000,0.2000,565073457,1595228,Success,United Arab Emirates,DU UAE,Transguard Group LLC,API User,E6AEAE22430
2022-02-19 19:31,72729412,"28,805.0560","28,800.1560",05.00 AED,5.00,4.9000,0.1000,565074163,1595236,Success,United Arab Emirates,DU UAE,Transguard Group LLC,API User,E6AEAE17361
2022-02-19 19:34,72729662,"28,800.1560","28,790.3560",10.00 AED,10.00,9.8000,0.2000,565074768,1595241,Success,United Arab Emirates,DU UAE,Transguard Group LLC,API User,E6AEAE22430
2022-02-19 19:35,72729725,"28,790.3560","28,785.4560",05.00 AED,5.00,4.9000,0.1000,565074926,1595244,Success,United Arab Emirates,DU UAE,Transguard Group LLC,API User,E6AEAE17361
2022-02-19 19:37,72729997,"28,785.4560","28,781.7160",151.00 PKR,4.25,3.7400,0.5100,565075635,1595255,Success,Pakistan,Telenor Pakistan,Transguard Group LLC,API User,TPPKPK94108
2022-02-19 19:38,72730051,"28,781.7160","28,776.8160",05.00 AED,5.00,4.9000,0.1000,565075737,1595258,Success,United Arab Emirates,DU UAE,Transguard Group LLC,API User,E6AEAE17361
2022-02-19 19:38,72730095,"28,776.8160","28,771.9160",05.00 AED,5.00,4.9000,0.1000,565075868,1595262,Success,United Arab Emirates,DU UAE,Transguard Group LLC,API User,E6AEAE17361
2022-02-19 19:40,72730202,"28,771.9160","28,762.1160",10.00 AED,10.00,9.8000,0.2000,565076161,1595266,Success,United Arab Emirates,DU UAE,Transguard Group LLC,API User,E6AEAE22430
2022-02-19 19:41,72730378,"28,762.1160","28,757.2160",05.00 AED,5.00,4.9000,0.1000,565076649,1595275,Success,United Arab Emirates,DU UAE,Transguard Group LLC,API User,E6AEAE17361
2022-02-19 19:49,72731020,"28,757.2160","28,747.4160",10.00 AED,10.00,9.8000,0.2000,565078395,1595292,Success,United Arab Emirates,DU UAE,Transguard Group LLC,API User,E6AEAE22430
2022-02-19 19:49,72731048,"28,747.4160","28,737.6160",10.00 AED,10.00,9.8000,0.2000,565078485,1595296,Success,United Arab Emirates,DU UAE,Transguard Group LLC,API User,E6AEAE22430
2022-02-19 19:50,72731120,"28,737.6160","28,732.7160",05.00 AED,5.00,4.9000,0.1000,565078702,1595305,Success,United Arab Emirates,DU UAE,Transguard Group LLC,API User,E6AEAE17361
2022-02-19 19:54,72731497,"28,732.7160","28,715.1160",26.41 GHS,20.00,17.6000,2.4000,565079644,1595314,Success,Ghana,MTN Ghana,Transguard Group LLC,API User,GH_MT_TopUp
2022-02-19 19:56,72731671,"28,715.1160","28,705.3160",10.00 AED,10.00,9.8000,0.2000,565080129,1595319,Success,United Arab Emirates,DU UAE,Transguard Group LLC,API User,E6AEAE22430
2022-02-19 20:02,72732286,"28,705.3160","28,700.4160",05.00 AED,5.00,4.9000,0.1000,565081807,1595335,Success,United Arab Emirates,DU UAE,Transguard Group LLC,API User,E6AEAE17361
2022-02-19 20:04,72732420,"28,700.4160","28,695.5160",05.00 AED,5.00,4.9000,0.1000,565082166,1595342,Success,United Arab Emirates,DU UAE,Transguard Group LLC,API User,E6AEAE17361
2022-02-19 20:04,72732440,"28,695.5160","28,675.9160",20.00 AED,20.00,19.6000,0.4000,565082224,1595344,Success,United Arab Emirates,DU UAE,Transguard Group LLC,API User,E6AEAE12938
2022-02-19 20:07,72732746,"28,675.9160","28,671.7360",150.00 PKR,4.75,4.1800,0.5700,565083054,1595355,Success,Pakistan,Zong Pakistan,Transguard Group LLC,API User,ZNPKPK65621
2022-02-19 20:07,72732752,"28,671.7360","28,666.8360",05.00 AED,5.00,4.9000,0.1000,565083065,1595356,Success,United Arab Emirates,DU UAE,Transguard Group LLC,API User,E6AEAE17361
2022-02-19 20:08,72732759,"28,666.8360","28,661.9360",05.00 AED,5.00,4.9000,0.1000,565083096,1595359,Success,United Arab Emirates,DU UAE,Transguard Group LLC,API User,E6AEAE17361
2022-02-19 20:09,72732911,"28,661.9360","28,652.1360",10.00 AED,10.00,9.8000,0.2000,565083528,1595370,Success,United Arab Emirates,DU UAE,Transguard Group LLC,API User,E6AEAE22430
2022-02-19 20:10,72732960,"28,652.1360","28,642.3360",10.00 AED,10.00,9.8000,0.2000,565083678,1595374,Success,United Arab Emirates,DU UAE,Transguard Group LLC,API User,E6AEAE22430
2022-02-19 20:11,72733036,"28,642.3360","28,637.4360",05.00 AED,5.00,4.9000,0.1000,565083879,1595382,Success,United Arab Emirates,DU UAE,Transguard Group LLC,API User,E6AEAE17361
2022-02-19 20:11,72733072,"28,637.4360","28,617.8360",20.00 AED,20.00,19.6000,0.4000,565083964,1595387,Success,United Arab Emirates,DU UAE,Transguard Group LLC,API User,E6AEAE12938
2022-02-19 20:11,72733084,"28,617.8360","28,608.0360",10.00 AED,10.00,9.8000,0.2000,565083978,1595388,Success,United Arab Emirates,DU UAE,Transguard Group LLC,API User,E6AEAE22430
2022-02-19 20:12,72733188,"28,608.0360","28,598.2360",10.00 AED,10.00,9.8000,0.2000,565084235,1595393,Success,United Arab Emirates,DU UAE,Transguard Group LLC,API User,E6AEAE22430
2022-02-19 20:13,72733271,"28,598.2360","28,595.1560",98.00 PKR,3.50,3.0800,0.4200,565084474,1595400,Success,Pakistan,Zong Pakistan,Transguard Group LLC,API User,ZNPKPK66738
2022-02-19 20:14,72733377,"28,595.1560","28,582.3960",350.00 NPR,14.50,12.7600,1.7400,565084746,1595404,Success,Nepal,Ncell Nepal,Transguard Group LLC,API User,NCNPNP22699
2022-02-19 20:17,72733759,"28,582.3960","28,573.8160",315.00 PKR,9.75,8.5800,1.1700,565085663,1595411,Success,Pakistan,Zong Pakistan,Transguard Group LLC,API User,ZNPKPK29953
2022-02-19 20:19,72733937,"28,573.8160","28,565.6760",300.00 PKR,9.25,8.1400,1.1100,565086062,1595419,Success,Pakistan,Zong Pakistan,Transguard Group LLC,API User,ZNPKPK70504
2022-02-19 20:21,72734223,"28,565.6760","28,557.0960",315.00 PKR,9.75,8.5800,1.1700,565086756,1595431,Success,Pakistan,Zong Pakistan,Transguard Group LLC,API User,ZNPKPK29953
2022-02-19 20:22,72734282,"28,557.0960","28,547.2960",10.00 AED,10.00,9.8000,0.2000,565086857,1595434,Success,United Arab Emirates,DU UAE,Transguard Group LLC,API User,E6AEAE22430
2022-02-19 20:24,72734497,"28,547.2960","28,517.8960",30.00 AED,30.00,29.4000,0.6000,565087363,1595440,Success,United Arab Emirates,DU UAE,Transguard Group LLC,API User,E6AEAE46146
2022-02-19 20:24,72734551,"28,517.8960","28,512.9960",05.00 AED,5.00,4.9000,0.1000,565087468,1595443,Success,United Arab Emirates,DU UAE,Transguard Group LLC,API User,E6AEAE17361
2022-02-19 20:27,72734903,"28,512.9960","28,508.0960",05.00 AED,5.00,4.9000,0.1000,565088325,1595454,Success,United Arab Emirates,DU UAE,Transguard Group LLC,API User,E6AEAE17361
2022-02-19 20:27,72734914,"28,508.0960","28,498.2960",10.00 AED,10.00,9.8000,0.2000,565088354,1595455,Success,United Arab Emirates,DU UAE,Transguard Group LLC,API User,E6AEAE22430
2022-02-19 20:32,72735347,"28,498.2960","28,494.5560",100.00 NPR,4.25,3.7400,0.5100,565089455,1595460,Success,Nepal,Ncell Nepal,Transguard Group LLC,API User,NP_NC_TopUp_100.00
2022-02-19 20:33,72735521,"28,494.5560","28,484.7560",10.00 AED,10.00,9.8000,0.2000,565089864,1595463,Success,United Arab Emirates,DU UAE,Transguard Group LLC,API User,E6AEAE22430
2022-02-19 20:38,72735914,"28,484.7560","28,479.8560",05.00 AED,5.00,4.9000,0.1000,565090934,1595472,Success,United Arab Emirates,DU UAE,Transguard Group LLC,API User,E6AEAE17361
2022-02-19 20:42,72736385,"28,479.8560","28,474.9560",05.00 AED,5.00,4.9000,0.1000,565092118,1595488,Success,United Arab Emirates,DU UAE,Transguard Group LLC,API User,E6AEAE17361
2022-02-19 20:43,72736445,"28,474.9560","28,458.8960",575.00 PKR,18.25,16.0600,2.1900,565092277,1595490,Success,Pakistan,Telenor Pakistan,Transguard Group LLC,API User,TPPKPK7947
2022-02-19 20:44,72736601,"28,458.8960","28,449.0960",10.00 AED,10.00,9.8000,0.2000,565092607,1595500,Success,United Arab Emirates,DU UAE,Transguard Group LLC,API User,E6AEAE22430
2022-02-19 20:47,72736859,"28,449.0960","28,444.1960",05.00 AED,5.00,4.9000,0.1000,565093265,1595511,Success,United Arab Emirates,DU UAE,Transguard Group LLC,API User,E6AEAE17361
2022-02-19 20:48,72736974,"28,444.1960","28,434.3960",10.00 AED,10.00,9.8000,0.2000,565093544,1595515,Success,United Arab Emirates,DU UAE,Transguard Group LLC,API User,E6AEAE22430
2022-02-19 20:49,72736990,"28,434.3960","28,429.4960",05.00 AED,5.00,4.9000,0.1000,565093610,1595519,Success,United Arab Emirates,DU UAE,Transguard Group LLC,API User,E6AEAE17361
2022-02-19 20:49,72737037,"28,429.4960","28,424.5960",05.00 AED,5.00,4.9000,0.1000,565093720,1595524,Success,United Arab Emirates,DU UAE,Transguard Group LLC,API User,E6AEAE17361
2022-02-19 20:49,72737054,"28,424.5960","28,419.6960",05.00 AED,5.00,4.9000,0.1000,565093766,1595525,Success,United Arab Emirates,DU UAE,Transguard Group LLC,API User,E6AEAE17361
2022-02-19 20:51,72737259,"28,419.6960","28,409.8960",10.00 AED,10.00,9.8000,0.2000,565094292,1595532,Success,United Arab Emirates,DU UAE,Transguard Group LLC,API User,E6AEAE22430
2022-02-19 20:52,72737308,"28,409.8960","28,404.9960",05.00 AED,5.00,4.9000,0.1000,565094411,1595539,Success,United Arab Emirates,DU UAE,Transguard Group LLC,API User,E6AEAE17361
2022-02-19 20:52,72737332,"28,404.9960","28,400.0960",05.00 AED,5.00,4.9000,0.1000,565094472,1595541,Success,United Arab Emirates,DU UAE,Transguard Group LLC,API User,E6AEAE17361
2022-02-19 20:54,72737505,"28,400.0960","28,395.1960",05.00 AED,5.00,4.9000,0.1000,565094943,1595553,Success,United Arab Emirates,DU UAE,Transguard Group LLC,API User,E6AEAE17361
2022-02-19 20:54,72737522,"28,395.1960","28,390.2960",05.00 AED,5.00,4.9000,0.1000,565094978,1595557,Success,United Arab Emirates,DU UAE,Transguard Group LLC,API User,E6AEAE17361
2022-02-19 20:55,72737548,"28,390.2960","28,386.5560",100.00 NPR,4.25,3.7400,0.5100,565095049,1595559,Success,Nepal,Nepal Telecom Nepal,Transguard Group LLC,API User,NP_NE_TopUp_100.00
2022-02-19 20:56,72737704,"28,386.5560","28,381.6560",05.00 AED,5.00,4.9000,0.1000,565095480,1595568,Success,United Arab Emirates,DU UAE,Transguard Group LLC,API User,E6AEAE17361
2022-02-19 20:56,72737707,"28,381.6560","28,376.7560",05.00 AED,5.00,4.9000,0.1000,565095488,1595569,Success,United Arab Emirates,DU UAE,Transguard Group LLC,API User,E6AEAE17361
2022-02-19 20:57,72737796,"28,376.7560","28,373.0160",151.00 PKR,4.25,3.7400,0.5100,565095705,1595574,Success,Pakistan,Telenor Pakistan,Transguard Group LLC,API User,TPPKPK94108
2022-02-19 21:11,72739055,"28,373.0160","28,368.1160",05.00 AED,5.00,4.9000,0.1000,565099050,1595601,Success,United Arab Emirates,DU UAE,Transguard Group LLC,API User,E6AEAE17361
2022-02-19 21:12,72739155,"28,368.1160","28,358.3160",10.00 AED,10.00,9.8000,0.2000,565099310,1595604,Success,United Arab Emirates,DU UAE,Transguard Group LLC,API User,E6AEAE22430
2022-02-19 21:17,72739586,"28,358.3160","28,349.9560",300.00 PKR,9.50,8.3600,1.1400,565100484,1595611,Success,Pakistan,Jazz Pakistan,Transguard Group LLC,API User,PK_MB_TopUp_300.00
2022-02-19 21:21,72739966,"28,349.9560","28,340.1560",10.00 AED,10.00,9.8000,0.2000,565101509,1595624,Success,United Arab Emirates,DU UAE,Transguard Group LLC,API User,E6AEAE22430
2022-02-19 21:25,72740226,"28,340.1560","28,320.5560",20.00 AED,20.00,19.6000,0.4000,565102299,1595629,Success,United Arab Emirates,DU UAE,Transguard Group LLC,API User,E6AEAE12938
2022-02-19 21:32,72740861,"28,320.5560","28,310.7560",10.00 AED,10.00,9.8000,0.2000,565104030,1595637,Success,United Arab Emirates,DU UAE,Transguard Group LLC,API User,E6AEAE22430
2022-02-19 21:34,72740986,"28,310.7560","28,300.9560",10.00 AED,10.00,9.8000,0.2000,565104411,1595640,Success,United Arab Emirates,DU UAE,Transguard Group LLC,API User,E6AEAE22430
2022-02-19 21:45,72741913,"28,300.9560","28,291.1560",10.00 AED,10.00,9.8000,0.2000,565107035,1595652,Success,United Arab Emirates,DU UAE,Transguard Group LLC,API User,E6AEAE22430
2022-02-19 21:47,72742059,"28,291.1560","28,286.2560",05.00 AED,5.00,4.9000,0.1000,565107368,1595656,Success,United Arab Emirates,DU UAE,Transguard Group LLC,API User,E6AEAE17361
2022-02-19 21:47,72742106,"28,286.2560","28,281.3560",05.00 AED,5.00,4.9000,0.1000,565107503,1595661,Success,United Arab Emirates,DU UAE,Transguard Group LLC,API User,E6AEAE17361
2022-02-19 21:48,72742177,"28,281.3560","28,276.4560",05.00 AED,5.00,4.9000,0.1000,565107694,1595668,Success,United Arab Emirates,DU UAE,Transguard Group LLC,API User,E6AEAE17361
2022-02-19 21:50,72742283,"28,276.4560","28,256.8560",20.00 AED,20.00,19.6000,0.4000,565107982,1595679,Success,United Arab Emirates,DU UAE,Transguard Group LLC,API User,E6AEAE12938
2022-02-19 21:54,72742606,"28,256.8560","28,251.9560",05.00 AED,5.00,4.9000,0.1000,565108943,1595699,Success,United Arab Emirates,DU UAE,Transguard Group LLC,API User,E6AEAE17361
2022-02-19 21:57,72742794,"28,251.9560","28,232.3560",20.00 AED,20.00,19.6000,0.4000,565109559,1595706,Success,United Arab Emirates,DU UAE,Transguard Group LLC,API User,E6AEAE12938
2022-02-19 22:04,72743359,"28,232.3560","28,222.5560",10.00 AED,10.00,9.8000,0.2000,565111050,1595722,Success,United Arab Emirates,DU UAE,Transguard Group LLC,API User,E6AEAE22430
2022-02-19 22:10,72743737,"28,222.5560","28,217.6560",05.00 AED,5.00,4.9000,0.1000,565112208,1595732,Success,United Arab Emirates,DU UAE,Transguard Group LLC,API User,E6AEAE17361
2022-02-19 22:11,72743835,"28,217.6560","28,212.7560",05.00 AED,5.00,4.9000,0.1000,565112528,1595737,Success,United Arab Emirates,DU UAE,Transguard Group LLC,API User,E6AEAE17361
2022-02-19 22:20,72744412,"28,212.7560","28,207.8560",05.00 AED,5.00,4.9000,0.1000,565114474,1595743,Success,United Arab Emirates,DU UAE,Transguard Group LLC,API User,E6AEAE17361
2022-02-19 22:21,72744474,"28,207.8560","28,198.0560",10.00 AED,10.00,9.8000,0.2000,565114673,1595750,Success,United Arab Emirates,DU UAE,Transguard Group LLC,API User,E6AEAE22430
2022-02-19 22:34,72745340,"28,198.0560","28,193.1560",05.00 AED,5.00,4.9000,0.1000,565117194,1595767,Success,United Arab Emirates,DU UAE,Transguard Group LLC,API User,E6AEAE17361
2022-02-19 22:37,72745537,"28,193.1560","28,188.2560",05.00 AED,5.00,4.9000,0.1000,565117804,1595771,Success,United Arab Emirates,DU UAE,Transguard Group LLC,API User,E6AEAE17361
2022-02-19 22:47,72746087,"28,188.2560","28,171.9760",200.00 PHP,18.50,16.2800,2.2200,565119617,1595783,Success,Philippines,Smart (SunCellular) Philippines,Transguard Group LLC,API User,PH_SM_TopUp_200.00
2022-02-19 22:52,72746401,"28,171.9760","28,162.1760",10.00 AED,10.00,9.8000,0.2000,565120531,1595788,Success,United Arab Emirates,DU UAE,Transguard Group LLC,API User,E6AEAE22430
2022-02-19 22:52,72746450,"28,162.1760","28,152.3760",10.00 AED,10.00,9.8000,0.2000,565120671,1595792,Success,United Arab Emirates,DU UAE,Transguard Group LLC,API User,E6AEAE22430
2022-02-19 22:53,72746494,"28,152.3760","28,142.5760",10.00 AED,10.00,9.8000,0.2000,565120821,1595796,Success,United Arab Emirates,DU UAE,Transguard Group LLC,API User,E6AEAE22430
2022-02-19 23:11,72747476,"28,142.5760","28,137.6760",05.00 AED,5.00,4.9000,0.1000,565123998,1595814,Success,United Arab Emirates,DU UAE,Transguard Group LLC,API User,E6AEAE17361
2022-02-19 23:20,72747989,"28,137.6760","28,108.2760",30.00 AED,30.00,29.4000,0.6000,565125577,1595818,Success,United Arab Emirates,DU UAE,Transguard Group LLC,API User,E6AEAE46146
2022-02-19 23:23,72748120,"28,108.2760","28,098.4760",10.00 AED,10.00,9.8000,0.2000,565125986,1595821,Success,United Arab Emirates,DU UAE,Transguard Group LLC,API User,E6AEAE22430
2022-02-19 23:34,72748691,"28,098.4760","28,088.6760",10.00 AED,10.00,9.8000,0.2000,565127814,1595831,Success,United Arab Emirates,DU UAE,Transguard Group LLC,API User,E6AEAE22430
2022-02-19 23:40,72748989,"28,088.6760","28,083.7760",05.00 AED,5.00,4.9000,0.1000,565128807,1595836,Success,United Arab Emirates,DU UAE,Transguard Group LLC,API User,E6AEAE17361
2022-02-19 23:46,72749256,"28,083.7760","28,078.8760",05.00 AED,5.00,4.9000,0.1000,565129690,1595842,Success,United Arab Emirates,DU UAE,Transguard Group LLC,API User,E6AEAE17361
2022-02-19 23:49,72749440,"28,078.8760","28,073.9760",05.00 AED,5.00,4.9000,0.1000,565130230,1595846,Success,United Arab Emirates,DU UAE,Transguard Group LLC,API User,E6AEAE17361
2022-02-19 23:51,72749521,"28,073.9760","28,069.0760",05.00 AED,5.00,4.9000,0.1000,565130552,1595849,Success,United Arab Emirates,DU UAE,Transguard Group LLC,API User,E6AEAE17361
2022-02-19 23:52,72749584,"28,069.0760","28,064.1760",05.00 AED,5.00,4.9000,0.1000,565130751,1595852,Success,United Arab Emirates,DU UAE,Transguard Group LLC,API User,E6AEAE17361
2022-02-20 00:20,72751293,"28,064.1760","28,059.2760",05.00 AED,5.00,4.9000,0.1000,565135369,1595866,Success,United Arab Emirates,DU UAE,Transguard Group LLC,API User,E6AEAE17361
2022-02-20 00:56,72753394,"28,059.2760","28,054.3760",05.00 AED,5.00,4.9000,0.1000,565141116,1595880,Success,United Arab Emirates,DU UAE,Transguard Group LLC,API User,E6AEAE17361
2022-02-20 01:08,72754049,"28,054.3760","28,049.4760",05.00 AED,5.00,4.9000,0.1000,565142906,1595885,Success,United Arab Emirates,DU UAE,Transguard Group LLC,API User,E6AEAE17361
2022-02-20 01:15,72754430,"28,049.4760","28,039.6760",10.00 AED,10.00,9.8000,0.2000,565143999,1595890,Success,United Arab Emirates,DU UAE,Transguard Group LLC,API User,E6AEAE22430
2022-02-20 01:22,72754805,"28,039.6760","28,029.8760",10.00 AED,10.00,9.8000,0.2000,565145086,1595895,Success,United Arab Emirates,DU UAE,Transguard Group LLC,API User,E6AEAE22430
2022-02-20 01:23,72754880,"28,029.8760","28,024.9760",05.00 AED,5.00,4.9000,0.1000,565145253,1595898,Success,United Arab Emirates,DU UAE,Transguard Group LLC,API User,E6AEAE17361
2022-02-20 01:28,72755126,"28,024.9760","28,015.1760",10.00 AED,10.00,9.8000,0.2000,565145987,1595901,Success,United Arab Emirates,DU UAE,Transguard Group LLC,API User,E6AEAE22430
2022-02-20 01:38,72755556,"28,015.1760","28,007.9160",200.00 NPR,8.25,7.2600,0.9900,565147314,1595904,Success,Nepal,Nepal Telecom Nepal,Transguard Group LLC,API User,NP_NE_TopUp_200.00
2022-02-20 01:53,72756323,"28,007.9160","28,003.0160",05.00 AED,5.00,4.9000,0.1000,565149759,1595907,Success,United Arab Emirates,DU UAE,Transguard Group LLC,API User,E6AEAE17361
2022-02-20 02:01,72756690,"28,003.0160","27,993.2160",10.00 AED,10.00,9.8000,0.2000,565150827,1595912,Success,United Arab Emirates,DU UAE,Transguard Group LLC,API User,E6AEAE22430
2022-02-20 02:17,72757457,"27,993.2160","27,988.3160",05.00 AED,5.00,4.9000,0.1000,565153286,1595917,Success,United Arab Emirates,DU UAE,Transguard Group LLC,API User,E6AEAE17361
2022-02-20 02:21,72757639,"27,988.3160","27,981.0560",200.00 NPR,8.25,7.2600,0.9900,565153864,1595920,Success,Nepal,Nepal Telecom Nepal,Transguard Group LLC,API User,NP_NE_TopUp_200.00
2022-02-20 02:24,72757767,"27,981.0560","27,976.1560",05.00 AED,5.00,4.9000,0.1000,565154255,1595926,Success,United Arab Emirates,DU UAE,Transguard Group LLC,API User,E6AEAE17361
2022-02-20 02:24,72757787,"27,976.1560","27,966.3560",10.00 AED,10.00,9.8000,0.2000,565154309,1595928,Success,United Arab Emirates,DU UAE,Transguard Group LLC,API User,E6AEAE22430
2022-02-20 02:25,72757842,"27,966.3560","27,961.4560",05.00 AED,5.00,4.9000,0.1000,565154469,1595931,Success,United Arab Emirates,DU UAE,Transguard Group LLC,API User,E6AEAE17361
2022-02-20 02:37,72758372,"27,961.4560","27,951.6560",10.00 AED,10.00,9.8000,0.2000,565156249,1595934,Success,United Arab Emirates,DU UAE,Transguard Group LLC,API User,E6AEAE22430
2022-02-20 02:43,72758695,"27,951.6560","27,946.7560",05.00 AED,5.00,4.9000,0.1000,565157206,1595939,Success,United Arab Emirates,DU UAE,Transguard Group LLC,API User,E6AEAE17361
2022-02-20 02:50,72759056,"27,946.7560","27,927.1560",20.00 AED,20.00,19.6000,0.4000,565158321,1595944,Success,United Arab Emirates,DU UAE,Transguard Group LLC,API User,E6AEAE12938
2022-02-20 03:20,72760499,"27,927.1560","27,917.3560",10.00 AED,10.00,9.8000,0.2000,565162692,1595952,Success,United Arab Emirates,DU UAE,Transguard Group LLC,API User,E6AEAE22430
2022-02-20 03:28,72760929,"27,917.3560","27,912.4560",05.00 AED,5.00,4.9000,0.1000,565163942,1595957,Success,United Arab Emirates,DU UAE,Transguard Group LLC,API User,E6AEAE17361
2022-02-20 03:29,72760996,"27,912.4560","27,907.5560",05.00 AED,5.00,4.9000,0.1000,565164126,1595961,Success,United Arab Emirates,DU UAE,Transguard Group LLC,API User,E6AEAE17361
2022-02-20 03:31,72761112,"27,907.5560","27,897.7560",10.00 AED,10.00,9.8000,0.2000,565164536,1595969,Success,United Arab Emirates,DU UAE,Transguard Group LLC,API User,E6AEAE22430
2022-02-20 03:32,72761130,"27,897.7560","27,887.9560",10.00 AED,10.00,9.8000,0.2000,565164572,1595970,Success,United Arab Emirates,DU UAE,Transguard Group LLC,API User,E6AEAE22430
2022-02-20 03:35,72761274,"27,887.9560","27,878.1560",10.00 AED,10.00,9.8000,0.2000,565165015,1595973,Success,United Arab Emirates,DU UAE,Transguard Group LLC,API User,E6AEAE22430
2022-02-20 03:37,72761377,"27,878.1560","27,873.2560",05.00 AED,5.00,4.9000,0.1000,565165361,1595976,Success,United Arab Emirates,DU UAE,Transguard Group LLC,API User,E6AEAE17361
2022-02-20 03:49,72762042,"27,873.2560","27,868.3560",05.00 AED,5.00,4.9000,0.1000,565167432,1595983,Success,United Arab Emirates,DU UAE,Transguard Group LLC,API User,E6AEAE17361
2022-02-20 04:21,72763516,"27,868.3560","27,863.4560",05.00 AED,5.00,4.9000,0.1000,565172184,1595988,Success,United Arab Emirates,DU UAE,Transguard Group LLC,API User,E6AEAE17361
2022-02-20 04:25,72763695,"27,863.4560","27,858.5560",05.00 AED,5.00,4.9000,0.1000,565172750,1595993,Success,United Arab Emirates,DU UAE,Transguard Group LLC,API User,E6AEAE17361
2022-02-20 04:25,72763697,"27,858.5560","27,853.6560",05.00 AED,5.00,4.9000,0.1000,565172756,1595994,Success,United Arab Emirates,DU UAE,Transguard Group LLC,API User,E6AEAE17361
2022-02-20 04:51,72764881,"27,853.6560","27,848.7560",05.00 AED,5.00,4.9000,0.1000,565176401,1596014,Success,United Arab Emirates,DU UAE,Transguard Group LLC,API User,E6AEAE17361
2022-02-20 04:59,72765256,"27,848.7560","27,843.8560",05.00 AED,5.00,4.9000,0.1000,565177447,1596020,Success,United Arab Emirates,DU UAE,Transguard Group LLC,API User,E6AEAE17361
2022-02-20 05:02,72765403,"27,843.8560","27,838.9560",05.00 AED,5.00,4.9000,0.1000,565177828,1596030,Success,United Arab Emirates,DU UAE,Transguard Group LLC,API User,E6AEAE17361
2022-02-20 05:03,72765427,"27,838.9560","27,834.0560",05.00 AED,5.00,4.9000,0.1000,565177892,1596035,Success,United Arab Emirates,DU UAE,Transguard Group LLC,API User,E6AEAE17361
2022-02-20 05:03,72765441,"27,834.0560","27,794.8560",40.00 AED,40.00,39.2000,0.8000,565177926,1596036,Success,United Arab Emirates,DU UAE,Transguard Group LLC,API User,E6AEAE64011
2022-02-20 05:04,72765485,"27,794.8560","27,775.2560",20.00 AED,20.00,19.6000,0.4000,565178034,1596039,Success,United Arab Emirates,DU UAE,Transguard Group LLC,API User,E6AEAE12938
2022-02-20 05:05,72765561,"27,775.2560","27,770.3560",05.00 AED,5.00,4.9000,0.1000,565178248,1596042,Success,United Arab Emirates,DU UAE,Transguard Group LLC,API User,E6AEAE17361
2022-02-20 05:08,72765687,"27,770.3560","27,765.4560",05.00 AED,5.00,4.9000,0.1000,565178541,1596051,Success,United Arab Emirates,DU UAE,Transguard Group LLC,API User,E6AEAE17361
2022-02-20 05:09,72765739,"27,765.4560","27,749.1760",200.00 PHP,18.50,16.2800,2.2200,565178658,1596054,Success,Philippines,Smart (SunCellular) Philippines,Transguard Group LLC,API User,PH_SM_TopUp_200.00
2022-02-20 05:19,72766192,"27,749.1760","27,744.2760",05.00 AED,5.00,4.9000,0.1000,565179826,1596068,Success,United Arab Emirates,DU UAE,Transguard Group LLC,API User,E6AEAE17361
2022-02-20 05:21,72766329,"27,744.2760","27,739.3760",05.00 AED,5.00,4.9000,0.1000,565180189,1596073,Success,United Arab Emirates,DU UAE,Transguard Group LLC,API User,E6AEAE17361
2022-02-20 05:22,72766367,"27,739.3760","27,729.5760",10.00 AED,10.00,9.8000,0.2000,565180294,1596076,Success,United Arab Emirates,DU UAE,Transguard Group LLC,API User,E6AEAE22430
2022-02-20 05:24,72766437,"27,729.5760","27,724.6760",05.00 AED,5.00,4.9000,0.1000,565180438,1596079,Success,United Arab Emirates,DU UAE,Transguard Group LLC,API User,E6AEAE17361
2022-02-20 05:25,72766498,"27,724.6760","27,719.7760",05.00 AED,5.00,4.9000,0.1000,565180586,1596082,Success,United Arab Emirates,DU UAE,Transguard Group LLC,API User,E6AEAE17361
2022-02-20 05:32,72766855,"27,719.7760","27,709.9760",10.00 AED,10.00,9.8000,0.2000,565181469,1596087,Success,United Arab Emirates,DU UAE,Transguard Group LLC,API User,E6AEAE22430
2022-02-20 05:47,72767563,"27,709.9760","27,700.1760",10.00 AED,10.00,9.8000,0.2000,565183302,1596092,Failure,United Arab Emirates,DU UAE,Transguard Group LLC,API User,E6AEAE22430
2022-02-20 05:47,72767563,"27,700.1760","27,690.3760",10.00 AED,10.00,9.8000,0.2000,565183302,1596092,Failure,United Arab Emirates,DU UAE,Transguard Group LLC,API User,E6AEAE22430
2022-02-20 05:51,72767748,"27,709.9760","27,705.0760",05.00 AED,5.00,4.9000,0.1000,565183838,1596097,Success,United Arab Emirates,DU UAE,Transguard Group LLC,API User,E6AEAE17361
2022-02-20 05:54,72767902,"27,705.0760","27,695.2760",10.00 AED,10.00,9.8000,0.2000,565184220,1596100,Success,United Arab Emirates,DU UAE,Transguard Group LLC,API User,E6AEAE22430
2022-02-20 06:02,72768256,"27,695.2760","27,686.6960",315.00 PKR,9.75,8.5800,1.1700,565185165,1596115,Success,Pakistan,Zong Pakistan,Transguard Group LLC,API User,ZNPKPK29953
2022-02-20 06:03,72768304,"27,686.6960","27,657.2960",30.00 AED,30.00,29.4000,0.6000,565185285,1596119,Success,United Arab Emirates,DU UAE,Transguard Group LLC,API User,E6AEAE46146
2022-02-20 06:04,72768327,"27,657.2960","27,652.3960",05.00 AED,5.00,4.9000,0.1000,565185340,1596123,Success,United Arab Emirates,DU UAE,Transguard Group LLC,API User,E6AEAE17361
2022-02-20 06:05,72768383,"27,652.3960","27,627.8960",25.00 AED,25.00,24.5000,0.5000,565185471,1596127,Success,United Arab Emirates,DU UAE,Transguard Group LLC,API User,E6AEAE17343
2022-02-20 06:09,72768570,"27,627.8960","27,614.6960",667.20 LKR,15.00,13.2000,1.8000,565185945,1596136,Success,Sri Lanka,Dialog Sri Lanka,Transguard Group LLC,API User,LK_DG_TopUp
2022-02-20 06:09,72768582,"27,614.6960","27,609.7960",05.00 AED,5.00,4.9000,0.1000,565185958,1596137,Success,United Arab Emirates,DU UAE,Transguard Group LLC,API User,E6AEAE17361
2022-02-20 06:10,72768598,"27,609.7960","27,601.8760",220.00 NPR,9.00,7.9200,1.0800,565186000,1596140,Success,Nepal,Ncell Nepal,Transguard Group LLC,API User,NCNPNP79518
2022-02-20 06:23,72769338,"27,601.8760","27,592.0760",10.00 AED,10.00,9.8000,0.2000,565187666,1596151,Success,United Arab Emirates,DU UAE,Transguard Group LLC,API User,E6AEAE22430
2022-02-20 06:26,72769521,"27,592.0760","27,587.1760",05.00 AED,5.00,4.9000,0.1000,565188043,1596158,Success,United Arab Emirates,DU UAE,Transguard Group LLC,API User,E6AEAE17361
2022-02-20 06:27,72769571,"27,587.1760","27,582.2760",05.00 AED,5.00,4.9000,0.1000,565188151,1596160,Success,United Arab Emirates,DU UAE,Transguard Group LLC,API User,E6AEAE17361
2022-02-20 06:30,72769726,"27,582.2760","27,577.3760",05.00 AED,5.00,4.9000,0.1000,565188498,1596164,Success,United Arab Emirates,DU UAE,Transguard Group LLC,API User,E6AEAE17361
2022-02-20 06:31,72769775,"27,577.3760","27,568.5760",315.00 PKR,10.00,8.8000,1.2000,565188614,1596168,Success,Pakistan,Telenor Pakistan,Transguard Group LLC,API User,TPPKPK75105
2022-02-20 06:35,72769947,"27,568.5760","27,563.6760",05.00 AED,5.00,4.9000,0.1000,565188973,1596178,Success,United Arab Emirates,DU UAE,Transguard Group LLC,API User,E6AEAE17361
2022-02-20 06:45,72770433,"27,563.6760","27,553.8760",10.00 AED,10.00,9.8000,0.2000,565190127,1596189,Success,United Arab Emirates,DU UAE,Transguard Group LLC,API User,E6AEAE22430
2022-02-20 06:48,72770575,"27,553.8760","27,548.9760",05.00 AED,5.00,4.9000,0.1000,565190425,1596193,Success,United Arab Emirates,DU UAE,Transguard Group LLC,API User,E6AEAE17361
2022-02-20 06:50,72770685,"27,548.9760","27,544.0760",05.00 AED,5.00,4.9000,0.1000,565190682,1596198,Success,United Arab Emirates,DU UAE,Transguard Group LLC,API User,E6AEAE17361
2022-02-20 06:52,72770782,"27,544.0760","27,539.1760",05.00 AED,5.00,4.9000,0.1000,565190903,1596204,Success,United Arab Emirates,DU UAE,Transguard Group LLC,API User,E6AEAE17361
2022-02-20 07:02,72771215,"27,539.1760","27,525.9760","11,003.00 UGX",15.00,13.2000,1.8000,565191993,1596220,Success,Uganda,Airtel Uganda,Transguard Group LLC,API User,UG_WA_TopUp
2022-02-20 07:03,72771264,"27,525.9760","27,486.7760",40.00 AED,40.00,39.2000,0.8000,565192089,1596223,Success,United Arab Emirates,DU UAE,Transguard Group LLC,API User,E6AEAE64011
2022-02-20 07:04,72771291,"27,486.7760","27,481.8760",05.00 AED,5.00,4.9000,0.1000,565192148,1596226,Success,United Arab Emirates,DU UAE,Transguard Group LLC,API User,E6AEAE17361
2022-02-20 07:04,72771306,"27,481.8760","27,472.0760",10.00 AED,10.00,9.8000,0.2000,565192183,1596228,Success,United Arab Emirates,DU UAE,Transguard Group LLC,API User,E6AEAE22430
2022-02-20 07:06,72771376,"27,472.0760","27,462.2760",10.00 AED,10.00,9.8000,0.2000,565192361,1596231,Success,United Arab Emirates,DU UAE,Transguard Group LLC,API User,E6AEAE22430
2022-02-20 07:06,72771392,"27,462.2760","27,457.3760",05.00 AED,5.00,4.9000,0.1000,565192392,1596236,Success,United Arab Emirates,DU UAE,Transguard Group LLC,API User,E6AEAE17361
2022-02-20 07:21,72772069,"27,457.3760","27,452.4760",05.00 AED,5.00,4.9000,0.1000,565193927,1596250,Success,United Arab Emirates,DU UAE,Transguard Group LLC,API User,E6AEAE17361
2022-02-20 07:23,72772180,"27,452.4760","27,447.5760",05.00 AED,5.00,4.9000,0.1000,565194152,1596255,Success,United Arab Emirates,DU UAE,Transguard Group LLC,API User,E6AEAE17361
2022-02-20 07:27,72772392,"27,447.5760","27,437.7760",10.00 AED,10.00,9.8000,0.2000,565194662,1596262,Success,United Arab Emirates,DU UAE,Transguard Group LLC,API User,E6AEAE22430
2022-02-20 07:29,72772478,"27,437.7760","27,427.9760",10.00 AED,10.00,9.8000,0.2000,565194848,1596269,Success,United Arab Emirates,DU UAE,Transguard Group LLC,API User,E6AEAE22430
2022-02-20 07:30,72772511,"27,427.9760","27,423.0760",05.00 AED,5.00,4.9000,0.1000,565194926,1596272,Success,United Arab Emirates,DU UAE,Transguard Group LLC,API User,E6AEAE17361
2022-02-20 07:40,72772994,"27,423.0760","27,413.2760",10.00 AED,10.00,9.8000,0.2000,565195981,1596288,Success,United Arab Emirates,DU UAE,Transguard Group LLC,API User,E6AEAE22430
2022-02-20 07:42,72773076,"27,413.2760","27,408.3760",05.00 AED,5.00,4.9000,0.1000,565196167,1596293,Success,United Arab Emirates,DU UAE,Transguard Group LLC,API User,E6AEAE17361
2022-02-20 07:46,72773244,"27,408.3760","27,388.7760",20.00 AED,20.00,19.6000,0.4000,565196565,1596298,Success,United Arab Emirates,DU UAE,Transguard Group LLC,API User,E6AEAE12938
2022-02-20 07:47,72773275,"27,388.7760","27,378.9760",10.00 AED,10.00,9.8000,0.2000,565196632,1596302,Success,United Arab Emirates,DU UAE,Transguard Group LLC,API User,E6AEAE22430
2022-02-20 07:50,72773393,"27,378.9760","27,369.1760",10.00 AED,10.00,9.8000,0.2000,565196900,1596306,Success,United Arab Emirates,DU UAE,Transguard Group LLC,API User,E6AEAE22430
2022-02-20 07:51,72773455,"27,369.1760","27,359.3760",10.00 AED,10.00,9.8000,0.2000,565197053,1596315,Success,United Arab Emirates,DU UAE,Transguard Group LLC,API User,E6AEAE22430
2022-02-20 07:51,72773456,"27,359.3760","27,354.4760",05.00 AED,5.00,4.9000,0.1000,565197058,1596316,Success,United Arab Emirates,DU UAE,Transguard Group LLC,API User,E6AEAE17361
2022-02-20 07:54,72773595,"27,354.4760","27,344.6760",10.00 AED,10.00,9.8000,0.2000,565197357,1596325,Success,United Arab Emirates,DU UAE,Transguard Group LLC,API User,E6AEAE22430
2022-02-20 07:55,72773658,"27,344.6760","27,339.7760",05.00 AED,5.00,4.9000,0.1000,565197504,1596331,Success,United Arab Emirates,DU UAE,Transguard Group LLC,API User,E6AEAE17361
2022-02-20 07:56,72773682,"27,339.7760","27,320.1760",20.00 AED,20.00,19.6000,0.4000,565197559,1596334,Success,United Arab Emirates,DU UAE,Transguard Group LLC,API User,E6AEAE12938
2022-02-20 07:57,72773717,"27,320.1760","27,315.2760",05.00 AED,5.00,4.9000,0.1000,565197618,1596337,Success,United Arab Emirates,DU UAE,Transguard Group LLC,API User,E6AEAE17361
2022-02-20 07:58,72773774,"27,315.2760","27,295.6760",20.00 AED,20.00,19.6000,0.4000,565197761,1596341,Success,United Arab Emirates,DU UAE,Transguard Group LLC,API User,E6AEAE12938
2022-02-20 07:58,72773795,"27,295.6760","27,285.8760",10.00 AED,10.00,9.8000,0.2000,565197803,1596345,Success,United Arab Emirates,DU UAE,Transguard Group LLC,API User,E6AEAE22430
2022-02-20 08:01,72773919,"27,285.8760","27,276.0760",10.00 AED,10.00,9.8000,0.2000,565198070,1596353,Success,United Arab Emirates,DU UAE,Transguard Group LLC,API User,E6AEAE22430
2022-02-20 08:01,72773925,"27,276.0760","27,266.2760",10.00 AED,10.00,9.8000,0.2000,565198083,1596355,Success,United Arab Emirates,DU UAE,Transguard Group LLC,API User,E6AEAE22430
2022-02-20 08:04,72774075,"27,266.2760","27,256.4760",10.00 AED,10.00,9.8000,0.2000,565198397,1596361,Success,United Arab Emirates,DU UAE,Transguard Group LLC,API User,E6AEAE22430
2022-02-20 08:08,72774252,"27,256.4760","27,246.6760",10.00 AED,10.00,9.8000,0.2000,565198780,1596377,Success,United Arab Emirates,DU UAE,Transguard Group LLC,API User,E6AEAE22430
2022-02-20 08:08,72774260,"27,246.6760","27,241.7760",05.00 AED,5.00,4.9000,0.1000,565198799,1596379,Success,United Arab Emirates,DU UAE,Transguard Group LLC,API User,E6AEAE17361
2022-02-20 08:09,72774298,"27,241.7760","27,235.3960",110.00 INR,7.25,6.3800,0.8700,565198879,1596381,Success,India,BSNL India,Transguard Group LLC,API User,BLININ42833
2022-02-20 08:12,72774471,"27,235.3960","27,225.5960",10.00 AED,10.00,9.8000,0.2000,565199244,1596391,Success,United Arab Emirates,DU UAE,Transguard Group LLC,API User,E6AEAE22430
2022-02-20 08:14,72774573,"27,225.5960","27,205.9960",20.00 AED,20.00,19.6000,0.4000,565199449,1596399,Success,United Arab Emirates,DU UAE,Transguard Group LLC,API User,E6AEAE12938
2022-02-20 08:14,72774580,"27,205.9960","27,196.1960",10.00 AED,10.00,9.8000,0.2000,565199462,1596402,Success,United Arab Emirates,DU UAE,Transguard Group LLC,API User,E6AEAE22430
2022-02-20 08:17,72774780,"27,196.1960","27,187.3960",447.16 LKR,10.00,8.8000,1.2000,565199852,1596411,Success,Sri Lanka,Hutch (Etisalat) Sri Lanka,Transguard Group LLC,API User,LK_HS_TopUp
2022-02-20 08:19,72774857,"27,187.3960","27,182.4960",05.00 AED,5.00,4.9000,0.1000,565200024,1596418,Success,United Arab Emirates,DU UAE,Transguard Group LLC,API User,E6AEAE17361
2022-02-20 08:20,72774900,"27,182.4960","27,176.5560",100.00 INR,6.75,5.9400,0.8100,565200137,1596422,Success,India,Airtel India,Transguard Group LLC,API User,AIININ36410
2022-02-20 08:20,72774925,"27,176.5560","27,166.7560",10.00 AED,10.00,9.8000,0.2000,565200169,1596424,Success,United Arab Emirates,DU UAE,Transguard Group LLC,API User,E6AEAE22430
2022-02-20 08:24,72775134,"27,166.7560","27,161.8560",05.00 AED,5.00,4.9000,0.1000,565200616,1596436,Success,United Arab Emirates,DU UAE,Transguard Group LLC,API User,E6AEAE17361
2022-02-20 08:25,72775201,"27,161.8560","27,156.9560",05.00 AED,5.00,4.9000,0.1000,565200752,1596440,Success,United Arab Emirates,DU UAE,Transguard Group LLC,API User,E6AEAE17361
2022-02-20 08:32,72775583,"27,156.9560","27,147.1560",10.00 AED,10.00,9.8000,0.2000,565201531,1596450,Success,United Arab Emirates,DU UAE,Transguard Group LLC,API User,E6AEAE22430
2022-02-20 08:40,72776022,"27,147.1560","27,142.2560",05.00 AED,5.00,4.9000,0.1000,565202432,1596467,Success,United Arab Emirates,DU UAE,Transguard Group LLC,API User,E6AEAE17361
2022-02-20 08:42,72776112,"27,142.2560","27,137.3560",05.00 AED,5.00,4.9000,0.1000,565202618,1596472,Success,United Arab Emirates,DU UAE,Transguard Group LLC,API User,E6AEAE17361
2022-02-20 08:47,72776361,"27,137.3560","27,132.4560",05.00 AED,5.00,4.9000,0.1000,565203177,1596488,Success,United Arab Emirates,DU UAE,Transguard Group LLC,API User,E6AEAE17361
2022-02-20 08:48,72776395,"27,132.4560","27,127.5560",05.00 AED,5.00,4.9000,0.1000,565203242,1596492,Success,United Arab Emirates,DU UAE,Transguard Group LLC,API User,E6AEAE17361
2022-02-20 08:50,72776491,"27,127.5560","27,117.7560",10.00 AED,10.00,9.8000,0.2000,565203446,1596501,Success,United Arab Emirates,DU UAE,Transguard Group LLC,API User,E6AEAE22430
2022-02-20 08:52,72776615,"27,117.7560","27,107.9560",10.00 AED,10.00,9.8000,0.2000,565203720,1596510,Success,United Arab Emirates,DU UAE,Transguard Group LLC,API User,E6AEAE22430
2022-02-20 08:54,72776731,"27,107.9560","27,103.0560",05.00 AED,5.00,4.9000,0.1000,565203941,1596514,Success,United Arab Emirates,DU UAE,Transguard Group LLC,API User,E6AEAE17361
2022-02-20 08:56,72776799,"27,103.0560","27,098.1560",05.00 AED,5.00,4.9000,0.1000,565204083,1596520,Success,United Arab Emirates,DU UAE,Transguard Group LLC,API User,E6AEAE17361
2022-02-20 08:57,72776884,"27,098.1560","27,088.3560",10.00 AED,10.00,9.8000,0.2000,565204259,1596524,Success,United Arab Emirates,DU UAE,Transguard Group LLC,API User,E6AEAE22430
2022-02-20 09:03,72777212,"27,088.3560","27,083.4560",05.00 AED,5.00,4.9000,0.1000,565204929,1596538,Success,United Arab Emirates,DU UAE,Transguard Group LLC,API User,E6AEAE17361
2022-02-20 09:06,72777358,"27,083.4560","27,070.6960",460.00 PKR,14.50,12.7600,1.7400,565205239,1596543,Success,Pakistan,Jazz Pakistan,Transguard Group LLC,API User,MBPKPK49413
2022-02-20 09:07,72777407,"27,070.6960","27,060.8960",10.00 AED,10.00,9.8000,0.2000,565205328,1596548,Success,United Arab Emirates,DU UAE,Transguard Group LLC,API User,E6AEAE22430
2022-02-20 09:13,72777686,"27,060.8960","27,055.9960",05.00 AED,5.00,4.9000,0.1000,565205907,1596561,Success,United Arab Emirates,DU UAE,Transguard Group LLC,API User,E6AEAE17361
2022-02-20 09:13,72777688,"27,055.9960","27,051.0960",05.00 AED,5.00,4.9000,0.1000,565205913,1596562,Success,United Arab Emirates,DU UAE,Transguard Group LLC,API User,E6AEAE17361
2022-02-20 09:14,72777732,"27,051.0960","27,041.2960",10.00 AED,10.00,9.8000,0.2000,565206022,1596565,Success,United Arab Emirates,DU UAE,Transguard Group LLC,API User,E6AEAE22430
2022-02-20 09:16,72777831,"27,041.2960","27,036.3960",05.00 AED,5.00,4.9000,0.1000,565206234,1596568,Success,United Arab Emirates,DU UAE,Transguard Group LLC,API User,E6AEAE17361
2022-02-20 09:21,72778060,"27,036.3960","27,031.4960",05.00 AED,5.00,4.9000,0.1000,565206721,1596573,Success,United Arab Emirates,DU UAE,Transguard Group LLC,API User,E6AEAE17361
2022-02-20 09:23,72778133,"27,031.4960","27,021.6960",10.00 AED,10.00,9.8000,0.2000,565206869,1596580,Success,United Arab Emirates,DU UAE,Transguard Group LLC,API User,E6AEAE22430
2022-02-20 09:24,72778197,"27,021.6960","27,011.8960",10.00 AED,10.00,9.8000,0.2000,565207005,1596583,Success,United Arab Emirates,DU UAE,Transguard Group LLC,API User,E6AEAE22430
2022-02-20 09:27,72778323,"27,011.8960","27,006.9960",05.00 AED,5.00,4.9000,0.1000,565207277,1596588,Success,United Arab Emirates,DU UAE,Transguard Group LLC,API User,E6AEAE17361
2022-02-20 09:39,72778906,"27,006.9960","26,998.1960",315.00 PKR,10.00,8.8000,1.2000,565208469,1596606,Success,Pakistan,Telenor Pakistan,Transguard Group LLC,API User,TPPKPK75105
2022-02-20 09:50,72779473,"26,998.1960","26,994.4560",100.00 NPR,4.25,3.7400,0.5100,565209602,1596622,Success,Nepal,Ncell Nepal,Transguard Group LLC,API User,NP_NC_TopUp_100.00
2022-02-20 09:51,72779492,"26,994.4560","26,989.5560",05.00 AED,5.00,4.9000,0.1000,565209645,1596625,Success,United Arab Emirates,DU UAE,Transguard Group LLC,API User,E6AEAE17361
2022-02-20 09:52,72779529,"26,989.5560","26,979.7560",10.00 AED,10.00,9.8000,0.2000,565209726,1596630,Success,United Arab Emirates,DU UAE,Transguard Group LLC,API User,E6AEAE22430
2022-02-20 09:53,72779569,"26,979.7560","26,974.8560",05.00 AED,5.00,4.9000,0.1000,565209825,1596635,Success,United Arab Emirates,DU UAE,Transguard Group LLC,API User,E6AEAE17361
2022-02-20 09:55,72779659,"26,974.8560","26,969.9560",05.00 AED,5.00,4.9000,0.1000,565210001,1596641,Success,United Arab Emirates,DU UAE,Transguard Group LLC,API User,E6AEAE17361
2022-02-20 09:56,72779746,"26,969.9560","26,960.1560",10.00 AED,10.00,9.8000,0.2000,565210180,1596645,Success,United Arab Emirates,DU UAE,Transguard Group LLC,API User,E6AEAE22430
2022-02-20 09:58,72779817,"26,960.1560","26,955.2560",05.00 AED,5.00,4.9000,0.1000,565210318,1596650,Success,United Arab Emirates,DU UAE,Transguard Group LLC,API User,E6AEAE17361
2022-02-20 09:58,72779826,"26,955.2560","26,945.4560",10.00 AED,10.00,9.8000,0.2000,565210347,1596652,Success,United Arab Emirates,DU UAE,Transguard Group LLC,API User,E6AEAE22430
2022-02-20 10:02,72779998,"26,945.4560","26,937.3160",300.00 PKR,9.25,8.1400,1.1100,565210715,1596661,Success,Pakistan,Zong Pakistan,Transguard Group LLC,API User,ZNPKPK70504
2022-02-20 10:05,72780119,"26,937.3160","26,932.4160",05.00 AED,5.00,4.9000,0.1000,565210970,1596669,Success,United Arab Emirates,DU UAE,Transguard Group LLC,API User,E6AEAE17361
2022-02-20 10:05,72780139,"26,932.4160","26,922.6160",10.00 AED,10.00,9.8000,0.2000,565211024,1596674,Success,United Arab Emirates,DU UAE,Transguard Group LLC,API User,E6AEAE22430
2022-02-20 10:05,72780143,"26,922.6160","26,912.8160",10.00 AED,10.00,9.8000,0.2000,565211033,1596675,Success,United Arab Emirates,DU UAE,Transguard Group LLC,API User,E6AEAE22430
2022-02-20 10:06,72780205,"26,912.8160","26,903.0160",10.00 AED,10.00,9.8000,0.2000,565211153,1596680,Success,United Arab Emirates,DU UAE,Transguard Group LLC,API User,E6AEAE22430
2022-02-20 10:08,72780260,"26,903.0160","26,893.2160",10.00 AED,10.00,9.8000,0.2000,565211254,1596685,Success,United Arab Emirates,DU UAE,Transguard Group LLC,API User,E6AEAE22430
2022-02-20 10:08,72780263,"26,893.2160","26,883.4160",10.00 AED,10.00,9.8000,0.2000,565211257,1596686,Success,United Arab Emirates,DU UAE,Transguard Group LLC,API User,E6AEAE22430
2022-02-20 10:14,72780599,"26,883.4160","26,878.5160",05.00 AED,5.00,4.9000,0.1000,565211934,1596700,Success,United Arab Emirates,DU UAE,Transguard Group LLC,API User,E6AEAE17361
2022-02-20 10:20,72780849,"26,878.5160","26,873.6160",05.00 AED,5.00,4.9000,0.1000,565212433,1596706,Success,United Arab Emirates,DU UAE,Transguard Group LLC,API User,E6AEAE17361
2022-02-20 10:20,72780856,"26,873.6160","26,868.7160",05.00 AED,5.00,4.9000,0.1000,565212454,1596710,Success,United Arab Emirates,DU UAE,Transguard Group LLC,API User,E6AEAE17361
2022-02-20 10:20,72780891,"26,868.7160","26,851.1160",26.41 GHS,20.00,17.6000,2.4000,565212515,1596716,Success,Ghana,MTN Ghana,Transguard Group LLC,API User,GH_MT_TopUp
2022-02-20 10:21,72780899,"26,851.1160","26,841.3160",10.00 AED,10.00,9.8000,0.2000,565212534,1596717,Success,United Arab Emirates,DU UAE,Transguard Group LLC,API User,E6AEAE22430
2022-02-20 10:23,72781028,"26,841.3160","26,836.4160",05.00 AED,5.00,4.9000,0.1000,565212794,1596724,Success,United Arab Emirates,DU UAE,Transguard Group LLC,API User,E6AEAE17361
2022-02-20 10:24,72781092,"26,836.4160","26,831.5160",05.00 AED,5.00,4.9000,0.1000,565212919,1596729,Success,United Arab Emirates,DU UAE,Transguard Group LLC,API User,E6AEAE17361
2022-02-20 10:26,72781181,"26,831.5160","26,826.6160",05.00 AED,5.00,4.9000,0.1000,565213104,1596734,Success,United Arab Emirates,DU UAE,Transguard Group LLC,API User,E6AEAE17361
2022-02-20 10:30,72781379,"26,826.6160","26,821.7160",05.00 AED,5.00,4.9000,0.1000,565213511,1596743,Success,United Arab Emirates,DU UAE,Transguard Group LLC,API User,E6AEAE17361
2022-02-20 10:31,72781394,"26,821.7160","26,802.1160",20.00 AED,20.00,19.6000,0.4000,565213543,1596746,Success,United Arab Emirates,DU UAE,Transguard Group LLC,API User,E6AEAE12938
2022-02-20 10:34,72781542,"26,802.1160","26,792.3160",10.00 AED,10.00,9.8000,0.2000,565213821,1596749,Success,United Arab Emirates,DU UAE,Transguard Group LLC,API User,E6AEAE22430
2022-02-20 10:34,72781585,"26,792.3160","26,782.5160",10.00 AED,10.00,9.8000,0.2000,565213910,1596757,Success,United Arab Emirates,DU UAE,Transguard Group LLC,API User,E6AEAE22430
2022-02-20 10:43,72782006,"26,782.5160","26,777.6160",05.00 AED,5.00,4.9000,0.1000,565214797,1596769,Success,United Arab Emirates,DU UAE,Transguard Group LLC,API User,E6AEAE17361
2022-02-20 10:49,72782343,"26,777.6160","26,772.7160",05.00 AED,5.00,4.9000,0.1000,565215414,1596776,Success,United Arab Emirates,DU UAE,Transguard Group LLC,API User,E6AEAE17361
2022-02-20 10:52,72782488,"26,767.8160","26,759.2360",315.00 PKR,9.75,8.5800,1.1700,565215716,1596786,Success,Pakistan,Zong Pakistan,Transguard Group LLC,API User,ZNPKPK29953
2022-02-20 10:52,72782490,"26,772.7160","26,767.8160",05.00 AED,5.00,4.9000,0.1000,565215714,1596785,Success,United Arab Emirates,DU UAE,Transguard Group LLC,API User,E6AEAE17361
2022-02-20 10:54,72782589,"26,759.2360","26,754.3360",05.00 AED,5.00,4.9000,0.1000,565215926,1596792,Success,United Arab Emirates,DU UAE,Transguard Group LLC,API User,E6AEAE17361
2022-02-20 10:54,72782627,"26,754.3360","26,749.4360",05.00 AED,5.00,4.9000,0.1000,565215997,1596797,Success,United Arab Emirates,DU UAE,Transguard Group LLC,API User,E6AEAE17361
2022-02-20 10:55,72782674,"26,749.4360","26,744.5360",05.00 AED,5.00,4.9000,0.1000,565216096,1596802,Success,United Arab Emirates,DU UAE,Transguard Group LLC,API User,E6AEAE17361
2022-02-20 11:05,72783258,"26,744.5360","26,739.6360",05.00 AED,5.00,4.9000,0.1000,565217218,1596818,Success,United Arab Emirates,DU UAE,Transguard Group LLC,API User,E6AEAE17361
2022-02-20 11:09,72783448,"26,739.6360","26,729.8360",10.00 AED,10.00,9.8000,0.2000,565217619,1596825,Success,United Arab Emirates,DU UAE,Transguard Group LLC,API User,E6AEAE22430
2022-02-20 11:12,72783633,"26,729.8360","26,724.9360",05.00 AED,5.00,4.9000,0.1000,565217992,1596828,Success,United Arab Emirates,DU UAE,Transguard Group LLC,API User,E6AEAE17361
2022-02-20 11:27,72784340,"26,724.9360","26,707.9960",470.00 NPR,19.25,16.9400,2.3100,565219464,1596856,Success,Nepal,Ncell Nepal,Transguard Group LLC,API User,NCNPNP37643
2022-02-20 11:39,72784911,"26,707.9960","26,703.0960",05.00 AED,5.00,4.9000,0.1000,565220700,1596872,Success,United Arab Emirates,DU UAE,Transguard Group LLC,API User,E6AEAE17361
2022-02-20 11:43,72785147,"26,703.0960","26,668.7960",35.00 AED,35.00,34.3000,0.7000,565221172,1596881,Success,United Arab Emirates,DU UAE,Transguard Group LLC,API User,E6AEAE73954
2022-02-20 11:45,72785208,"26,668.7960","26,663.8960",05.00 AED,5.00,4.9000,0.1000,565221303,1596884,Success,United Arab Emirates,DU UAE,Transguard Group LLC,API User,E6AEAE17361
2022-02-20 11:45,72785233,"26,663.8960","26,658.9960",05.00 AED,5.00,4.9000,0.1000,565221353,1596888,Success,United Arab Emirates,DU UAE,Transguard Group LLC,API User,E6AEAE17361
2022-02-20 11:45,72785253,"26,658.9960","26,629.5960",30.00 AED,30.00,29.4000,0.6000,565221399,1596890,Success,United Arab Emirates,DU UAE,Transguard Group LLC,API User,E6AEAE46146
2022-02-20 11:49,72785417,"26,629.5960","26,619.7960",10.00 AED,10.00,9.8000,0.2000,565221716,1596897,Success,United Arab Emirates,DU UAE,Transguard Group LLC,API User,E6AEAE22430
2022-02-20 11:51,72785537,"26,619.7960","26,615.6160",50.00 PHP,4.75,4.1800,0.5700,565221978,1596906,Success,Philippines,Smart (SunCellular) Philippines,Transguard Group LLC,API User,PH_SM_TopUp_50.00
2022-02-20 11:51,72785542,"26,615.6160","26,610.7160",05.00 AED,5.00,4.9000,0.1000,565221995,1596907,Success,United Arab Emirates,DU UAE,Transguard Group LLC,API User,E6AEAE17361
2022-02-20 11:57,72785828,"26,610.7160","26,600.9160",10.00 AED,10.00,9.8000,0.2000,565222598,1596913,Success,United Arab Emirates,DU UAE,Transguard Group LLC,API User,E6AEAE22430
2022-02-20 11:59,72785940,"26,600.9160","26,596.0160",05.00 AED,5.00,4.9000,0.1000,565222797,1596918,Success,United Arab Emirates,DU UAE,Transguard Group LLC,API User,E6AEAE17361
2022-02-20 12:02,72786085,"26,596.0160","26,581.3160",15.00 AED,15.00,14.7000,0.3000,565223128,1596927,Success,United Arab Emirates,DU UAE,Transguard Group LLC,API User,E6AEAE8527
2022-02-20 12:03,72786125,"26,581.3160","26,576.4160",05.00 AED,5.00,4.9000,0.1000,565223192,1596930,Success,United Arab Emirates,DU UAE,Transguard Group LLC,API User,E6AEAE17361
2022-02-20 12:06,72786249,"26,576.4160","26,572.2360",150.00 PKR,4.75,4.1800,0.5700,565223473,1596933,Success,Pakistan,Jazz Pakistan,Transguard Group LLC,API User,MBPKPK20699
2022-02-20 12:06,72786272,"26,572.2360","26,567.3360",05.00 AED,5.00,4.9000,0.1000,565223508,1596936,Success,United Arab Emirates,DU UAE,Transguard Group LLC,API User,E6AEAE17361
2022-02-20 12:07,72786325,"26,567.3360","26,563.1560",150.00 PKR,4.75,4.1800,0.5700,565223615,1596939,Success,Pakistan,Jazz Pakistan,Transguard Group LLC,API User,MBPKPK20699
2022-02-20 12:11,72786528,"26,563.1560","26,558.2560",05.00 AED,5.00,4.9000,0.1000,565224030,1596948,Success,United Arab Emirates,DU UAE,Transguard Group LLC,API User,E6AEAE17361
2022-02-20 12:13,72786606,"26,558.2560","26,553.3560",05.00 AED,5.00,4.9000,0.1000,565224192,1596952,Success,United Arab Emirates,DU UAE,Transguard Group LLC,API User,E6AEAE17361
2022-02-20 12:15,72786726,"26,553.3560","26,543.5560",10.00 AED,10.00,9.8000,0.2000,565224426,1596962,Success,United Arab Emirates,DU UAE,Transguard Group LLC,API User,E6AEAE22430
2022-02-20 12:19,72786905,"26,543.5560","26,538.6560",05.00 AED,5.00,4.9000,0.1000,565224769,1596965,Success,United Arab Emirates,DU UAE,Transguard Group LLC,API User,E6AEAE17361
2022-02-20 12:25,72787271,"26,538.6560","26,533.7560",05.00 AED,5.00,4.9000,0.1000,565225525,1596970,Success,United Arab Emirates,DU UAE,Transguard Group LLC,API User,E6AEAE17361
2022-02-20 12:35,72787792,"26,533.7560","26,523.9560",10.00 AED,10.00,9.8000,0.2000,565226540,1596986,Success,United Arab Emirates,DU UAE,Transguard Group LLC,API User,E6AEAE22430
2022-02-20 12:38,72787936,"26,523.9560","26,519.0560",05.00 AED,5.00,4.9000,0.1000,565226856,1596993,Success,United Arab Emirates,DU UAE,Transguard Group LLC,API User,E6AEAE17361
2022-02-20 12:40,72788022,"26,519.0560","26,511.7960",200.00 NPR,8.25,7.2600,0.9900,565227038,1596996,Success,Nepal,Nepal Telecom Nepal,Transguard Group LLC,API User,NP_NE_TopUp_200.00
2022-02-20 12:47,72788401,"26,511.7960","26,506.8960",05.00 AED,5.00,4.9000,0.1000,565227819,1597005,Success,United Arab Emirates,DU UAE,Transguard Group LLC,API User,E6AEAE17361
2022-02-20 12:47,72788410,"26,506.8960","26,501.9960",05.00 AED,5.00,4.9000,0.1000,565227846,1597006,Success,United Arab Emirates,DU UAE,Transguard Group LLC,API User,E6AEAE17361
2022-02-20 12:56,72788810,"26,501.9960","26,497.0960",05.00 AED,5.00,4.9000,0.1000,565228705,1597023,Success,United Arab Emirates,DU UAE,Transguard Group LLC,API User,E6AEAE17361
2022-02-20 12:56,72788832,"26,497.0960","26,492.1960",05.00 AED,5.00,4.9000,0.1000,565228765,1597025,Success,United Arab Emirates,DU UAE,Transguard Group LLC,API User,E6AEAE17361
2022-02-20 13:02,72789059,"26,492.1960","26,487.2960",05.00 AED,5.00,4.9000,0.1000,565229336,1597043,Success,United Arab Emirates,DU UAE,Transguard Group LLC,API User,E6AEAE17361
2022-02-20 13:05,72789204,"26,487.2960","26,482.3960",05.00 AED,5.00,4.9000,0.1000,565229644,1597050,Success,United Arab Emirates,DU UAE,Transguard Group LLC,API User,E6AEAE17361
2022-02-20 13:06,72789269,"26,482.3960","26,477.4960",05.00 AED,5.00,4.9000,0.1000,565229765,1597059,Success,United Arab Emirates,DU UAE,Transguard Group LLC,API User,E6AEAE17361
2022-02-20 13:06,72789272,"26,477.4960","26,467.6960",10.00 AED,10.00,9.8000,0.2000,565229783,1597060,Success,United Arab Emirates,DU UAE,Transguard Group LLC,API User,E6AEAE22430
2022-02-20 13:07,72789284,"26,467.6960","26,462.7960",05.00 AED,5.00,4.9000,0.1000,565229804,1597062,Success,United Arab Emirates,DU UAE,Transguard Group LLC,API User,E6AEAE17361
2022-02-20 13:10,72789470,"26,462.7960","26,457.8960",05.00 AED,5.00,4.9000,0.1000,565230209,1597071,Success,United Arab Emirates,DU UAE,Transguard Group LLC,API User,E6AEAE17361
2022-02-20 13:12,72789562,"26,457.8960","26,452.9960",05.00 AED,5.00,4.9000,0.1000,565230391,1597074,Success,United Arab Emirates,DU UAE,Transguard Group LLC,API User,E6AEAE17361
2022-02-20 13:18,72789869,"26,452.9960","26,443.1960",10.00 AED,10.00,9.8000,0.2000,565231018,1597082,Success,United Arab Emirates,DU UAE,Transguard Group LLC,API User,E6AEAE22430
2022-02-20 13:18,72789904,"26,443.1960","26,433.3960",10.00 AED,10.00,9.8000,0.2000,565231089,1597084,Success,United Arab Emirates,DU UAE,Transguard Group LLC,API User,E6AEAE22430
2022-02-20 13:21,72790050,"26,433.3960","26,428.4960",05.00 AED,5.00,4.9000,0.1000,565231427,1597093,Success,United Arab Emirates,DU UAE,Transguard Group LLC,API User,E6AEAE17361
2022-02-20 13:29,72790480,"26,428.4960","26,423.5960",05.00 AED,5.00,4.9000,0.1000,565232287,1597098,Success,United Arab Emirates,DU UAE,Transguard Group LLC,API User,E6AEAE17361
2022-02-20 13:34,72790693,"26,423.5960","26,413.7960",10.00 AED,10.00,9.8000,0.2000,565232760,1597107,Success,United Arab Emirates,DU UAE,Transguard Group LLC,API User,E6AEAE22430
2022-02-20 13:34,72790704,"26,413.7960","26,403.9960",10.00 AED,10.00,9.8000,0.2000,565232798,1597109,Success,United Arab Emirates,DU UAE,Transguard Group LLC,API User,E6AEAE22430
2022-02-20 13:43,72791152,"26,403.9960","26,394.1960",10.00 AED,10.00,9.8000,0.2000,565233852,1597119,Success,United Arab Emirates,DU UAE,Transguard Group LLC,API User,E6AEAE22430
2022-02-20 13:44,72791223,"26,394.1960","26,386.2760",220.00 NPR,9.00,7.9200,1.0800,565233982,1597122,Success,Nepal,Ncell Nepal,Transguard Group LLC,API User,NCNPNP79518
2022-02-20 13:50,72791508,"26,386.2760","26,381.3760",05.00 AED,5.00,4.9000,0.1000,565234596,1597139,Success,United Arab Emirates,DU UAE,Transguard Group LLC,API User,E6AEAE17361
2022-02-20 13:52,72791605,"26,381.3760","26,376.4760",05.00 AED,5.00,4.9000,0.1000,565234805,1597148,Success,United Arab Emirates,DU UAE,Transguard Group LLC,API User,E6AEAE17361
2022-02-20 13:58,72791895,"26,376.4760","26,371.5760",05.00 AED,5.00,4.9000,0.1000,565235441,1597155,Success,United Arab Emirates,DU UAE,Transguard Group LLC,API User,E6AEAE17361
2022-02-20 14:01,72792042,"26,371.5760","26,329.9960","1,500.00 PKR",47.25,41.5800,5.6700,565235771,1597161,Success,Pakistan,Jazz Pakistan,Transguard Group LLC,API User,MBPKPK5467
2022-02-20 14:02,72792119,"26,329.9960","26,325.0960",05.00 AED,5.00,4.9000,0.1000,565235932,1597164,Success,United Arab Emirates,DU UAE,Transguard Group LLC,API User,E6AEAE17361
2022-02-20 14:10,72792523,"26,325.0960","26,320.1960",05.00 AED,5.00,4.9000,0.1000,565236781,1597171,Success,United Arab Emirates,DU UAE,Transguard Group LLC,API User,E6AEAE17361
2022-02-20 14:12,72792621,"26,320.1960","26,300.5960",20.00 AED,20.00,19.6000,0.4000,565237016,1597182,Success,United Arab Emirates,DU UAE,Transguard Group LLC,API User,E6AEAE12938
2022-02-20 14:13,72792645,"26,300.5960","26,295.6960",05.00 AED,5.00,4.9000,0.1000,565237079,1597186,Success,United Arab Emirates,DU UAE,Transguard Group LLC,API User,E6AEAE17361
2022-02-20 14:16,72792782,"26,295.6960","26,290.7960",05.00 AED,5.00,4.9000,0.1000,565237365,1597190,Success,United Arab Emirates,DU UAE,Transguard Group LLC,API User,E6AEAE17361
2022-02-20 14:17,72792848,"26,290.7960","26,280.9960",10.00 AED,10.00,9.8000,0.2000,565237506,1597195,Success,United Arab Emirates,DU UAE,Transguard Group LLC,API User,E6AEAE22430
2022-02-20 14:19,72792928,"26,280.9960","26,276.0960",05.00 AED,5.00,4.9000,0.1000,565237684,1597198,Success,United Arab Emirates,DU UAE,Transguard Group LLC,API User,E6AEAE17361
2022-02-20 14:22,72793107,"26,276.0960","26,266.2960",10.00 AED,10.00,9.8000,0.2000,565238103,1597206,Success,United Arab Emirates,DU UAE,Transguard Group LLC,API User,E6AEAE22430
2022-02-20 14:22,72793111,"26,266.2960","26,261.3960",05.00 AED,5.00,4.9000,0.1000,565238121,1597207,Success,United Arab Emirates,DU UAE,Transguard Group LLC,API User,E6AEAE17361
2022-02-20 14:30,72793467,"26,261.3960","26,256.4960",05.00 AED,5.00,4.9000,0.1000,565238932,1597219,Success,United Arab Emirates,DU UAE,Transguard Group LLC,API User,E6AEAE17361
2022-02-20 14:35,72793712,"26,256.4960","26,246.6960",10.00 AED,10.00,9.8000,0.2000,565239508,1597225,Success,United Arab Emirates,DU UAE,Transguard Group LLC,API User,E6AEAE22430
2022-02-20 14:38,72793846,"26,246.6960","26,207.4960",40.00 AED,40.00,39.2000,0.8000,565239856,1597231,Success,United Arab Emirates,DU UAE,Transguard Group LLC,API User,E6AEAE64011
2022-02-20 14:38,72793847,"26,207.4960","26,197.6960",10.00 AED,10.00,9.8000,0.2000,565239858,1597232,Success,United Arab Emirates,DU UAE,Transguard Group LLC,API User,E6AEAE22430
2022-02-20 14:40,72793951,"26,197.6960","26,187.8960",10.00 AED,10.00,9.8000,0.2000,565240105,1597236,Success,United Arab Emirates,DU UAE,Transguard Group LLC,API User,E6AEAE22430
2022-02-20 14:48,72794408,"26,187.8960","26,178.0960",10.00 AED,10.00,9.8000,0.2000,565241098,1597245,Success,United Arab Emirates,DU UAE,Transguard Group LLC,API User,E6AEAE22430
2022-02-20 14:55,72794727,"26,178.0960","26,173.1960",05.00 AED,5.00,4.9000,0.1000,565241818,1597255,Success,United Arab Emirates,DU UAE,Transguard Group LLC,API User,E6AEAE17361
2022-02-20 14:55,72794753,"26,173.1960","26,168.2960",05.00 AED,5.00,4.9000,0.1000,565241871,1597258,Success,United Arab Emirates,DU UAE,Transguard Group LLC,API User,E6AEAE17361
2022-02-20 15:00,72794980,"26,168.2960","26,163.3960",05.00 AED,5.00,4.9000,0.1000,565242375,1597263,Success,United Arab Emirates,DU UAE,Transguard Group LLC,API User,E6AEAE17361
2022-02-20 15:03,72795122,"26,163.3960","26,153.5960",10.00 AED,10.00,9.8000,0.2000,565242680,1597269,Success,United Arab Emirates,DU UAE,Transguard Group LLC,API User,E6AEAE22430
2022-02-20 15:11,72795536,"26,153.5960","26,148.6960",05.00 AED,5.00,4.9000,0.1000,565243683,1597274,Success,United Arab Emirates,DU UAE,Transguard Group LLC,API User,E6AEAE17361
2022-02-20 15:12,72795566,"26,148.6960","26,138.8960",10.00 AED,10.00,9.8000,0.2000,565243743,1597276,Success,United Arab Emirates,DU UAE,Transguard Group LLC,API User,E6AEAE22430
2022-02-20 15:17,72795793,"26,138.8960","26,133.9960",05.00 AED,5.00,4.9000,0.1000,565244304,1597283,Success,United Arab Emirates,DU UAE,Transguard Group LLC,API User,E6AEAE17361
2022-02-20 15:19,72795909,"26,133.9960","26,129.8160",150.00 PKR,4.75,4.1800,0.5700,565244596,1597289,Success,Pakistan,Zong Pakistan,Transguard Group LLC,API User,ZNPKPK65621
2022-02-20 15:20,72795926,"26,129.8160","26,113.7560",575.00 PKR,18.25,16.0600,2.1900,565244634,1597291,Success,Pakistan,Telenor Pakistan,Transguard Group LLC,API User,TPPKPK7947
2022-02-20 15:23,72796089,"26,113.7560","26,103.9560",10.00 AED,10.00,9.8000,0.2000,565245013,1597296,Success,United Arab Emirates,DU UAE,Transguard Group LLC,API User,E6AEAE22430
2022-02-20 15:26,72796241,"26,103.9560","26,099.0560",05.00 AED,5.00,4.9000,0.1000,565245365,1597301,Success,United Arab Emirates,DU UAE,Transguard Group LLC,API User,E6AEAE17361
2022-02-20 15:26,72796254,"26,099.0560","26,094.1560",05.00 AED,5.00,4.9000,0.1000,565245400,1597302,Success,United Arab Emirates,DU UAE,Transguard Group LLC,API User,E6AEAE17361
2022-02-20 15:27,72796310,"26,094.1560","26,089.2560",05.00 AED,5.00,4.9000,0.1000,565245529,1597305,Success,United Arab Emirates,DU UAE,Transguard Group LLC,API User,E6AEAE17361
2022-02-20 15:31,72796512,"26,089.2560","26,084.3560",05.00 AED,5.00,4.9000,0.1000,565246033,1597316,Success,United Arab Emirates,DU UAE,Transguard Group LLC,API User,E6AEAE17361
2022-02-20 15:37,72796775,"26,084.3560","26,079.4560",05.00 AED,5.00,4.9000,0.1000,565246632,1597320,Success,United Arab Emirates,DU UAE,Transguard Group LLC,API User,E6AEAE17361
2022-02-20 15:42,72797049,"26,079.4560","26,074.5560",05.00 AED,5.00,4.9000,0.1000,565247276,1597331,Success,United Arab Emirates,DU UAE,Transguard Group LLC,API User,E6AEAE17361
2022-02-20 15:56,72797725,"26,074.5560","26,069.6560",05.00 AED,5.00,4.9000,0.1000,565248924,1597341,Success,United Arab Emirates,DU UAE,Transguard Group LLC,API User,E6AEAE17361
2022-02-20 15:58,72797797,"26,069.6560","26,064.7560",05.00 AED,5.00,4.9000,0.1000,565249086,1597346,Success,United Arab Emirates,DU UAE,Transguard Group LLC,API User,E6AEAE17361
2022-02-20 15:58,72797813,"26,064.7560","26,040.2560",25.00 AED,25.00,24.5000,0.5000,565249115,1597347,Success,United Arab Emirates,DU UAE,Transguard Group LLC,API User,E6AEAE17343
2022-02-20 16:07,72798227,"26,040.2560","26,020.6560",20.00 AED,20.00,19.6000,0.4000,565250185,1597357,Success,United Arab Emirates,DU UAE,Transguard Group LLC,API User,E6AEAE12938
2022-02-20 16:08,72798305,"26,020.6560","26,005.9560",15.00 AED,15.00,14.7000,0.3000,565250380,1597360,Success,United Arab Emirates,DU UAE,Transguard Group LLC,API User,E6AEAE8527
2022-02-20 16:11,72798434,"26,005.9560","25,996.1560",10.00 AED,10.00,9.8000,0.2000,565250730,1597370,Success,United Arab Emirates,DU UAE,Transguard Group LLC,API User,E6AEAE22430
2022-02-20 16:11,72798445,"25,996.1560","25,991.2560",05.00 AED,5.00,4.9000,0.1000,565250758,1597372,Success,United Arab Emirates,DU UAE,Transguard Group LLC,API User,E6AEAE17361
2022-02-20 16:16,72798637,"25,991.2560","25,986.3560",05.00 AED,5.00,4.9000,0.1000,565251241,1597380,Success,United Arab Emirates,DU UAE,Transguard Group LLC,API User,E6AEAE17361
2022-02-20 16:20,72798881,"25,986.3560","25,976.5560",10.00 AED,10.00,9.8000,0.2000,565251843,1597390,Success,United Arab Emirates,DU UAE,Transguard Group LLC,API User,E6AEAE22430
2022-02-20 16:27,72799252,"25,976.5560","25,971.6560",05.00 AED,5.00,4.9000,0.1000,565252718,1597400,Success,United Arab Emirates,DU UAE,Transguard Group LLC,API User,E6AEAE17361
2022-02-20 16:28,72799310,"25,971.6560","25,966.7560",05.00 AED,5.00,4.9000,0.1000,565252849,1597404,Success,United Arab Emirates,DU UAE,Transguard Group LLC,API User,E6AEAE17361
2022-02-20 16:29,72799361,"25,966.7560","25,956.9560",10.00 AED,10.00,9.8000,0.2000,565252949,1597411,Success,United Arab Emirates,DU UAE,Transguard Group LLC,API User,E6AEAE22430
2022-02-20 16:31,72799476,"25,956.9560","25,947.1560",10.00 AED,10.00,9.8000,0.2000,565253255,1597417,Success,United Arab Emirates,DU UAE,Transguard Group LLC,API User,E6AEAE22430
2022-02-20 16:34,72799662,"25,947.1560","25,937.3560",10.00 AED,10.00,9.8000,0.2000,565253688,1597423,Success,United Arab Emirates,DU UAE,Transguard Group LLC,API User,E6AEAE22430
2022-02-20 16:40,72800023,"25,937.3560","25,927.5560",10.00 AED,10.00,9.8000,0.2000,565254519,1597434,Success,United Arab Emirates,DU UAE,Transguard Group LLC,API User,E6AEAE22430
2022-02-20 16:42,72800112,"25,927.5560","25,917.7560",10.00 AED,10.00,9.8000,0.2000,565254741,1597437,Success,United Arab Emirates,DU UAE,Transguard Group LLC,API User,E6AEAE22430
2022-02-20 16:43,72800181,"25,917.7560","25,912.8560",05.00 AED,5.00,4.9000,0.1000,565254908,1597442,Success,United Arab Emirates,DU UAE,Transguard Group LLC,API User,E6AEAE17361
2022-02-20 16:50,72800567,"25,912.8560","25,904.4960",300.00 PKR,9.50,8.3600,1.1400,565255885,1597451,Success,Pakistan,Ufone Pakistan,Transguard Group LLC,API User,PK_UF_TopUp_300.00
2022-02-20 16:52,72800668,"25,904.4960","25,894.6960",10.00 AED,10.00,9.8000,0.2000,565256173,1597459,Success,United Arab Emirates,DU UAE,Transguard Group LLC,API User,E6AEAE22430
2022-02-20 16:53,72800736,"25,894.6960","25,889.7960",05.00 AED,5.00,4.9000,0.1000,565256341,1597466,Success,United Arab Emirates,DU UAE,Transguard Group LLC,API User,E6AEAE17361
2022-02-20 16:57,72800977,"25,889.7960","25,884.8960",05.00 AED,5.00,4.9000,0.1000,565256957,1597479,Success,United Arab Emirates,DU UAE,Transguard Group LLC,API User,E6AEAE17361
2022-02-20 16:57,72800987,"25,884.8960","25,879.9960",05.00 AED,5.00,4.9000,0.1000,565256970,1597480,Success,United Arab Emirates,DU UAE,Transguard Group LLC,API User,E6AEAE17361
2022-02-20 17:03,72801305,"25,879.9960","25,870.1960",10.00 AED,10.00,9.8000,0.2000,565257777,1597493,Success,United Arab Emirates,DU UAE,Transguard Group LLC,API User,E6AEAE22430
2022-02-20 17:04,72801382,"25,870.1960","25,865.2960",05.00 AED,5.00,4.9000,0.1000,565257936,1597497,Success,United Arab Emirates,DU UAE,Transguard Group LLC,API User,E6AEAE17361
2022-02-20 17:05,72801467,"25,865.2960","25,860.3960",05.00 AED,5.00,4.9000,0.1000,565258179,1597503,Success,United Arab Emirates,DU UAE,Transguard Group LLC,API User,E6AEAE17361
2022-02-20 17:08,72801615,"25,860.3960","25,855.4960",05.00 AED,5.00,4.9000,0.1000,565258574,1597513,Success,United Arab Emirates,DU UAE,Transguard Group LLC,API User,E6AEAE17361
2022-02-20 17:11,72801783,"25,855.4960","25,845.6960",10.00 AED,10.00,9.8000,0.2000,565259026,1597518,Success,United Arab Emirates,DU UAE,Transguard Group LLC,API User,E6AEAE22430
2022-02-20 17:17,72802145,"25,845.6960","25,840.7960",05.00 AED,5.00,4.9000,0.1000,565259973,1597526,Success,United Arab Emirates,DU UAE,Transguard Group LLC,API User,E6AEAE17361
2022-02-20 17:18,72802189,"25,840.7960","25,835.8960",05.00 AED,5.00,4.9000,0.1000,565260074,1597529,Success,United Arab Emirates,DU UAE,Transguard Group LLC,API User,E6AEAE17361
2022-02-20 17:21,72802433,"25,835.8960","25,816.2960",20.00 AED,20.00,19.6000,0.4000,565260644,1597534,Success,United Arab Emirates,DU UAE,Transguard Group LLC,API User,E6AEAE12938
2022-02-20 17:22,72802468,"25,816.2960","25,811.3960",05.00 AED,5.00,4.9000,0.1000,565260715,1597537,Success,United Arab Emirates,DU UAE,Transguard Group LLC,API User,E6AEAE17361
2022-02-20 17:24,72802627,"25,811.3960","25,806.4960",05.00 AED,5.00,4.9000,0.1000,565261085,1597544,Success,United Arab Emirates,DU UAE,Transguard Group LLC,API User,E6AEAE17361
2022-02-20 17:24,72802656,"25,806.4960","25,801.5960",05.00 AED,5.00,4.9000,0.1000,565261158,1597545,Success,United Arab Emirates,DU UAE,Transguard Group LLC,API User,E6AEAE17361
2022-02-20 17:26,72802781,"25,801.5960","25,796.6960",05.00 AED,5.00,4.9000,0.1000,565261511,1597548,Success,United Arab Emirates,DU UAE,Transguard Group LLC,API User,E6AEAE17361
2022-02-20 17:31,72803082,"25,796.6960","25,791.7960",05.00 AED,5.00,4.9000,0.1000,565262291,1597555,Success,United Arab Emirates,DU UAE,Transguard Group LLC,API User,E6AEAE17361
2022-02-20 17:36,72803411,"25,791.7960","25,781.9960",10.00 AED,10.00,9.8000,0.2000,565263116,1597567,Success,United Arab Emirates,DU UAE,Transguard Group LLC,API User,E6AEAE22430
2022-02-20 17:45,72803975,"25,781.9960","25,772.1960",10.00 AED,10.00,9.8000,0.2000,565264557,1597572,Success,United Arab Emirates,DU UAE,Transguard Group LLC,API User,E6AEAE22430
2022-02-20 17:45,72804025,"25,772.1960","25,767.2960",05.00 AED,5.00,4.9000,0.1000,565264686,1597575,Success,United Arab Emirates,DU UAE,Transguard Group LLC,API User,E6AEAE17361
2022-02-20 17:46,72804063,"25,767.2960","25,757.4960",10.00 AED,10.00,9.8000,0.2000,565264824,1597578,Success,United Arab Emirates,DU UAE,Transguard Group LLC,API User,E6AEAE22430
2022-02-20 17:50,72804296,"25,757.4960","25,747.6960",10.00 AED,10.00,9.8000,0.2000,565265425,1597586,Success,United Arab Emirates,DU UAE,Transguard Group LLC,API User,E6AEAE22430
2022-02-20 17:50,72804317,"25,747.6960","25,742.7960",05.00 AED,5.00,4.9000,0.1000,565265475,1597588,Success,United Arab Emirates,DU UAE,Transguard Group LLC,API User,E6AEAE17361
2022-02-20 17:52,72804459,"25,742.7960","25,732.9960",10.00 AED,10.00,9.8000,0.2000,565265866,1597596,Success,United Arab Emirates,DU UAE,Transguard Group LLC,API User,E6AEAE22430
2022-02-20 17:53,72804541,"25,732.9960","25,728.0960",05.00 AED,5.00,4.9000,0.1000,565266086,1597602,Success,United Arab Emirates,DU UAE,Transguard Group LLC,API User,E6AEAE17361
2022-02-20 17:56,72804791,"25,728.0960","25,722.1560",99.00 INR,6.75,5.9400,0.8100,565266688,1597610,Success,India,Airtel India,Transguard Group LLC,API User,AIININ6418
2022-02-20 18:00,72805062,"25,722.1560","25,717.2560",05.00 AED,5.00,4.9000,0.1000,565267350,1597624,Success,United Arab Emirates,DU UAE,Transguard Group LLC,API User,E6AEAE17361
2022-02-20 18:00,72805071,"25,717.2560","25,712.3560",05.00 AED,5.00,4.9000,0.1000,565267393,1597625,Success,United Arab Emirates,DU UAE,Transguard Group LLC,API User,E6AEAE17361
2022-02-20 18:01,72805144,"25,712.3560","25,703.7760",315.00 PKR,9.75,8.5800,1.1700,565267622,1597632,Success,Pakistan,Zong Pakistan,Transguard Group LLC,API User,ZNPKPK29953
2022-02-20 18:02,72805210,"25,703.7760","25,686.8360",650.00 PKR,19.25,16.9400,2.3100,565267801,1597635,Success,Pakistan,Telenor Pakistan,Transguard Group LLC,API User,TPPKPK28935
2022-02-20 18:06,72805485,"25,686.8360","25,677.0360",10.00 AED,10.00,9.8000,0.2000,565268524,1597646,Success,United Arab Emirates,DU UAE,Transguard Group LLC,API User,E6AEAE22430
2022-02-20 18:08,72805642,"25,677.0360","25,672.1360",05.00 AED,5.00,4.9000,0.1000,565268945,1597654,Success,United Arab Emirates,DU UAE,Transguard Group LLC,API User,E6AEAE17361
2022-02-20 18:12,72805901,"25,672.1360","25,668.3960",130.00 PKR,4.25,3.7400,0.5100,565269639,1597663,Success,Pakistan,Telenor Pakistan,Transguard Group LLC,API User,TPPKPK26966
2022-02-20 18:12,72805911,"25,668.3960","25,648.7960",20.00 AED,20.00,19.6000,0.4000,565269654,1597666,Success,United Arab Emirates,DU UAE,Transguard Group LLC,API User,E6AEAE12938
2022-02-20 18:13,72805935,"25,648.7960","25,629.1960",20.00 AED,20.00,19.6000,0.4000,565269727,1597670,Success,United Arab Emirates,DU UAE,Transguard Group LLC,API User,E6AEAE12938
2022-02-20 18:16,72806192,"25,629.1960","25,619.3960",10.00 AED,10.00,9.8000,0.2000,565270382,1597676,Success,United Arab Emirates,DU UAE,Transguard Group LLC,API User,E6AEAE22430
2022-02-20 18:21,72806544,"25,619.3960","25,614.4960",05.00 AED,5.00,4.9000,0.1000,565271253,1597690,Success,United Arab Emirates,DU UAE,Transguard Group LLC,API User,E6AEAE17361
2022-02-20 18:21,72806572,"25,614.4960","25,604.6960",10.00 AED,10.00,9.8000,0.2000,565271320,1597691,Success,United Arab Emirates,DU UAE,Transguard Group LLC,API User,E6AEAE22430
2022-02-20 18:24,72806786,"25,604.6960","25,599.7960",05.00 AED,5.00,4.9000,0.1000,565271866,1597696,Success,United Arab Emirates,DU UAE,Transguard Group LLC,API User,E6AEAE17361
2022-02-20 18:27,72807036,"25,599.7960","25,591.8760",220.00 NPR,9.00,7.9200,1.0800,565272552,1597699,Success,Nepal,Ncell Nepal,Transguard Group LLC,API User,NCNPNP79518
2022-02-20 18:28,72807067,"25,591.8760","25,586.9760",05.00 AED,5.00,4.9000,0.1000,565272656,1597702,Success,United Arab Emirates,DU UAE,Transguard Group LLC,API User,E6AEAE17361
2022-02-20 18:32,72807413,"25,586.9760","25,582.0760",05.00 AED,5.00,4.9000,0.1000,565273559,1597715,Success,United Arab Emirates,DU UAE,Transguard Group LLC,API User,E6AEAE17361
2022-02-20 18:39,72807921,"25,582.0760","25,572.2760",10.00 AED,10.00,9.8000,0.2000,565274873,1597722,Success,United Arab Emirates,DU UAE,Transguard Group LLC,API User,E6AEAE22430
2022-02-20 18:40,72808052,"25,572.2760","25,567.3760",05.00 AED,5.00,4.9000,0.1000,565275207,1597726,Success,United Arab Emirates,DU UAE,Transguard Group LLC,API User,E6AEAE17361
2022-02-20 18:45,72808414,"25,567.3760","25,562.4760",05.00 AED,5.00,4.9000,0.1000,565276178,1597744,Success,United Arab Emirates,DU UAE,Transguard Group LLC,API User,E6AEAE17361
2022-02-20 18:46,72808485,"25,562.4760","25,542.8760",20.00 AED,20.00,19.6000,0.4000,565276375,1597752,Success,United Arab Emirates,DU UAE,Transguard Group LLC,API User,E6AEAE12938
2022-02-20 18:46,72808493,"25,542.8760","25,537.9760",05.00 AED,5.00,4.9000,0.1000,565276392,1597753,Success,United Arab Emirates,DU UAE,Transguard Group LLC,API User,E6AEAE17361
2022-02-20 18:47,72808550,"25,537.9760","25,528.1760",10.00 AED,10.00,9.8000,0.2000,565276520,1597759,Success,United Arab Emirates,DU UAE,Transguard Group LLC,API User,E6AEAE22430
2022-02-20 18:47,72808616,"25,528.1760","25,518.3760",10.00 AED,10.00,9.8000,0.2000,565276683,1597765,Success,United Arab Emirates,DU UAE,Transguard Group LLC,API User,E6AEAE22430
2022-02-20 18:48,72808661,"25,518.3760","25,508.5760",10.00 AED,10.00,9.8000,0.2000,565276793,1597768,Success,United Arab Emirates,DU UAE,Transguard Group LLC,API User,E6AEAE22430
2022-02-20 18:48,72808704,"25,508.5760","25,503.6760",05.00 AED,5.00,4.9000,0.1000,565276885,1597771,Success,United Arab Emirates,DU UAE,Transguard Group LLC,API User,E6AEAE17361
2022-02-20 18:52,72808950,"25,503.6760","25,484.0760",20.00 AED,20.00,19.6000,0.4000,565277527,1597779,Success,United Arab Emirates,DU UAE,Transguard Group LLC,API User,E6AEAE12938
2022-02-20 18:52,72809020,"25,484.0760","25,479.1760",05.00 AED,5.00,4.9000,0.1000,565277672,1597783,Success,United Arab Emirates,DU UAE,Transguard Group LLC,API User,E6AEAE17361
2022-02-20 18:52,72809034,"25,479.1760","25,447.2760",549.00 INR,36.25,31.9000,4.3500,565277703,1597784,Success,India,Airtel India,Transguard Group LLC,API User,AIININ7098
2022-02-20 18:56,72809289,"25,447.2760","25,442.3760",05.00 AED,5.00,4.9000,0.1000,565278346,1597790,Success,United Arab Emirates,DU UAE,Transguard Group LLC,API User,E6AEAE17361
2022-02-20 18:57,72809457,"25,442.3760","25,432.5760",10.00 AED,10.00,9.8000,0.2000,565278773,1597797,Success,United Arab Emirates,DU UAE,Transguard Group LLC,API User,E6AEAE22430
2022-02-20 18:58,72809484,"25,432.5760","25,422.7760",10.00 AED,10.00,9.8000,0.2000,565278833,1597798,Success,United Arab Emirates,DU UAE,Transguard Group LLC,API User,E6AEAE22430
2022-02-20 18:58,72809514,"25,422.7760","25,417.8760",05.00 AED,5.00,4.9000,0.1000,565278924,1597804,Success,United Arab Emirates,DU UAE,Transguard Group LLC,API User,E6AEAE17361
2022-02-20 19:00,72809653,"25,417.8760","25,398.2760",20.00 AED,20.00,19.6000,0.4000,565279272,1597810,Success,United Arab Emirates,DU UAE,Transguard Group LLC,API User,E6AEAE12938
2022-02-20 19:10,72810582,"25,398.2760","25,388.4760",10.00 AED,10.00,9.8000,0.2000,565281600,1597835,Success,United Arab Emirates,DU UAE,Transguard Group LLC,API User,E6AEAE22430
2022-02-20 19:16,72811069,"25,388.4760","25,383.5760",05.00 AED,5.00,4.9000,0.1000,565282839,1597846,Success,United Arab Emirates,DU UAE,Transguard Group LLC,API User,E6AEAE17361
2022-02-20 19:16,72811097,"25,383.5760","25,373.7760",10.00 AED,10.00,9.8000,0.2000,565282930,1597850,Success,United Arab Emirates,DU UAE,Transguard Group LLC,API User,E6AEAE22430
2022-02-20 19:17,72811206,"25,373.7760","25,354.1760",20.00 AED,20.00,19.6000,0.4000,565283219,1597852,Success,United Arab Emirates,DU UAE,Transguard Group LLC,API User,E6AEAE12938
2022-02-20 19:19,72811325,"25,354.1760","25,344.3760",10.00 AED,10.00,9.8000,0.2000,565283519,1597857,Success,United Arab Emirates,DU UAE,Transguard Group LLC,API User,E6AEAE22430
2022-02-20 19:19,72811331,"25,344.3760","25,339.4760",05.00 AED,5.00,4.9000,0.1000,565283545,1597858,Success,United Arab Emirates,DU UAE,Transguard Group LLC,API User,E6AEAE17361
2022-02-20 19:19,72811376,"25,339.4760","25,334.5760",05.00 AED,5.00,4.9000,0.1000,565283653,1597861,Success,United Arab Emirates,DU UAE,Transguard Group LLC,API User,E6AEAE17361
2022-02-20 19:21,72811495,"25,334.5760","25,300.2760",35.00 AED,35.00,34.3000,0.7000,565283973,1597865,Success,United Arab Emirates,DU UAE,Transguard Group LLC,API User,E6AEAE73954
2022-02-20 19:21,72811588,"25,300.2760","25,290.4760",10.00 AED,10.00,9.8000,0.2000,565284181,1597870,Success,United Arab Emirates,DU UAE,Transguard Group LLC,API User,E6AEAE22430
2022-02-20 19:25,72811882,"25,290.4760","25,285.5760",05.00 AED,5.00,4.9000,0.1000,565284937,1597876,Success,United Arab Emirates,DU UAE,Transguard Group LLC,API User,E6AEAE17361
2022-02-20 19:26,72811944,"25,285.5760","25,280.6760",05.00 AED,5.00,4.9000,0.1000,565285131,1597880,Success,United Arab Emirates,DU UAE,Transguard Group LLC,API User,E6AEAE17361
2022-02-20 19:27,72812032,"25,280.6760","25,244.8160","1,000.00 NPR",40.75,35.8600,4.8900,565285365,1597883,Success,Nepal,Nepal Telecom Nepal,Transguard Group LLC,API User,NP_NE_TopUp_1000.00
2022-02-20 19:28,72812147,"25,244.8160","25,239.9160",05.00 AED,5.00,4.9000,0.1000,565285673,1597886,Success,United Arab Emirates,DU UAE,Transguard Group LLC,API User,E6AEAE17361
2022-02-20 19:29,72812236,"25,239.9160","25,236.1760",100.00 NPR,4.25,3.7400,0.5100,565285875,1597891,Success,Nepal,Ncell Nepal,Transguard Group LLC,API User,NP_NC_TopUp_100.00
2022-02-20 19:30,72812274,"25,236.1760","25,226.3760",10.00 AED,10.00,9.8000,0.2000,565285971,1597895,Success,United Arab Emirates,DU UAE,Transguard Group LLC,API User,E6AEAE22430
2022-02-20 19:30,72812279,"25,226.3760","25,221.4760",05.00 AED,5.00,4.9000,0.1000,565285991,1597896,Success,United Arab Emirates,DU UAE,Transguard Group LLC,API User,E6AEAE17361
2022-02-20 19:31,72812407,"25,221.4760","25,216.5760",05.00 AED,5.00,4.9000,0.1000,565286362,1597900,Success,United Arab Emirates,DU UAE,Transguard Group LLC,API User,E6AEAE17361
2022-02-20 19:32,72812441,"25,216.5760","25,211.6760",05.00 AED,5.00,4.9000,0.1000,565286456,1597902,Success,United Arab Emirates,DU UAE,Transguard Group LLC,API User,E6AEAE17361
2022-02-20 19:34,72812628,"25,211.6760","25,201.8760",10.00 AED,10.00,9.8000,0.2000,565286904,1597908,Success,United Arab Emirates,DU UAE,Transguard Group LLC,API User,E6AEAE22430
2022-02-20 19:35,72812730,"25,201.8760","25,196.9760",05.00 AED,5.00,4.9000,0.1000,565287160,1597913,Success,United Arab Emirates,DU UAE,Transguard Group LLC,API User,E6AEAE17361
2022-02-20 19:36,72812821,"25,196.9760","25,192.0760",05.00 AED,5.00,4.9000,0.1000,565287375,1597917,Success,United Arab Emirates,DU UAE,Transguard Group LLC,API User,E6AEAE17361
2022-02-20 19:38,72812980,"25,192.0760","25,182.2760",10.00 AED,10.00,9.8000,0.2000,565287799,1597924,Success,United Arab Emirates,DU UAE,Transguard Group LLC,API User,E6AEAE22430
2022-02-20 19:42,72813277,"25,182.2760","25,177.3760",05.00 AED,5.00,4.9000,0.1000,565288608,1597929,Success,United Arab Emirates,DU UAE,Transguard Group LLC,API User,E6AEAE17361
2022-02-20 19:43,72813365,"25,177.3760","25,172.4760",05.00 AED,5.00,4.9000,0.1000,565288834,1597934,Success,United Arab Emirates,DU UAE,Transguard Group LLC,API User,E6AEAE17361
2022-02-20 19:47,72813684,"25,172.4760","25,162.6760",10.00 AED,10.00,9.8000,0.2000,565289615,1597942,Success,United Arab Emirates,DU UAE,Transguard Group LLC,API User,E6AEAE22430
2022-02-20 19:50,72813963,"25,162.6760","25,157.7760",05.00 AED,5.00,4.9000,0.1000,565290347,1597950,Success,United Arab Emirates,DU UAE,Transguard Group LLC,API User,E6AEAE17361
2022-02-20 19:51,72814053,"25,157.7760","25,152.8760",05.00 AED,5.00,4.9000,0.1000,565290602,1597954,Success,United Arab Emirates,DU UAE,Transguard Group LLC,API User,E6AEAE17361
2022-02-20 19:52,72814137,"25,152.8760","25,147.9760",05.00 AED,5.00,4.9000,0.1000,565290796,1597960,Success,United Arab Emirates,DU UAE,Transguard Group LLC,API User,E6AEAE17361
2022-02-20 19:53,72814185,"25,147.9760","25,140.0560",220.00 NPR,9.00,7.9200,1.0800,565290916,1597964,Success,Nepal,Ncell Nepal,Transguard Group LLC,API User,NCNPNP79518
2022-02-20 19:53,72814219,"25,140.0560","25,135.1560",05.00 AED,5.00,4.9000,0.1000,565290987,1597967,Success,United Arab Emirates,DU UAE,Transguard Group LLC,API User,E6AEAE17361
2022-02-20 19:56,72814448,"25,135.1560","25,130.2560",05.00 AED,5.00,4.9000,0.1000,565291575,1597983,Success,United Arab Emirates,DU UAE,Transguard Group LLC,API User,E6AEAE17361
2022-02-20 19:58,72814630,"25,130.2560","25,110.6560",20.00 AED,20.00,19.6000,0.4000,565292054,1597990,Success,United Arab Emirates,DU UAE,Transguard Group LLC,API User,E6AEAE12938
2022-02-20 19:59,72814680,"25,110.6560","25,105.7560",05.00 AED,5.00,4.9000,0.1000,565292210,1597996,Success,United Arab Emirates,DU UAE,Transguard Group LLC,API User,E6AEAE17361
2022-02-20 20:01,72814839,"25,105.7560","25,076.3560",30.00 AED,30.00,29.4000,0.6000,565292649,1598003,Success,United Arab Emirates,DU UAE,Transguard Group LLC,API User,E6AEAE46146
2022-02-20 20:01,72814873,"25,076.3560","25,037.1560",40.00 AED,40.00,39.2000,0.8000,565292732,1598005,Success,United Arab Emirates,DU UAE,Transguard Group LLC,API User,E6AEAE64011
2022-02-20 20:02,72814956,"25,037.1560","25,032.2560",05.00 AED,5.00,4.9000,0.1000,565292947,1598013,Success,United Arab Emirates,DU UAE,Transguard Group LLC,API User,E6AEAE17361
2022-02-20 20:02,72814963,"25,032.2560","25,022.4560",10.00 AED,10.00,9.8000,0.2000,565292969,1598014,Success,United Arab Emirates,DU UAE,Transguard Group LLC,API User,E6AEAE22430
2022-02-20 20:02,72814983,"25,022.4560","25,017.5560",05.00 AED,5.00,4.9000,0.1000,565293013,1598017,Success,United Arab Emirates,DU UAE,Transguard Group LLC,API User,E6AEAE17361
2022-02-20 20:03,72815008,"25,017.5560","25,012.6560",05.00 AED,5.00,4.9000,0.1000,565293069,1598019,Success,United Arab Emirates,DU UAE,Transguard Group LLC,API User,E6AEAE17361
2022-02-20 20:07,72815357,"25,012.6560","25,007.7560",05.00 AED,5.00,4.9000,0.1000,565294027,1598026,Success,United Arab Emirates,DU UAE,Transguard Group LLC,API User,E6AEAE17361
2022-02-20 20:08,72815412,"25,007.7560","24,997.9560",10.00 AED,10.00,9.8000,0.2000,565294152,1598029,Success,United Arab Emirates,DU UAE,Transguard Group LLC,API User,E6AEAE22430
2022-02-20 20:10,72815575,"24,997.9560","24,993.0560",05.00 AED,5.00,4.9000,0.1000,565294597,1598038,Success,United Arab Emirates,DU UAE,Transguard Group LLC,API User,E6AEAE17361
2022-02-20 20:11,72815711,"24,993.0560","24,988.1560",05.00 AED,5.00,4.9000,0.1000,565294952,1598042,Success,United Arab Emirates,DU UAE,Transguard Group LLC,API User,E6AEAE17361
2022-02-20 20:15,72816083,"24,988.1560","24,983.2560",05.00 AED,5.00,4.9000,0.1000,565295956,1598060,Success,United Arab Emirates,DU UAE,Transguard Group LLC,API User,E6AEAE17361
2022-02-20 20:16,72816126,"24,983.2560","24,978.3560",05.00 AED,5.00,4.9000,0.1000,565296088,1598064,Success,United Arab Emirates,DU UAE,Transguard Group LLC,API User,E6AEAE17361
2022-02-20 20:19,72816413,"24,978.3560","24,973.4560",05.00 AED,5.00,4.9000,0.1000,565296852,1598069,Success,United Arab Emirates,DU UAE,Transguard Group LLC,API User,E6AEAE17361
2022-02-20 20:23,72816726,"24,973.4560","24,968.5560",05.00 AED,5.00,4.9000,0.1000,565297702,1598076,Success,United Arab Emirates,DU UAE,Transguard Group LLC,API User,E6AEAE17361
2022-02-20 20:32,72817487,"24,968.5560","24,958.7560",10.00 AED,10.00,9.8000,0.2000,565299737,1598089,Success,United Arab Emirates,DU UAE,Transguard Group LLC,API User,E6AEAE22430
2022-02-20 20:38,72817981,"24,958.7560","24,953.8560",05.00 AED,5.00,4.9000,0.1000,565301031,1598100,Success,United Arab Emirates,DU UAE,Transguard Group LLC,API User,E6AEAE17361
2022-02-20 20:41,72818221,"24,953.8560","24,944.0560",10.00 AED,10.00,9.8000,0.2000,565301688,1598105,Success,United Arab Emirates,DU UAE,Transguard Group LLC,API User,E6AEAE22430
2022-02-20 20:42,72818307,"24,944.0560","24,939.1560",05.00 AED,5.00,4.9000,0.1000,565301925,1598110,Success,United Arab Emirates,DU UAE,Transguard Group LLC,API User,E6AEAE17361
2022-02-20 20:44,72818493,"24,939.1560","24,929.3560",10.00 AED,10.00,9.8000,0.2000,565302390,1598113,Success,United Arab Emirates,DU UAE,Transguard Group LLC,API User,E6AEAE22430
2022-02-20 20:46,72818619,"24,929.3560","24,919.5560",10.00 AED,10.00,9.8000,0.2000,565302823,1598121,Success,United Arab Emirates,DU UAE,Transguard Group LLC,API User,E6AEAE22430
2022-02-20 20:47,72818670,"24,919.5560","24,909.7560",10.00 AED,10.00,9.8000,0.2000,565302949,1598126,Success,United Arab Emirates,DU UAE,Transguard Group LLC,API User,E6AEAE22430
2022-02-20 20:48,72818739,"24,909.7560","24,899.9560",10.00 AED,10.00,9.8000,0.2000,565303135,1598135,Success,United Arab Emirates,DU UAE,Transguard Group LLC,API User,E6AEAE22430
2022-02-20 20:50,72818930,"24,899.9560","24,895.0560",05.00 AED,5.00,4.9000,0.1000,565303685,1598140,Success,United Arab Emirates,DU UAE,Transguard Group LLC,API User,E6AEAE17361
2022-02-20 20:53,72819118,"24,895.0560","24,885.2560",10.00 AED,10.00,9.8000,0.2000,565304228,1598146,Success,United Arab Emirates,DU UAE,Transguard Group LLC,API User,E6AEAE22430
2022-02-20 20:53,72819145,"24,885.2560","24,876.6760",315.00 PKR,9.75,8.5800,1.1700,565304297,1598151,Success,Pakistan,Zong Pakistan,Transguard Group LLC,API User,ZNPKPK29953
2022-02-20 20:54,72819161,"24,876.6760","24,866.8760",10.00 AED,10.00,9.8000,0.2000,565304318,1598153,Success,United Arab Emirates,DU UAE,Transguard Group LLC,API User,E6AEAE22430
2022-02-20 20:54,72819169,"24,866.8760","24,861.9760",05.00 AED,5.00,4.9000,0.1000,565304336,1598154,Success,United Arab Emirates,DU UAE,Transguard Group LLC,API User,E6AEAE17361
2022-02-20 20:55,72819237,"24,861.9760","24,852.1760",10.00 AED,10.00,9.8000,0.2000,565304522,1598157,Success,United Arab Emirates,DU UAE,Transguard Group LLC,API User,E6AEAE22430
2022-02-20 21:06,72820199,"24,852.1760","24,847.2760",05.00 AED,5.00,4.9000,0.1000,565306996,1598174,Success,United Arab Emirates,DU UAE,Transguard Group LLC,API User,E6AEAE17361
2022-02-20 21:11,72820525,"24,847.2760","24,842.3760",05.00 AED,5.00,4.9000,0.1000,565307944,1598185,Success,United Arab Emirates,DU UAE,Transguard Group LLC,API User,E6AEAE17361
2022-02-20 21:11,72820558,"24,842.3760","24,837.4760",05.00 AED,5.00,4.9000,0.1000,565308030,1598188,Success,United Arab Emirates,DU UAE,Transguard Group LLC,API User,E6AEAE17361
2022-02-20 21:12,72820645,"24,837.4760","24,817.8760",20.00 AED,20.00,19.6000,0.4000,565308251,1598195,Success,United Arab Emirates,DU UAE,Transguard Group LLC,API User,E6AEAE12938
2022-02-20 21:12,72820674,"24,817.8760","24,808.0760",10.00 AED,10.00,9.8000,0.2000,565308304,1598198,Success,United Arab Emirates,DU UAE,Transguard Group LLC,API User,E6AEAE22430
2022-02-20 21:15,72820859,"24,808.0760","24,803.1760",05.00 AED,5.00,4.9000,0.1000,565308745,1598204,Success,United Arab Emirates,DU UAE,Transguard Group LLC,API User,E6AEAE17361
2022-02-20 21:15,72820895,"24,803.1760","24,798.2760",05.00 AED,5.00,4.9000,0.1000,565308868,1598209,Success,United Arab Emirates,DU UAE,Transguard Group LLC,API User,E6AEAE17361
2022-02-20 21:15,72820902,"24,798.2760","24,788.4760",10.00 AED,10.00,9.8000,0.2000,565308885,1598210,Success,United Arab Emirates,DU UAE,Transguard Group LLC,API User,E6AEAE22430
2022-02-20 21:19,72821189,"24,788.4760","24,773.7760",15.00 AED,15.00,14.7000,0.3000,565309701,1598219,Success,United Arab Emirates,DU UAE,Transguard Group LLC,API User,E6AEAE8527
2022-02-20 21:20,72821284,"24,773.7760","24,763.9760",10.00 AED,10.00,9.8000,0.2000,565309961,1598226,Success,United Arab Emirates,DU UAE,Transguard Group LLC,API User,E6AEAE22430
2022-02-20 21:23,72821461,"24,763.9760","24,759.0760",05.00 AED,5.00,4.9000,0.1000,565310384,1598229,Success,United Arab Emirates,DU UAE,Transguard Group LLC,API User,E6AEAE17361
2022-02-20 21:28,72821910,"24,759.0760","24,754.8960",150.00 PKR,4.75,4.1800,0.5700,565311592,1598241,Success,Pakistan,Jazz Pakistan,Transguard Group LLC,API User,MBPKPK20699
2022-02-20 21:29,72821947,"24,754.8960","24,749.9960",05.00 AED,5.00,4.9000,0.1000,565311665,1598244,Success,United Arab Emirates,DU UAE,Transguard Group LLC,API User,E6AEAE17361
2022-02-20 21:30,72822035,"24,749.9960","24,740.1960",10.00 AED,10.00,9.8000,0.2000,565311891,1598247,Success,United Arab Emirates,DU UAE,Transguard Group LLC,API User,E6AEAE22430
2022-02-20 21:41,72822804,"24,740.1960","24,730.3960",10.00 AED,10.00,9.8000,0.2000,565314101,1598263,Success,United Arab Emirates,DU UAE,Transguard Group LLC,API User,E6AEAE22430
2022-02-20 21:42,72822897,"24,730.3960","24,720.5960",10.00 AED,10.00,9.8000,0.2000,565314347,1598271,Success,United Arab Emirates,DU UAE,Transguard Group LLC,API User,E6AEAE22430
2022-02-20 21:44,72822991,"24,720.5960","24,716.4160",150.00 PKR,4.75,4.1800,0.5700,565314636,1598277,Success,Pakistan,Ufone Pakistan,Transguard Group LLC,API User,UFPKPK90336
2022-02-20 21:45,72823067,"24,716.4160","24,696.8160",20.00 AED,20.00,19.6000,0.4000,565314867,1598282,Success,United Arab Emirates,DU UAE,Transguard Group LLC,API User,E6AEAE12938
2022-02-20 21:47,72823254,"24,696.8160","24,691.9160",05.00 AED,5.00,4.9000,0.1000,565315400,1598286,Success,United Arab Emirates,DU UAE,Transguard Group LLC,API User,E6AEAE17361
2022-02-20 21:51,72823516,"24,691.9160","24,687.0160",05.00 AED,5.00,4.9000,0.1000,565316157,1598296,Success,United Arab Emirates,DU UAE,Transguard Group LLC,API User,E6AEAE17361
2022-02-20 21:53,72823637,"24,687.0160","24,647.8160",40.00 AED,40.00,39.2000,0.8000,565316462,1598299,Success,United Arab Emirates,DU UAE,Transguard Group LLC,API User,E6AEAE64011
2022-02-20 21:54,72823736,"24,647.8160","24,642.9160",05.00 AED,5.00,4.9000,0.1000,565316757,1598307,Success,United Arab Emirates,DU UAE,Transguard Group LLC,API User,E6AEAE17361
2022-02-20 21:56,72823833,"24,642.9160","24,638.0160",05.00 AED,5.00,4.9000,0.1000,565317038,1598315,Success,United Arab Emirates,DU UAE,Transguard Group LLC,API User,E6AEAE17361
2022-02-20 21:59,72824056,"24,638.0160","24,633.1160",05.00 AED,5.00,4.9000,0.1000,565317590,1598318,Success,United Arab Emirates,DU UAE,Transguard Group LLC,API User,E6AEAE17361
2022-02-20 22:01,72824203,"24,633.1160","24,628.2160",05.00 AED,5.00,4.9000,0.1000,565318037,1598325,Success,United Arab Emirates,DU UAE,Transguard Group LLC,API User,E6AEAE17361
2022-02-20 22:02,72824235,"24,628.2160","24,618.4160",10.00 AED,10.00,9.8000,0.2000,565318105,1598326,Success,United Arab Emirates,DU UAE,Transguard Group LLC,API User,E6AEAE22430
2022-02-20 22:11,72824775,"24,618.4160","24,608.6160",10.00 AED,10.00,9.8000,0.2000,565319803,1598334,Success,United Arab Emirates,DU UAE,Transguard Group LLC,API User,E6AEAE22430
2022-02-20 22:18,72825303,"24,608.6160","24,598.8160",10.00 AED,10.00,9.8000,0.2000,565321256,1598340,Success,United Arab Emirates,DU UAE,Transguard Group LLC,API User,E6AEAE22430
2022-02-20 22:33,72826204,"24,598.8160","24,593.9160",05.00 AED,5.00,4.9000,0.1000,565323903,1598351,Success,United Arab Emirates,DU UAE,Transguard Group LLC,API User,E6AEAE17361
2022-02-20 22:45,72826808,"24,593.9160","24,589.0160",05.00 AED,5.00,4.9000,0.1000,565325736,1598358,Success,United Arab Emirates,DU UAE,Transguard Group LLC,API User,E6AEAE17361
2022-02-20 22:51,72827143,"24,589.0160","24,584.1160",05.00 AED,5.00,4.9000,0.1000,565326792,1598368,Success,United Arab Emirates,DU UAE,Transguard Group LLC,API User,E6AEAE17361
2022-02-20 22:52,72827171,"24,584.1160","24,574.3160",10.00 AED,10.00,9.8000,0.2000,565326902,1598371,Success,United Arab Emirates,DU UAE,Transguard Group LLC,API User,E6AEAE22430
2022-02-20 23:02,72827683,"24,574.3160","24,569.4160",05.00 AED,5.00,4.9000,0.1000,565328460,1598384,Success,United Arab Emirates,DU UAE,Transguard Group LLC,API User,E6AEAE17361
2022-02-20 23:03,72827748,"24,569.4160","24,564.5160",05.00 AED,5.00,4.9000,0.1000,565328620,1598389,Success,United Arab Emirates,DU UAE,Transguard Group LLC,API User,E6AEAE17361
2022-02-20 23:04,72827817,"24,564.5160","24,554.7160",10.00 AED,10.00,9.8000,0.2000,565328826,1598392,Success,United Arab Emirates,DU UAE,Transguard Group LLC,API User,E6AEAE22430
2022-02-20 23:07,72827955,"24,554.7160","24,549.8160",05.00 AED,5.00,4.9000,0.1000,565329277,1598397,Success,United Arab Emirates,DU UAE,Transguard Group LLC,API User,E6AEAE17361
2022-02-20 23:14,72828318,"24,549.8160","24,541.6760",300.00 PKR,9.25,8.1400,1.1100,565330407,1598404,Success,Pakistan,Zong Pakistan,Transguard Group LLC,API User,ZNPKPK70504
2022-02-20 23:22,72828651,"24,541.6760","24,512.2760",30.00 AED,30.00,29.4000,0.6000,565331605,1598411,Success,United Arab Emirates,DU UAE,Transguard Group LLC,API User,E6AEAE46146
2022-02-20 23:28,72828935,"24,512.2760","24,507.3760",05.00 AED,5.00,4.9000,0.1000,565332572,1598418,Success,United Arab Emirates,DU UAE,Transguard Group LLC,API User,E6AEAE17361
2022-02-20 23:31,72829070,"24,507.3760","24,497.5760",10.00 AED,10.00,9.8000,0.2000,565333031,1598421,Success,United Arab Emirates,DU UAE,Transguard Group LLC,API User,E6AEAE22430
2022-02-20 23:40,72829407,"24,497.5760","24,479.9760",26.41 GHS,20.00,17.6000,2.4000,565334349,1598425,Success,Ghana,MTN Ghana,Transguard Group LLC,API User,GH_MT_TopUp
2022-02-20 23:40,72829418,"24,479.9760","24,475.0760",05.00 AED,5.00,4.9000,0.1000,565334421,1598427,Success,United Arab Emirates,DU UAE,Transguard Group LLC,API User,E6AEAE17361
2022-02-20 23:44,72829563,"24,475.0760","24,470.1760",05.00 AED,5.00,4.9000,0.1000,565334953,1598430,Success,United Arab Emirates,DU UAE,Transguard Group LLC,API User,E6AEAE17361
2022-02-20 23:50,72829810,"24,470.1760","24,465.2760",05.00 AED,5.00,4.9000,0.1000,565335863,1598433,Success,United Arab Emirates,DU UAE,Transguard Group LLC,API User,E6AEAE17361
2022-02-21 00:04,72830390,"24,465.2760","24,460.3760",05.00 AED,5.00,4.9000,0.1000,565337791,1598441,Success,United Arab Emirates,DU UAE,Transguard Group LLC,API User,E6AEAE17361
2022-02-21 00:07,72830512,"24,460.3760","24,455.4760",05.00 AED,5.00,4.9000,0.1000,565338191,1598444,Success,United Arab Emirates,DU UAE,Transguard Group LLC,API User,E6AEAE17361
2022-02-21 00:10,72830664,"24,455.4760","24,451.2960",150.00 PKR,4.75,4.1800,0.5700,565338664,1598449,Success,Pakistan,Ufone Pakistan,Transguard Group LLC,API User,UFPKPK90336
2022-02-21 00:14,72830792,"24,451.2960","24,441.4960",10.00 AED,10.00,9.8000,0.2000,565339080,1598454,Success,United Arab Emirates,DU UAE,Transguard Group LLC,API User,E6AEAE22430
2022-02-21 00:18,72830986,"24,441.4960","24,437.7560",100.00 NPR,4.25,3.7400,0.5100,565339682,1598457,Success,Nepal,Ncell Nepal,Transguard Group LLC,API User,NP_NC_TopUp_100.00
2022-02-21 00:44,72831948,"24,437.7560","24,427.9560",10.00 AED,10.00,9.8000,0.2000,565342962,1598472,Success,United Arab Emirates,DU UAE,Transguard Group LLC,API User,E6AEAE22430
2022-02-21 00:44,72831968,"24,427.9560","24,383.8560",45.00 AED,45.00,44.1000,0.9000,565343018,1598473,Success,United Arab Emirates,DU UAE,Transguard Group LLC,API User,E6AEAE35243
2022-02-21 00:45,72832000,"24,383.8560","24,374.0560",10.00 AED,10.00,9.8000,0.2000,565343153,1598477,Success,United Arab Emirates,DU UAE,Transguard Group LLC,API User,E6AEAE22430
2022-02-21 00:47,72832047,"24,374.0560","24,369.1560",05.00 AED,5.00,4.9000,0.1000,565343340,1598480,Success,United Arab Emirates,DU UAE,Transguard Group LLC,API User,E6AEAE17361
2022-02-21 00:49,72832156,"24,369.1560","24,364.2560",05.00 AED,5.00,4.9000,0.1000,565343647,1598483,Success,United Arab Emirates,DU UAE,Transguard Group LLC,API User,E6AEAE17361
2022-02-21 00:52,72832274,"24,364.2560","24,354.4560",10.00 AED,10.00,9.8000,0.2000,565344077,1598486,Success,United Arab Emirates,DU UAE,Transguard Group LLC,API User,E6AEAE22430
2022-02-21 01:27,72833469,"24,354.4560","24,349.5560",05.00 AED,5.00,4.9000,0.1000,565348378,1598492,Success,United Arab Emirates,DU UAE,Transguard Group LLC,API User,E6AEAE17361
2022-02-21 01:29,72833542,"24,349.5560","24,339.7560",10.00 AED,10.00,9.8000,0.2000,565348645,1598496,Success,United Arab Emirates,DU UAE,Transguard Group LLC,API User,E6AEAE22430
2022-02-21 01:48,72834111,"24,339.7560","24,329.9560",10.00 AED,10.00,9.8000,0.2000,565350885,1598504,Success,United Arab Emirates,DU UAE,Transguard Group LLC,API User,E6AEAE22430
2022-02-21 01:50,72834151,"24,329.9560","24,325.0560",05.00 AED,5.00,4.9000,0.1000,565351068,1598507,Success,United Arab Emirates,DU UAE,Transguard Group LLC,API User,E6AEAE17361
2022-02-21 02:36,72835551,"24,325.0560","24,285.8560",40.00 AED,40.00,39.2000,0.8000,565356159,1598520,Success,United Arab Emirates,DU UAE,Transguard Group LLC,API User,E6AEAE64011
2022-02-21 02:47,72835909,"24,285.8560","24,276.0560",10.00 AED,10.00,9.8000,0.2000,565357284,1598529,Success,United Arab Emirates,DU UAE,Transguard Group LLC,API User,E6AEAE22430
2022-02-21 02:47,72835921,"24,276.0560","24,266.2560",10.00 AED,10.00,9.8000,0.2000,565357318,1598530,Success,United Arab Emirates,DU UAE,Transguard Group LLC,API User,E6AEAE22430
2022-02-21 02:48,72835941,"24,266.2560","24,256.4560",10.00 AED,10.00,9.8000,0.2000,565357422,1598533,Success,United Arab Emirates,DU UAE,Transguard Group LLC,API User,E6AEAE22430
2022-02-21 03:40,72837518,"24,256.4560","24,251.5560",05.00 AED,5.00,4.9000,0.1000,565362819,1598542,Success,United Arab Emirates,DU UAE,Transguard Group LLC,API User,E6AEAE17361
2022-02-21 03:43,72837617,"24,251.5560","24,241.7560",10.00 AED,10.00,9.8000,0.2000,565363125,1598545,Success,United Arab Emirates,DU UAE,Transguard Group LLC,API User,E6AEAE22430
2022-02-21 04:26,72838819,"24,241.7560","24,236.8560",05.00 AED,5.00,4.9000,0.1000,565367408,1598557,Success,United Arab Emirates,DU UAE,Transguard Group LLC,API User,E6AEAE17361
2022-02-21 04:27,72838855,"24,236.8560","24,231.9560",05.00 AED,5.00,4.9000,0.1000,565367519,1598559,Success,United Arab Emirates,DU UAE,Transguard Group LLC,API User,E6AEAE17361
2022-02-21 04:39,72839153,"24,231.9560","24,227.0560",05.00 AED,5.00,4.9000,0.1000,565368675,1598569,Success,United Arab Emirates,DU UAE,Transguard Group LLC,API User,E6AEAE17361
2022-02-21 05:19,72840241,"24,227.0560","24,222.1560",05.00 AED,5.00,4.9000,0.1000,565372399,1598593,Success,United Arab Emirates,DU UAE,Transguard Group LLC,API User,E6AEAE17361
2022-02-21 05:19,72840248,"24,222.1560","24,217.2560",05.00 AED,5.00,4.9000,0.1000,565372413,1598594,Success,United Arab Emirates,DU UAE,Transguard Group LLC,API User,E6AEAE17361
2022-02-21 05:20,72840260,"24,217.2560","24,212.3560",05.00 AED,5.00,4.9000,0.1000,565372468,1598597,Success,United Arab Emirates,DU UAE,Transguard Group LLC,API User,E6AEAE17361
2022-02-21 05:20,72840282,"24,212.3560","24,207.4560",05.00 AED,5.00,4.9000,0.1000,565372524,1598600,Success,United Arab Emirates,DU UAE,Transguard Group LLC,API User,E6AEAE17361
2022-02-21 05:32,72840657,"24,207.4560","24,197.6560",10.00 AED,10.00,9.8000,0.2000,565373687,1598606,Success,United Arab Emirates,DU UAE,Transguard Group LLC,API User,E6AEAE22430
2022-02-21 05:49,72841131,"24,197.6560","24,192.7560",05.00 AED,5.00,4.9000,0.1000,565375107,1598622,Success,United Arab Emirates,DU UAE,Transguard Group LLC,API User,E6AEAE17361
2022-02-21 05:52,72841223,"24,192.7560","24,187.8560",05.00 AED,5.00,4.9000,0.1000,565375392,1598632,Success,United Arab Emirates,DU UAE,Transguard Group LLC,API User,E6AEAE17361
2022-02-21 05:53,72841267,"24,187.8560","24,178.0560",10.00 AED,10.00,9.8000,0.2000,565375518,1598635,Success,United Arab Emirates,DU UAE,Transguard Group LLC,API User,E6AEAE22430
2022-02-21 05:54,72841297,"24,178.0560","24,173.1560",05.00 AED,5.00,4.9000,0.1000,565375605,1598638,Success,United Arab Emirates,DU UAE,Transguard Group LLC,API User,E6AEAE17361
2022-02-21 06:03,72841582,"24,173.1560","24,168.2560",05.00 AED,5.00,4.9000,0.1000,565376405,1598657,Success,United Arab Emirates,DU UAE,Transguard Group LLC,API User,E6AEAE17361
2022-02-21 06:04,72841607,"24,168.2560","24,163.3560",05.00 AED,5.00,4.9000,0.1000,565376480,1598660,Success,United Arab Emirates,DU UAE,Transguard Group LLC,API User,E6AEAE17361
2022-02-21 06:11,72841814,"24,163.3560","24,153.5560",10.00 AED,10.00,9.8000,0.2000,565377036,1598669,Success,United Arab Emirates,DU UAE,Transguard Group LLC,API User,E6AEAE22430
2022-02-21 06:12,72841854,"24,153.5560","24,148.6560",05.00 AED,5.00,4.9000,0.1000,565377142,1598673,Success,United Arab Emirates,DU UAE,Transguard Group LLC,API User,E6AEAE17361
2022-02-21 06:27,72842324,"24,148.6560","24,129.0560",20.00 AED,20.00,19.6000,0.4000,565378416,1598688,Success,United Arab Emirates,DU UAE,Transguard Group LLC,API User,E6AEAE12938
2022-02-21 06:33,72842516,"24,129.0560","24,121.1360",220.00 NPR,9.00,7.9200,1.0800,565378920,1598695,Success,Nepal,Ncell Nepal,Transguard Group LLC,API User,NCNPNP79518
2022-02-21 06:35,72842595,"24,121.1360","24,111.3360",10.00 AED,10.00,9.8000,0.2000,565379140,1598699,Success,United Arab Emirates,DU UAE,Transguard Group LLC,API User,E6AEAE22430
2022-02-21 06:36,72842608,"24,111.3360","24,101.5360",10.00 AED,10.00,9.8000,0.2000,565379183,1598703,Success,United Arab Emirates,DU UAE,Transguard Group LLC,API User,E6AEAE22430
2022-02-21 06:38,72842652,"24,101.5360","24,096.6360",05.00 AED,5.00,4.9000,0.1000,565379327,1598708,Success,United Arab Emirates,DU UAE,Transguard Group LLC,API User,E6AEAE17361
2022-02-21 06:49,72843014,"24,096.6360","24,072.1360",25.00 AED,25.00,24.5000,0.5000,565380259,1598715,Success,United Arab Emirates,DU UAE,Transguard Group LLC,API User,E6AEAE17343
2022-02-21 06:53,72843157,"24,072.1360","24,032.9360",40.00 AED,40.00,39.2000,0.8000,565380611,1598720,Success,United Arab Emirates,DU UAE,Transguard Group LLC,API User,E6AEAE64011
2022-02-21 06:56,72843243,"24,032.9360","24,028.0360",05.00 AED,5.00,4.9000,0.1000,565380825,1598726,Success,United Arab Emirates,DU UAE,Transguard Group LLC,API User,E6AEAE17361
2022-02-21 06:57,72843305,"24,028.0360","23,998.6360",30.00 AED,30.00,29.4000,0.6000,565380994,1598732,Success,United Arab Emirates,DU UAE,Transguard Group LLC,API User,E6AEAE46146
2022-02-21 06:58,72843327,"23,998.6360","23,988.8360",10.00 AED,10.00,9.8000,0.2000,565381052,1598734,Success,United Arab Emirates,DU UAE,Transguard Group LLC,API User,E6AEAE22430
2022-02-21 07:01,72843422,"23,988.8360","23,969.2360",20.00 AED,20.00,19.6000,0.4000,565381304,1598737,Success,United Arab Emirates,DU UAE,Transguard Group LLC,API User,E6AEAE12938
2022-02-21 07:02,72843443,"23,969.2360","23,964.3360",05.00 AED,5.00,4.9000,0.1000,565381350,1598742,Success,United Arab Emirates,DU UAE,Transguard Group LLC,API User,E6AEAE17361
2022-02-21 07:05,72843546,"23,964.3360","23,959.4360",05.00 AED,5.00,4.9000,0.1000,565381613,1598745,Success,United Arab Emirates,DU UAE,Transguard Group LLC,API User,E6AEAE17361
2022-02-21 07:10,72843719,"23,959.4360","23,954.5360",05.00 AED,5.00,4.9000,0.1000,565382104,1598748,Success,United Arab Emirates,DU UAE,Transguard Group LLC,API User,E6AEAE17361
2022-02-21 07:14,72843835,"23,954.5360","23,944.7360",10.00 AED,10.00,9.8000,0.2000,565382398,1598755,Success,United Arab Emirates,DU UAE,Transguard Group LLC,API User,E6AEAE22430
2022-02-21 07:16,72843908,"23,944.7360","23,934.9360",10.00 AED,10.00,9.8000,0.2000,565382619,1598760,Success,United Arab Emirates,DU UAE,Transguard Group LLC,API User,E6AEAE22430
2022-02-21 07:25,72844199,"23,934.9360","23,930.0360",05.00 AED,5.00,4.9000,0.1000,565383362,1598768,Success,United Arab Emirates,DU UAE,Transguard Group LLC,API User,E6AEAE17361
2022-02-21 07:26,72844243,"23,930.0360","23,920.2360",10.00 AED,10.00,9.8000,0.2000,565383487,1598771,Success,United Arab Emirates,DU UAE,Transguard Group LLC,API User,E6AEAE22430
2022-02-21 07:30,72844356,"23,920.2360","23,916.0560",150.00 PKR,4.75,4.1800,0.5700,565383780,1598777,Success,Pakistan,Zong Pakistan,Transguard Group LLC,API User,ZNPKPK65621
2022-02-21 07:32,72844412,"23,916.0560","23,871.9560",45.00 AED,45.00,44.1000,0.9000,565383916,1598781,Success,United Arab Emirates,DU UAE,Transguard Group LLC,API User,E6AEAE35243
2022-02-21 07:33,72844437,"23,871.9560","23,867.0560",05.00 AED,5.00,4.9000,0.1000,565383983,1598786,Success,United Arab Emirates,DU UAE,Transguard Group LLC,API User,E6AEAE17361
2022-02-21 07:33,72844445,"23,867.0560","23,857.2560",10.00 AED,10.00,9.8000,0.2000,565384002,1598788,Success,United Arab Emirates,DU UAE,Transguard Group LLC,API User,E6AEAE22430
2022-02-21 07:34,72844475,"23,857.2560","23,837.6560",20.00 AED,20.00,19.6000,0.4000,565384060,1598791,Success,United Arab Emirates,DU UAE,Transguard Group LLC,API User,E6AEAE12938
2022-02-21 07:34,72844504,"23,837.6560","23,827.8560",10.00 AED,10.00,9.8000,0.2000,565384141,1598794,Success,United Arab Emirates,DU UAE,Transguard Group LLC,API User,E6AEAE22430
2022-02-21 07:39,72844664,"23,827.8560","23,822.9560",05.00 AED,5.00,4.9000,0.1000,565384531,1598799,Success,United Arab Emirates,DU UAE,Transguard Group LLC,API User,E6AEAE17361
2022-02-21 07:42,72844740,"23,822.9560","23,810.1960",460.00 PKR,14.50,12.7600,1.7400,565384777,1598803,Success,Pakistan,Jazz Pakistan,Transguard Group LLC,API User,MBPKPK49413
2022-02-21 07:42,72844751,"23,810.1960","23,805.2960",05.00 AED,5.00,4.9000,0.1000,565384806,1598805,Success,United Arab Emirates,DU UAE,Transguard Group LLC,API User,E6AEAE17361
2022-02-21 07:48,72844917,"23,805.2960","23,795.4960",10.00 AED,10.00,9.8000,0.2000,565385221,1598813,Success,United Arab Emirates,DU UAE,Transguard Group LLC,API User,E6AEAE22430
2022-02-21 07:49,72844965,"23,795.4960","23,790.5960",05.00 AED,5.00,4.9000,0.1000,565385342,1598816,Success,United Arab Emirates,DU UAE,Transguard Group LLC,API User,E6AEAE17361
2022-02-21 07:55,72845175,"23,790.5960","23,785.6960",05.00 AED,5.00,4.9000,0.1000,565385861,1598826,Success,United Arab Emirates,DU UAE,Transguard Group LLC,API User,E6AEAE17361
2022-02-21 07:58,72845279,"23,785.6960","23,780.7960",05.00 AED,5.00,4.9000,0.1000,565386158,1598829,Failure,United Arab Emirates,DU UAE,Transguard Group LLC,API User,E6AEAE17361
2022-02-21 07:58,72845279,"23,780.7960","23,775.8960",05.00 AED,5.00,4.9000,0.1000,565386158,1598829,Failure,United Arab Emirates,DU UAE,Transguard Group LLC,API User,E6AEAE17361
2022-02-21 07:59,72845305,"23,785.6960","23,775.8960",10.00 AED,10.00,9.8000,0.2000,565386213,1598832,Success,United Arab Emirates,DU UAE,Transguard Group LLC,API User,E6AEAE22430
2022-02-21 08:01,72845406,"23,775.8960","23,766.0960",10.00 AED,10.00,9.8000,0.2000,565386416,1598840,Success,United Arab Emirates,DU UAE,Transguard Group LLC,API User,E6AEAE22430
2022-02-21 08:03,72845469,"23,766.0960","23,761.1960",05.00 AED,5.00,4.9000,0.1000,565386573,1598850,Success,United Arab Emirates,DU UAE,Transguard Group LLC,API User,E6AEAE17361
2022-02-21 08:09,72845663,"23,761.1960","23,757.4560",100.00 NPR,4.25,3.7400,0.5100,565387064,1598862,Success,Nepal,Nepal Telecom Nepal,Transguard Group LLC,API User,NP_NE_TopUp_100.00
2022-02-21 08:13,72845784,"23,757.4560","23,752.5560",05.00 AED,5.00,4.9000,0.1000,565387347,1598869,Success,United Arab Emirates,DU UAE,Transguard Group LLC,API User,E6AEAE17361
2022-02-21 08:13,72845790,"23,752.5560","23,743.7560",832.00 NGN,10.00,8.8000,1.2000,565387353,1598870,Success,Nigeria,Glo Nigeria,Transguard Group LLC,API User,NG_GL_TopUp
2022-02-21 08:18,72845942,"23,743.7560","23,733.9560",10.00 AED,10.00,9.8000,0.2000,565387748,1598878,Success,United Arab Emirates,DU UAE,Transguard Group LLC,API User,E6AEAE22430
2022-02-21 08:18,72845956,"23,733.9560","23,729.0560",05.00 AED,5.00,4.9000,0.1000,565387778,1598882,Success,United Arab Emirates,DU UAE,Transguard Group LLC,API User,E6AEAE17361
2022-02-21 08:19,72846001,"23,729.0560","23,719.2560",10.00 AED,10.00,9.8000,0.2000,565387871,1598887,Success,United Arab Emirates,DU UAE,Transguard Group LLC,API User,E6AEAE22430
2022-02-21 08:20,72846035,"23,719.2560","23,714.3560",05.00 AED,5.00,4.9000,0.1000,565387939,1598890,Success,United Arab Emirates,DU UAE,Transguard Group LLC,API User,E6AEAE17361
2022-02-21 08:27,72846286,"23,714.3560","23,709.4560",05.00 AED,5.00,4.9000,0.1000,565388533,1598904,Success,United Arab Emirates,DU UAE,Transguard Group LLC,API User,E6AEAE17361
2022-02-21 08:28,72846322,"23,709.4560","23,699.6560",10.00 AED,10.00,9.8000,0.2000,565388644,1598909,Success,United Arab Emirates,DU UAE,Transguard Group LLC,API User,E6AEAE22430
2022-02-21 08:31,72846389,"23,699.6560","23,689.8560",10.00 AED,10.00,9.8000,0.2000,565388813,1598914,Success,United Arab Emirates,DU UAE,Transguard Group LLC,API User,E6AEAE22430
2022-02-21 08:36,72846574,"23,689.8560","23,673.7960",575.00 PKR,18.25,16.0600,2.1900,565389224,1598919,Success,Pakistan,Telenor Pakistan,Transguard Group LLC,API User,TPPKPK7947
2022-02-21 08:37,72846617,"23,673.7960","23,668.8960",05.00 AED,5.00,4.9000,0.1000,565389308,1598923,Success,United Arab Emirates,DU UAE,Transguard Group LLC,API User,E6AEAE17361
2022-02-21 08:40,72846743,"23,668.8960","23,659.0960",10.00 AED,10.00,9.8000,0.2000,565389600,1598931,Success,United Arab Emirates,DU UAE,Transguard Group LLC,API User,E6AEAE22430
2022-02-21 08:41,72846795,"23,659.0960","23,649.2960",10.00 AED,10.00,9.8000,0.2000,565389717,1598936,Success,United Arab Emirates,DU UAE,Transguard Group LLC,API User,E6AEAE22430
2022-02-21 08:44,72846888,"23,649.2960","23,644.3960",05.00 AED,5.00,4.9000,0.1000,565389964,1598939,Success,United Arab Emirates,DU UAE,Transguard Group LLC,API User,E6AEAE17361
2022-02-21 08:46,72846947,"23,644.3960","23,639.4960",05.00 AED,5.00,4.9000,0.1000,565390091,1598945,Success,United Arab Emirates,DU UAE,Transguard Group LLC,API User,E6AEAE17361
2022-02-21 08:50,72847095,"23,639.4960","23,619.8960",20.00 AED,20.00,19.6000,0.4000,565390423,1598950,Success,United Arab Emirates,DU UAE,Transguard Group LLC,API User,E6AEAE12938
2022-02-21 08:56,72847310,"23,619.8960","23,610.0960",10.00 AED,10.00,9.8000,0.2000,565390915,1598958,Success,United Arab Emirates,DU UAE,Transguard Group LLC,API User,E6AEAE22430
2022-02-21 08:57,72847347,"23,610.0960","23,605.1960",05.00 AED,5.00,4.9000,0.1000,565391004,1598965,Success,United Arab Emirates,DU UAE,Transguard Group LLC,API User,E6AEAE17361
2022-02-21 08:57,72847364,"23,605.1960","23,600.2960",05.00 AED,5.00,4.9000,0.1000,565391028,1598969,Success,United Arab Emirates,DU UAE,Transguard Group LLC,API User,E6AEAE17361
2022-02-21 08:57,72847365,"23,600.2960","23,580.6960",20.00 AED,20.00,19.6000,0.4000,565391044,1598970,Success,United Arab Emirates,DU UAE,Transguard Group LLC,API User,E6AEAE12938
2022-02-21 09:00,72847443,"23,580.6960","23,572.7760",220.00 NPR,9.00,7.9200,1.0800,565391249,1598979,Success,Nepal,Ncell Nepal,Transguard Group LLC,API User,NCNPNP79518
2022-02-21 09:07,72847701,"23,572.7760","23,567.8760",05.00 AED,5.00,4.9000,0.1000,565391844,1598996,Success,United Arab Emirates,DU UAE,Transguard Group LLC,API User,E6AEAE17361
2022-02-21 09:10,72847832,"23,567.8760","23,562.9760",05.00 AED,5.00,4.9000,0.1000,565392129,1599000,Success,United Arab Emirates,DU UAE,Transguard Group LLC,API User,E6AEAE17361
2022-02-21 09:16,72848035,"23,562.9760","23,558.0760",05.00 AED,5.00,4.9000,0.1000,565392615,1599005,Success,United Arab Emirates,DU UAE,Transguard Group LLC,API User,E6AEAE17361
2022-02-21 09:19,72848137,"23,558.0760","23,553.1760",05.00 AED,5.00,4.9000,0.1000,565392850,1599016,Success,United Arab Emirates,DU UAE,Transguard Group LLC,API User,E6AEAE17361
2022-02-21 09:19,72848163,"23,553.1760","23,539.3160",529.00 PKR,15.75,13.8600,1.8900,565392919,1599021,Success,Pakistan,Ufone Pakistan,Transguard Group LLC,API User,UFPKPK6556
2022-02-21 09:20,72848187,"23,539.3160","23,529.5160",10.00 AED,10.00,9.8000,0.2000,565392976,1599025,Success,United Arab Emirates,DU UAE,Transguard Group LLC,API User,E6AEAE22430
2022-02-21 09:23,72848275,"23,529.5160","23,524.6160",05.00 AED,5.00,4.9000,0.1000,565393204,1599037,Success,United Arab Emirates,DU UAE,Transguard Group LLC,API User,E6AEAE17361
2022-02-21 09:29,72848496,"23,524.6160","23,519.7160",05.00 AED,5.00,4.9000,0.1000,565393694,1599049,Success,United Arab Emirates,DU UAE,Transguard Group LLC,API User,E6AEAE17361
2022-02-21 09:29,72848499,"23,519.7160","23,509.9160",10.00 AED,10.00,9.8000,0.2000,565393709,1599050,Success,United Arab Emirates,DU UAE,Transguard Group LLC,API User,E6AEAE22430
2022-02-21 09:32,72848607,"23,509.9160","23,505.0160",05.00 AED,5.00,4.9000,0.1000,565393955,1599056,Success,United Arab Emirates,DU UAE,Transguard Group LLC,API User,E6AEAE17361
2022-02-21 09:32,72848630,"23,505.0160","23,495.2160",10.00 AED,10.00,9.8000,0.2000,565394019,1599060,Success,United Arab Emirates,DU UAE,Transguard Group LLC,API User,E6AEAE22430
2022-02-21 09:34,72848713,"23,495.2160","23,490.3160",05.00 AED,5.00,4.9000,0.1000,565394189,1599066,Success,United Arab Emirates,DU UAE,Transguard Group LLC,API User,E6AEAE17361
2022-02-21 09:37,72848823,"23,490.3160","23,485.4160",05.00 AED,5.00,4.9000,0.1000,565394445,1599072,Success,United Arab Emirates,DU UAE,Transguard Group LLC,API User,E6AEAE17361
2022-02-21 09:50,72849254,"23,485.4160","23,480.5160",05.00 AED,5.00,4.9000,0.1000,565395437,1599090,Success,United Arab Emirates,DU UAE,Transguard Group LLC,API User,E6AEAE17361
2022-02-21 09:51,72849277,"23,480.5160","23,475.6160",05.00 AED,5.00,4.9000,0.1000,565395494,1599095,Success,United Arab Emirates,DU UAE,Transguard Group LLC,API User,E6AEAE17361
2022-02-21 09:51,72849303,"23,475.6160","23,470.7160",05.00 AED,5.00,4.9000,0.1000,565395554,1599099,Success,United Arab Emirates,DU UAE,Transguard Group LLC,API User,E6AEAE17361
2022-02-21 09:52,72849321,"23,470.7160","23,460.9160",10.00 AED,10.00,9.8000,0.2000,565395580,1599101,Success,United Arab Emirates,DU UAE,Transguard Group LLC,API User,E6AEAE22430
2022-02-21 10:00,72849605,"23,460.9160","23,448.1560",350.00 NPR,14.50,12.7600,1.7400,565396259,1599116,Success,Nepal,Ncell Nepal,Transguard Group LLC,API User,NCNPNP22699
2022-02-21 10:02,72849638,"23,448.1560","23,443.9760",150.00 PKR,4.75,4.1800,0.5700,565396364,1599120,Success,Pakistan,Ufone Pakistan,Transguard Group LLC,API User,UFPKPK90336
2022-02-21 10:02,72849661,"23,443.9760","23,439.0760",05.00 AED,5.00,4.9000,0.1000,565396420,1599122,Success,United Arab Emirates,DU UAE,Transguard Group LLC,API User,E6AEAE17361
2022-02-21 10:03,72849701,"23,439.0760","23,434.1760",05.00 AED,5.00,4.9000,0.1000,565396518,1599127,Success,United Arab Emirates,DU UAE,Transguard Group LLC,API User,E6AEAE17361
2022-02-21 10:05,72849768,"23,434.1760","23,429.2760",05.00 AED,5.00,4.9000,0.1000,565396670,1599132,Success,United Arab Emirates,DU UAE,Transguard Group LLC,API User,E6AEAE17361
2022-02-21 10:06,72849789,"23,429.2760","23,419.4760",10.00 AED,10.00,9.8000,0.2000,565396715,1599135,Success,United Arab Emirates,DU UAE,Transguard Group LLC,API User,E6AEAE22430
2022-02-21 10:08,72849867,"23,419.4760","23,409.6760",10.00 AED,10.00,9.8000,0.2000,565396916,1599141,Success,United Arab Emirates,DU UAE,Transguard Group LLC,API User,E6AEAE22430
2022-02-21 10:09,72849895,"23,409.6760","23,399.8760",10.00 AED,10.00,9.8000,0.2000,565396989,1599146,Success,United Arab Emirates,DU UAE,Transguard Group LLC,API User,E6AEAE22430
2022-02-21 10:10,72849926,"23,399.8760","23,394.9760",05.00 AED,5.00,4.9000,0.1000,565397061,1599150,Success,United Arab Emirates,DU UAE,Transguard Group LLC,API User,E6AEAE17361
2022-02-21 10:10,72849940,"23,394.9760","23,390.7960",150.00 PKR,4.75,4.1800,0.5700,565397093,1599152,Success,Pakistan,Ufone Pakistan,Transguard Group LLC,API User,UFPKPK90336
2022-02-21 10:22,72850389,"23,390.7960","23,380.9960",10.00 AED,10.00,9.8000,0.2000,565398129,1599169,Success,United Arab Emirates,DU UAE,Transguard Group LLC,API User,E6AEAE22430
2022-02-21 10:23,72850398,"23,380.9960","23,376.0960",05.00 AED,5.00,4.9000,0.1000,565398151,1599171,Success,United Arab Emirates,DU UAE,Transguard Group LLC,API User,E6AEAE17361
2022-02-21 10:24,72850434,"23,376.0960","23,371.1960",05.00 AED,5.00,4.9000,0.1000,565398237,1599174,Success,United Arab Emirates,DU UAE,Transguard Group LLC,API User,E6AEAE17361
2022-02-21 10:26,72850529,"23,371.1960","23,366.2960",05.00 AED,5.00,4.9000,0.1000,565398449,1599180,Success,United Arab Emirates,DU UAE,Transguard Group LLC,API User,E6AEAE17361
2022-02-21 10:27,72850548,"23,366.2960","23,361.3960",05.00 AED,5.00,4.9000,0.1000,565398490,1599183,Success,United Arab Emirates,DU UAE,Transguard Group LLC,API User,E6AEAE17361
2022-02-21 10:31,72850721,"23,361.3960","23,351.5960",10.00 AED,10.00,9.8000,0.2000,565398879,1599186,Success,United Arab Emirates,DU UAE,Transguard Group LLC,API User,E6AEAE22430
2022-02-21 10:35,72850877,"23,351.5960","23,346.6960",05.00 AED,5.00,4.9000,0.1000,565399212,1599192,Success,United Arab Emirates,DU UAE,Transguard Group LLC,API User,E6AEAE17361
2022-02-21 10:37,72850964,"23,346.6960","23,336.8960",10.00 AED,10.00,9.8000,0.2000,565399424,1599200,Success,United Arab Emirates,DU UAE,Transguard Group LLC,API User,E6AEAE22430
2022-02-21 10:39,72851016,"23,336.8960","23,331.9960",05.00 AED,5.00,4.9000,0.1000,565399551,1599205,Success,United Arab Emirates,DU UAE,Transguard Group LLC,API User,E6AEAE17361
2022-02-21 10:40,72851093,"23,331.9960","23,327.0960",05.00 AED,5.00,4.9000,0.1000,565399740,1599211,Success,United Arab Emirates,DU UAE,Transguard Group LLC,API User,E6AEAE17361
2022-02-21 10:42,72851153,"23,327.0960","23,322.1960",05.00 AED,5.00,4.9000,0.1000,565399866,1599215,Success,United Arab Emirates,DU UAE,Transguard Group LLC,API User,E6AEAE17361
2022-02-21 10:44,72851211,"23,322.1960","23,317.2960",05.00 AED,5.00,4.9000,0.1000,565400001,1599221,Success,United Arab Emirates,DU UAE,Transguard Group LLC,API User,E6AEAE17361
2022-02-21 10:44,72851236,"23,317.2960","23,312.3960",05.00 AED,5.00,4.9000,0.1000,565400059,1599224,Success,United Arab Emirates,DU UAE,Transguard Group LLC,API User,E6AEAE17361
2022-02-21 10:47,72851321,"23,312.3960","23,307.4960",05.00 AED,5.00,4.9000,0.1000,565400294,1599227,Success,United Arab Emirates,DU UAE,Transguard Group LLC,API User,E6AEAE17361
2022-02-21 10:48,72851340,"23,307.4960","23,297.6960",10.00 AED,10.00,9.8000,0.2000,565400341,1599230,Success,United Arab Emirates,DU UAE,Transguard Group LLC,API User,E6AEAE22430
2022-02-21 11:00,72851753,"23,297.6960","23,292.7960",05.00 AED,5.00,4.9000,0.1000,565401356,1599241,Success,United Arab Emirates,DU UAE,Transguard Group LLC,API User,E6AEAE17361
2022-02-21 11:11,72852114,"23,292.7960","23,287.8960",05.00 AED,5.00,4.9000,0.1000,565402191,1599260,Success,United Arab Emirates,DU UAE,Transguard Group LLC,API User,E6AEAE17361
2022-02-21 11:11,72852128,"23,287.8960","23,273.3760",400.00 NPR,16.50,14.5200,1.9800,565402230,1599263,Success,Nepal,Nepal Telecom Nepal,Transguard Group LLC,API User,NENPNP18292
2022-02-21 11:16,72852319,"23,273.3760","23,268.4760",05.00 AED,5.00,4.9000,0.1000,565402624,1599270,Success,United Arab Emirates,DU UAE,Transguard Group LLC,API User,E6AEAE17361
2022-02-21 11:19,72852407,"23,268.4760","23,258.6760",10.00 AED,10.00,9.8000,0.2000,565402839,1599275,Success,United Arab Emirates,DU UAE,Transguard Group LLC,API User,E6AEAE22430
2022-02-21 11:25,72852650,"23,258.6760","23,250.5360",300.00 PKR,9.25,8.1400,1.1100,565403398,1599287,Success,Pakistan,Zong Pakistan,Transguard Group LLC,API User,ZNPKPK70504
2022-02-21 11:25,72852668,"23,250.5360","23,245.6360",05.00 AED,5.00,4.9000,0.1000,565403419,1599289,Success,United Arab Emirates,DU UAE,Transguard Group LLC,API User,E6AEAE17361
2022-02-21 11:25,72852674,"23,245.6360","23,240.7360",05.00 AED,5.00,4.9000,0.1000,565403431,1599290,Success,United Arab Emirates,DU UAE,Transguard Group LLC,API User,E6AEAE17361
2022-02-21 11:27,72852752,"23,240.7360","23,235.8360",05.00 AED,5.00,4.9000,0.1000,565403574,1599298,Success,United Arab Emirates,DU UAE,Transguard Group LLC,API User,E6AEAE17361
2022-02-21 11:27,72852769,"23,235.8360","23,226.0360",10.00 AED,10.00,9.8000,0.2000,565403609,1599301,Success,United Arab Emirates,DU UAE,Transguard Group LLC,API User,E6AEAE22430
2022-02-21 11:27,72852770,"23,226.0360","23,216.2360",10.00 AED,10.00,9.8000,0.2000,565403613,1599302,Success,United Arab Emirates,DU UAE,Transguard Group LLC,API User,E6AEAE22430
2022-02-21 11:28,72852795,"23,216.2360","23,206.4360",10.00 AED,10.00,9.8000,0.2000,565403659,1599305,Success,United Arab Emirates,DU UAE,Transguard Group LLC,API User,E6AEAE22430
2022-02-21 11:33,72852981,"23,206.4360","23,201.5360",05.00 AED,5.00,4.9000,0.1000,565404072,1599316,Success,United Arab Emirates,DU UAE,Transguard Group LLC,API User,E6AEAE17361
2022-02-21 11:34,72853046,"23,201.5360","23,196.6360",05.00 AED,5.00,4.9000,0.1000,565404216,1599319,Success,United Arab Emirates,DU UAE,Transguard Group LLC,API User,E6AEAE17361
2022-02-21 11:45,72853442,"23,196.6360","23,191.7360",05.00 AED,5.00,4.9000,0.1000,565405148,1599335,Success,United Arab Emirates,DU UAE,Transguard Group LLC,API User,E6AEAE17361
2022-02-21 11:49,72853598,"23,191.7360","23,181.9360",10.00 AED,10.00,9.8000,0.2000,565405482,1599343,Success,United Arab Emirates,DU UAE,Transguard Group LLC,API User,E6AEAE22430
2022-02-21 11:50,72853644,"23,181.9360","23,162.3360",20.00 AED,20.00,19.6000,0.4000,565405596,1599347,Success,United Arab Emirates,DU UAE,Transguard Group LLC,API User,E6AEAE12938
2022-02-21 11:54,72853792,"23,162.3360","23,152.5360",10.00 AED,10.00,9.8000,0.2000,565405935,1599353,Success,United Arab Emirates,DU UAE,Transguard Group LLC,API User,E6AEAE22430
2022-02-21 11:57,72853939,"23,152.5360","23,147.6360",05.00 AED,5.00,4.9000,0.1000,565406214,1599362,Success,United Arab Emirates,DU UAE,Transguard Group LLC,API User,E6AEAE17361
2022-02-21 11:59,72853982,"23,147.6360","23,137.8360",10.00 AED,10.00,9.8000,0.2000,565406311,1599369,Success,United Arab Emirates,DU UAE,Transguard Group LLC,API User,E6AEAE22430
2022-02-21 12:00,72854041,"23,137.8360","23,132.9360",05.00 AED,5.00,4.9000,0.1000,565406433,1599374,Success,United Arab Emirates,DU UAE,Transguard Group LLC,API User,E6AEAE17361
2022-02-21 12:01,72854081,"23,132.9360","23,128.0360",05.00 AED,5.00,4.9000,0.1000,565406519,1599377,Success,United Arab Emirates,DU UAE,Transguard Group LLC,API User,E6AEAE17361
2022-02-21 12:05,72854231,"23,128.0360","23,123.1360",05.00 AED,5.00,4.9000,0.1000,565406886,1599389,Success,United Arab Emirates,DU UAE,Transguard Group LLC,API User,E6AEAE17361
2022-02-21 12:10,72854382,"23,123.1360","23,118.2360",05.00 AED,5.00,4.9000,0.1000,565407230,1599402,Success,United Arab Emirates,DU UAE,Transguard Group LLC,API User,E6AEAE17361
2022-02-21 12:13,72854503,"23,118.2360","23,113.3360",05.00 AED,5.00,4.9000,0.1000,565407500,1599410,Success,United Arab Emirates,DU UAE,Transguard Group LLC,API User,E6AEAE17361
2022-02-21 12:14,72854564,"23,113.3360","23,103.5360",10.00 AED,10.00,9.8000,0.2000,565407646,1599413,Success,United Arab Emirates,DU UAE,Transguard Group LLC,API User,E6AEAE22430
2022-02-21 12:18,72854680,"23,103.5360","23,098.6360",05.00 AED,5.00,4.9000,0.1000,565407922,1599416,Success,United Arab Emirates,DU UAE,Transguard Group LLC,API User,E6AEAE17361
2022-02-21 12:18,72854697,"23,098.6360","23,094.8960",100.00 NPR,4.25,3.7400,0.5100,565407968,1599420,Success,Nepal,Ncell Nepal,Transguard Group LLC,API User,NP_NC_TopUp_100.00
2022-02-21 12:19,72854750,"23,094.8960","23,086.9760",220.00 NPR,9.00,7.9200,1.0800,565408073,1599423,Success,Nepal,Ncell Nepal,Transguard Group LLC,API User,NCNPNP79518
2022-02-21 12:23,72854884,"23,086.9760","23,062.4760",25.00 AED,25.00,24.5000,0.5000,565408370,1599430,Success,United Arab Emirates,DU UAE,Transguard Group LLC,API User,E6AEAE17343
2022-02-21 12:24,72854954,"23,062.4760","23,057.5760",05.00 AED,5.00,4.9000,0.1000,565408537,1599435,Success,United Arab Emirates,DU UAE,Transguard Group LLC,API User,E6AEAE17361
2022-02-21 12:27,72855059,"23,057.5760","23,047.7760",10.00 AED,10.00,9.8000,0.2000,565408800,1599446,Success,United Arab Emirates,DU UAE,Transguard Group LLC,API User,E6AEAE22430
2022-02-21 12:28,72855076,"23,047.7760","23,037.9760",10.00 AED,10.00,9.8000,0.2000,565408831,1599449,Success,United Arab Emirates,DU UAE,Transguard Group LLC,API User,E6AEAE22430
2022-02-21 12:29,72855125,"23,037.9760","23,020.5960",200.00 PHP,19.75,17.3800,2.3700,565408941,1599454,Success,Philippines,BS_Globe Philippines,Transguard Group LLC,API User,PH_GB_TopUp_200.00
2022-02-21 12:31,72855193,"23,020.5960","23,016.1960",50.00 PHP,5.00,4.4000,0.6000,565409100,1599462,Success,Philippines,BS_Globe Philippines,Transguard Group LLC,API User,PH_GB_TopUp_50.00
2022-02-21 12:32,72855244,"23,016.1960","23,011.2960",05.00 AED,5.00,4.9000,0.1000,565409232,1599467,Success,United Arab Emirates,DU UAE,Transguard Group LLC,API User,E6AEAE17361
2022-02-21 12:37,72855435,"23,011.2960","23,006.3960",05.00 AED,5.00,4.9000,0.1000,565409682,1599474,Success,United Arab Emirates,DU UAE,Transguard Group LLC,API User,E6AEAE17361
2022-02-21 12:38,72855460,"23,006.3960","22,996.5960",10.00 AED,10.00,9.8000,0.2000,565409748,1599478,Success,United Arab Emirates,DU UAE,Transguard Group LLC,API User,E6AEAE22430
2022-02-21 12:41,72855608,"22,996.5960","22,986.7960",10.00 AED,10.00,9.8000,0.2000,565410075,1599484,Success,United Arab Emirates,DU UAE,Transguard Group LLC,API User,E6AEAE22430
2022-02-21 12:42,72855631,"22,986.7960","22,978.4360",100.00 PHP,9.50,8.3600,1.1400,565410126,1599488,Success,Philippines,Smart (SunCellular) Philippines,Transguard Group LLC,API User,PH_SM_TopUp_100.00
2022-02-21 12:43,72855658,"22,978.4360","22,968.6360",10.00 AED,10.00,9.8000,0.2000,565410184,1599495,Success,United Arab Emirates,DU UAE,Transguard Group LLC,API User,E6AEAE22430
2022-02-21 12:43,72855679,"22,968.6360","22,958.8360",10.00 AED,10.00,9.8000,0.2000,565410240,1599498,Success,United Arab Emirates,DU UAE,Transguard Group LLC,API User,E6AEAE22430
2022-02-21 12:51,72855968,"22,958.8360","22,953.9360",05.00 AED,5.00,4.9000,0.1000,565410911,1599515,Success,United Arab Emirates,DU UAE,Transguard Group LLC,API User,E6AEAE17361
2022-02-21 12:51,72855976,"22,953.9360","22,949.0360",05.00 AED,5.00,4.9000,0.1000,565410927,1599516,Success,United Arab Emirates,DU UAE,Transguard Group LLC,API User,E6AEAE17361
2022-02-21 12:52,72856001,"22,949.0360","22,944.1360",05.00 AED,5.00,4.9000,0.1000,565410986,1599519,Success,United Arab Emirates,DU UAE,Transguard Group LLC,API User,E6AEAE17361
2022-02-21 12:54,72856100,"22,944.1360","22,924.5360",20.00 AED,20.00,19.6000,0.4000,565411222,1599523,Success,United Arab Emirates,DU UAE,Transguard Group LLC,API User,E6AEAE12938
2022-02-21 12:56,72856176,"22,924.5360","22,919.6360",05.00 AED,5.00,4.9000,0.1000,565411410,1599530,Success,United Arab Emirates,DU UAE,Transguard Group LLC,API User,E6AEAE17361
2022-02-21 13:00,72856320,"22,919.6360","22,909.8360",10.00 AED,10.00,9.8000,0.2000,565411723,1599535,Success,United Arab Emirates,DU UAE,Transguard Group LLC,API User,E6AEAE22430
2022-02-21 13:01,72856347,"22,909.8360","22,900.0360",10.00 AED,10.00,9.8000,0.2000,565411791,1599540,Success,United Arab Emirates,DU UAE,Transguard Group LLC,API User,E6AEAE22430
2022-02-21 13:01,72856352,"22,900.0360","22,895.1360",05.00 AED,5.00,4.9000,0.1000,565411806,1599541,Success,United Arab Emirates,DU UAE,Transguard Group LLC,API User,E6AEAE17361
2022-02-21 13:08,72856600,"22,895.1360","22,890.2360",05.00 AED,5.00,4.9000,0.1000,565412416,1599555,Success,United Arab Emirates,DU UAE,Transguard Group LLC,API User,E6AEAE17361
2022-02-21 13:08,72856604,"22,890.2360","22,885.3360",05.00 AED,5.00,4.9000,0.1000,565412421,1599556,Success,United Arab Emirates,DU UAE,Transguard Group LLC,API User,E6AEAE17361
2022-02-21 13:09,72856652,"22,885.3360","22,880.4360",05.00 AED,5.00,4.9000,0.1000,565412535,1599563,Success,United Arab Emirates,DU UAE,Transguard Group LLC,API User,E6AEAE17361
2022-02-21 13:10,72856714,"22,880.4360","22,875.5360",05.00 AED,5.00,4.9000,0.1000,565412661,1599569,Success,United Arab Emirates,DU UAE,Transguard Group LLC,API User,E6AEAE17361
2022-02-21 13:11,72856741,"22,875.5360","22,870.6360",05.00 AED,5.00,4.9000,0.1000,565412713,1599572,Success,United Arab Emirates,DU UAE,Transguard Group LLC,API User,E6AEAE17361
2022-02-21 13:15,72856898,"22,870.6360","22,851.0360",20.00 AED,20.00,19.6000,0.4000,565413087,1599577,Success,United Arab Emirates,DU UAE,Transguard Group LLC,API User,E6AEAE12938
2022-02-21 13:17,72856996,"22,851.0360","22,801.7860",50.00 AED,50.00,49.2500,0.7500,565413294,1599587,Success,United Arab Emirates,App Store & iTunes Gift Card UAE,Transguard Group LLC,API User,IASASA96606
2022-02-21 13:18,72857015,"22,801.7860","22,796.8860",05.00 AED,5.00,4.9000,0.1000,565413335,1599589,Success,United Arab Emirates,DU UAE,Transguard Group LLC,API User,E6AEAE17361
2022-02-21 13:22,72857204,"22,796.8860","22,790.9460",100.00 INR,6.75,5.9400,0.8100,565413814,1599594,Success,India,Airtel India,Transguard Group LLC,API User,AIININ36410
2022-02-21 13:28,72857455,"22,790.9460","22,786.0460",05.00 AED,5.00,4.9000,0.1000,565414370,1599605,Success,United Arab Emirates,DU UAE,Transguard Group LLC,API User,E6AEAE17361
2022-02-21 13:35,72857790,"22,786.0460","22,776.2460",10.00 AED,10.00,9.8000,0.2000,565415185,1599620,Success,United Arab Emirates,DU UAE,Transguard Group LLC,API User,E6AEAE22430
2022-02-21 13:41,72858026,"22,776.2460","22,756.6460",20.00 AED,20.00,19.6000,0.4000,565415813,1599635,Success,United Arab Emirates,DU UAE,Transguard Group LLC,API User,E6AEAE12938
2022-02-21 13:45,72858180,"22,756.6460","22,717.4460",40.00 AED,40.00,39.2000,0.8000,565416204,1599643,Success,United Arab Emirates,DU UAE,Transguard Group LLC,API User,E6AEAE64011
2022-02-21 13:48,72858306,"22,717.4460","22,709.5260",220.00 NPR,9.00,7.9200,1.0800,565416530,1599649,Success,Nepal,Ncell Nepal,Transguard Group LLC,API User,NCNPNP79518
2022-02-21 13:49,72858344,"22,709.5260","22,704.6260",05.00 AED,5.00,4.9000,0.1000,565416607,1599652,Success,United Arab Emirates,DU UAE,Transguard Group LLC,API User,E6AEAE17361
2022-02-21 13:56,72858613,"22,704.6260","22,685.0260",20.00 AED,20.00,19.6000,0.4000,565417265,1599655,Success,United Arab Emirates,DU UAE,Transguard Group LLC,API User,E6AEAE12938
2022-02-21 13:58,72858670,"22,685.0260","22,675.2260",10.00 AED,10.00,9.8000,0.2000,565417428,1599662,Success,United Arab Emirates,DU UAE,Transguard Group LLC,API User,E6AEAE22430
2022-02-21 13:59,72858720,"22,675.2260","22,670.3260",05.00 AED,5.00,4.9000,0.1000,565417554,1599669,Success,United Arab Emirates,DU UAE,Transguard Group LLC,API User,E6AEAE17361
2022-02-21 14:03,72858868,"22,670.3260","22,665.4260",05.00 AED,5.00,4.9000,0.1000,565417962,1599679,Success,United Arab Emirates,DU UAE,Transguard Group LLC,API User,E6AEAE17361
2022-02-21 14:07,72859044,"22,665.4260","22,655.6260",10.00 AED,10.00,9.8000,0.2000,565418378,1599689,Success,United Arab Emirates,DU UAE,Transguard Group LLC,API User,E6AEAE22430
2022-02-21 14:21,72859541,"22,655.6260","22,626.2260",30.00 AED,30.00,29.4000,0.6000,565419744,1599693,Success,United Arab Emirates,DU UAE,Transguard Group LLC,API User,E6AEAE46146
2022-02-21 14:22,72859591,"22,626.2260","22,616.4260",10.00 AED,10.00,9.8000,0.2000,565419851,1599696,Success,United Arab Emirates,DU UAE,Transguard Group LLC,API User,E6AEAE22430
2022-02-21 14:23,72859637,"22,616.4260","22,606.6260",10.00 AED,10.00,9.8000,0.2000,565419955,1599702,Failure,United Arab Emirates,DU UAE,Transguard Group LLC,API User,E6AEAE22430
2022-02-21 14:23,72859637,"22,606.6260","22,596.8260",10.00 AED,10.00,9.8000,0.2000,565419955,1599702,Failure,United Arab Emirates,DU UAE,Transguard Group LLC,API User,E6AEAE22430
2022-02-21 14:23,72859640,"22,616.4260","22,606.6260",10.00 AED,10.00,9.8000,0.2000,565419975,1599703,Success,United Arab Emirates,DU UAE,Transguard Group LLC,API User,E6AEAE22430
2022-02-21 14:27,72859765,"22,606.6260","22,596.8260",10.00 AED,10.00,9.8000,0.2000,565420352,1599710,Success,United Arab Emirates,DU UAE,Transguard Group LLC,API User,E6AEAE22430
2022-02-21 14:28,72859782,"22,596.8260","22,591.9260",05.00 AED,5.00,4.9000,0.1000,565420404,1599714,Success,United Arab Emirates,DU UAE,Transguard Group LLC,API User,E6AEAE17361
2022-02-21 14:32,72859973,"22,591.9260","22,587.0260",05.00 AED,5.00,4.9000,0.1000,565420864,1599725,Success,United Arab Emirates,DU UAE,Transguard Group LLC,API User,E6AEAE17361
2022-02-21 14:35,72860093,"22,587.0260","22,567.4260",20.00 AED,20.00,19.6000,0.4000,565421155,1599729,Success,United Arab Emirates,DU UAE,Transguard Group LLC,API User,E6AEAE12938
2022-02-21 14:47,72860595,"22,567.4260","22,562.5260",05.00 AED,5.00,4.9000,0.1000,565422445,1599745,Success,United Arab Emirates,DU UAE,Transguard Group LLC,API User,E6AEAE17361
2022-02-21 14:48,72860664,"22,562.5260","22,549.9860",460.00 PKR,14.25,12.5400,1.7100,565422635,1599748,Success,Pakistan,Zong Pakistan,Transguard Group LLC,API User,ZNPKPK8741
2022-02-21 14:55,72860967,"22,549.9860","22,545.0860",05.00 AED,5.00,4.9000,0.1000,565423371,1599752,Success,United Arab Emirates,DU UAE,Transguard Group LLC,API User,E6AEAE17361
2022-02-21 15:08,72861568,"22,545.0860","22,535.2860",10.00 AED,10.00,9.8000,0.2000,565424833,1599775,Success,United Arab Emirates,DU UAE,Transguard Group LLC,API User,E6AEAE22430
2022-02-21 15:08,72861584,"22,535.2860","22,530.3860",05.00 AED,5.00,4.9000,0.1000,565424871,1599777,Success,United Arab Emirates,DU UAE,Transguard Group LLC,API User,E6AEAE17361
2022-02-21 15:11,72861684,"22,530.3860","22,525.4860",05.00 AED,5.00,4.9000,0.1000,565425166,1599780,Success,United Arab Emirates,DU UAE,Transguard Group LLC,API User,E6AEAE17361
2022-02-21 15:25,72862223,"22,525.4860","22,515.6860",10.00 AED,10.00,9.8000,0.2000,565426743,1599790,Success,United Arab Emirates,DU UAE,Transguard Group LLC,API User,E6AEAE22430
2022-02-21 15:25,72862231,"22,515.6860","22,505.8860",10.00 AED,10.00,9.8000,0.2000,565426785,1599792,Success,United Arab Emirates,DU UAE,Transguard Group LLC,API User,E6AEAE22430
2022-02-21 15:28,72862346,"22,505.8860","22,500.9860",05.00 AED,5.00,4.9000,0.1000,565427112,1599800,Success,United Arab Emirates,DU UAE,Transguard Group LLC,API User,E6AEAE17361
2022-02-21 15:29,72862379,"22,500.9860","22,481.3860",20.00 AED,20.00,19.6000,0.4000,565427201,1599804,Success,United Arab Emirates,DU UAE,Transguard Group LLC,API User,E6AEAE12938
2022-02-21 15:30,72862420,"22,481.3860","22,476.4860",05.00 AED,5.00,4.9000,0.1000,565427315,1599810,Success,United Arab Emirates,DU UAE,Transguard Group LLC,API User,E6AEAE17361
2022-02-21 15:31,72862478,"22,476.4860","22,471.5860",05.00 AED,5.00,4.9000,0.1000,565427473,1599815,Success,United Arab Emirates,DU UAE,Transguard Group LLC,API User,E6AEAE17361
2022-02-21 15:36,72862669,"22,471.5860","22,466.6860",05.00 AED,5.00,4.9000,0.1000,565428043,1599822,Success,United Arab Emirates,DU UAE,Transguard Group LLC,API User,E6AEAE17361
2022-02-21 15:37,72862708,"22,466.6860","22,461.7860",05.00 AED,5.00,4.9000,0.1000,565428164,1599826,Success,United Arab Emirates,DU UAE,Transguard Group LLC,API User,E6AEAE17361
2022-02-21 15:37,72862714,"22,461.7860","22,456.8860",05.00 AED,5.00,4.9000,0.1000,565428180,1599827,Success,United Arab Emirates,DU UAE,Transguard Group LLC,API User,E6AEAE17361
2022-02-21 15:43,72862954,"22,456.8860","22,451.9860",05.00 AED,5.00,4.9000,0.1000,565428971,1599836,Success,United Arab Emirates,DU UAE,Transguard Group LLC,API User,E6AEAE17361
2022-02-21 15:45,72863012,"22,451.9860","22,442.1860",10.00 AED,10.00,9.8000,0.2000,565429167,1599841,Success,United Arab Emirates,DU UAE,Transguard Group LLC,API User,E6AEAE22430
2022-02-21 15:48,72863144,"22,442.1860","22,417.6860",25.00 AED,25.00,24.5000,0.5000,565429530,72863144,Failure,United Arab Emirates,DU UAE,Transguard Group LLC,mohammed.arafath@transguardgroup.com,E6AEAE17343
2022-02-21 15:48,72863144,"22,417.6860","22,393.1860",25.00 AED,25.00,24.5000,0.5000,565429530,72863144,Failure,United Arab Emirates,DU UAE,Transguard Group LLC,mohammed.arafath@transguardgroup.com,E6AEAE17343
2022-02-21 15:50,72863253,"22,442.1860","22,437.2610",05.00 AED,5.00,4.9250,0.0750,565429822,72863253,Success,United Arab Emirates,Etisalat UAE,Transguard Group LLC,mohammed.arafath@transguardgroup.com,ETAEAE54031
2022-02-21 15:51,72863280,"22,437.2610","22,417.5610",20.00 AED,20.00,19.7000,0.3000,565429896,72863280,Success,United Arab Emirates,Etisalat UAE,Transguard Group LLC,mohammed.arafath@transguardgroup.com,ETAEAE40692
2022-02-21 15:52,72863307,"22,417.5610","22,412.6610",05.00 AED,5.00,4.9000,0.1000,565429964,72863307,Success,United Arab Emirates,DU UAE,Transguard Group LLC,mohammed.arafath@transguardgroup.com,E6AEAE17361
2022-02-21 15:52,72863321,"22,412.6610","22,407.7610",05.00 AED,5.00,4.9000,0.1000,565429985,1599851,Success,United Arab Emirates,DU UAE,Transguard Group LLC,API User,E6AEAE17361
2022-02-21 15:53,72863356,"22,407.7610","22,397.9610",10.00 AED,10.00,9.8000,0.2000,565430093,1599856,Success,United Arab Emirates,DU UAE,Transguard Group LLC,API User,E6AEAE22430
2022-02-21 15:54,72863384,"22,397.9610","22,380.3610",26.41 GHS,20.00,17.6000,2.4000,565430188,72863384,Success,Ghana,MTN Ghana,Transguard Group LLC,mohammed.arafath@transguardgroup.com,GH_MT_TopUp
2022-02-21 15:54,72863397,"22,380.3610","22,375.4610",05.00 AED,5.00,4.9000,0.1000,565430203,1599861,Success,United Arab Emirates,DU UAE,Transguard Group LLC,API User,E6AEAE17361
2022-02-21 15:55,72863464,"22,375.4610","22,365.6110",10.00 AED,10.00,9.8500,0.1500,565430368,72863464,Success,United Arab Emirates,Etisalat UAE,Transguard Group LLC,mohammed.arafath@transguardgroup.com,ETAEAE95904
2022-02-21 15:55,72863470,"22,365.6110","22,360.7110",05.00 AED,5.00,4.9000,0.1000,565430379,1599864,Success,United Arab Emirates,DU UAE,Transguard Group LLC,API User,E6AEAE17361
2022-02-21 15:56,72863506,"22,360.7110","22,356.9710",100.00 NPR,4.25,3.7400,0.5100,565430480,1599867,Success,Nepal,Ncell Nepal,Transguard Group LLC,API User,NP_NC_TopUp_100.00
2022-02-21 15:56,72863520,"22,356.9710","22,347.1710",10.00 AED,10.00,9.8000,0.2000,565430523,72863520,Success,United Arab Emirates,DU UAE,Transguard Group LLC,mohammed.arafath@transguardgroup.com,E6AEAE22430
2022-02-21 15:57,72863548,"22,347.1710","22,337.3710",10.00 AED,10.00,9.8000,0.2000,565430582,1599870,Success,United Arab Emirates,DU UAE,Transguard Group LLC,API User,E6AEAE22430
2022-02-21 15:57,72863553,"22,337.3710","22,307.9710",30.00 AED,30.00,29.4000,0.6000,565430609,72863553,Success,United Arab Emirates,DU UAE,Transguard Group LLC,mohammed.arafath@transguardgroup.com,E6AEAE46146
2022-02-21 15:58,72863581,"22,307.9710","22,298.1710",10.00 AED,10.00,9.8000,0.2000,565430685,72863581,Success,United Arab Emirates,DU UAE,Transguard Group LLC,mohammed.arafath@transguardgroup.com,E6AEAE22430
2022-02-21 15:58,72863592,"22,298.1710","22,278.5710",20.00 AED,20.00,19.6000,0.4000,565430696,1599876,Success,United Arab Emirates,DU UAE,Transguard Group LLC,API User,E6AEAE12938
2022-02-21 15:59,72863617,"22,278.5710","22,268.7710",10.00 AED,10.00,9.8000,0.2000,565430793,72863617,Success,United Arab Emirates,DU UAE,Transguard Group LLC,mohammed.arafath@transguardgroup.com,E6AEAE22430
2022-02-21 16:06,72863921,"22,268.7710","22,258.9710",10.00 AED,10.00,9.8000,0.2000,565431709,1599895,Success,United Arab Emirates,DU UAE,Transguard Group LLC,API User,E6AEAE22430
2022-02-21 16:07,72863948,"22,258.9710","22,254.0710",05.00 AED,5.00,4.9000,0.1000,565431792,1599900,Success,United Arab Emirates,DU UAE,Transguard Group LLC,API User,E6AEAE17361
2022-02-21 16:10,72864073,"22,254.0710","22,249.1710",05.00 AED,5.00,4.9000,0.1000,565432166,1599910,Success,United Arab Emirates,DU UAE,Transguard Group LLC,API User,E6AEAE17361
2022-02-21 16:11,72864135,"22,249.1710","22,239.3710",10.00 AED,10.00,9.8000,0.2000,565432310,1599913,Success,United Arab Emirates,DU UAE,Transguard Group LLC,API User,E6AEAE22430
2022-02-21 16:13,72864193,"22,239.3710","22,229.5710",10.00 AED,10.00,9.8000,0.2000,565432473,1599918,Success,United Arab Emirates,DU UAE,Transguard Group LLC,API User,E6AEAE22430
2022-02-21 16:13,72864213,"22,229.5710","22,224.6710",05.00 AED,5.00,4.9000,0.1000,565432532,1599921,Success,United Arab Emirates,DU UAE,Transguard Group LLC,API User,E6AEAE17361
2022-02-21 16:14,72864227,"22,224.6710","22,219.7710",05.00 AED,5.00,4.9000,0.1000,565432583,1599924,Success,United Arab Emirates,DU UAE,Transguard Group LLC,API User,E6AEAE17361
2022-02-21 16:25,72864719,"22,219.7710","22,180.5710",40.00 AED,40.00,39.2000,0.8000,565434056,1599942,Success,United Arab Emirates,DU UAE,Transguard Group LLC,API User,E6AEAE64011
2022-02-21 16:26,72864763,"22,180.5710","22,175.6710",05.00 AED,5.00,4.9000,0.1000,565434189,1599947,Success,United Arab Emirates,DU UAE,Transguard Group LLC,API User,E6AEAE17361
2022-02-21 16:28,72864833,"22,175.6710","22,165.8710",10.00 AED,10.00,9.8000,0.2000,565434383,1599954,Success,United Arab Emirates,DU UAE,Transguard Group LLC,API User,E6AEAE22430
2022-02-21 16:28,72864875,"22,165.8710","22,156.0710",10.00 AED,10.00,9.8000,0.2000,565434492,1599958,Success,United Arab Emirates,DU UAE,Transguard Group LLC,API User,E6AEAE22430
2022-02-21 16:35,72865251,"22,156.0710","22,151.1710",05.00 AED,5.00,4.9000,0.1000,565435475,72865251,Failure,United Arab Emirates,DU UAE,Transguard Group LLC,mohammed.arafath@transguardgroup.com,E6AEAE17361
2022-02-21 16:35,72865251,"22,151.1710","22,146.2710",05.00 AED,5.00,4.9000,0.1000,565435475,72865251,Failure,United Arab Emirates,DU UAE,Transguard Group LLC,mohammed.arafath@transguardgroup.com,E6AEAE17361
2022-02-21 16:38,72865427,"22,156.0710","22,151.1710",05.00 AED,5.00,4.9000,0.1000,565435873,1599967,Success,United Arab Emirates,DU UAE,Transguard Group LLC,API User,E6AEAE17361
2022-02-21 16:43,72865717,"22,151.1710","22,146.7710",50.00 PHP,5.00,4.4000,0.6000,565436670,1599971,Success,Philippines,BS_Globe Philippines,Transguard Group LLC,API User,PH_GB_TopUp_50.00
2022-02-21 16:43,72865729,"22,146.7710","22,136.9710",10.00 AED,10.00,9.8000,0.2000,565436703,1599974,Success,United Arab Emirates,DU UAE,Transguard Group LLC,API User,E6AEAE22430
2022-02-21 16:45,72865823,"22,136.9710","22,132.0710",05.00 AED,5.00,4.9000,0.1000,565436961,1599979,Success,United Arab Emirates,DU UAE,Transguard Group LLC,API User,E6AEAE17361
2022-02-21 16:46,72865875,"22,132.0710","22,127.1710",05.00 AED,5.00,4.9000,0.1000,565437127,1599982,Success,United Arab Emirates,DU UAE,Transguard Group LLC,API User,E6AEAE17361
2022-02-21 16:49,72865976,"22,127.1710","22,122.2710",05.00 AED,5.00,4.9000,0.1000,565437431,1599987,Success,United Arab Emirates,DU UAE,Transguard Group LLC,API User,E6AEAE17361
2022-02-21 16:53,72866162,"22,122.2710","22,112.4710",10.00 AED,10.00,9.8000,0.2000,565437983,1599994,Success,United Arab Emirates,DU UAE,Transguard Group LLC,API User,E6AEAE22430
2022-02-21 16:54,72866221,"22,112.4710","22,092.8710",20.00 AED,20.00,19.6000,0.4000,565438119,1599999,Success,United Arab Emirates,DU UAE,Transguard Group LLC,API User,E6AEAE12938
2022-02-21 17:05,72866800,"22,092.8710","22,053.6710",40.00 AED,40.00,39.2000,0.8000,565439687,1600017,Success,United Arab Emirates,DU UAE,Transguard Group LLC,API User,E6AEAE64011
2022-02-21 17:06,72866858,"22,053.6710","22,034.0710",20.00 AED,20.00,19.6000,0.4000,565439845,1600022,Success,United Arab Emirates,DU UAE,Transguard Group LLC,API User,E6AEAE12938
2022-02-21 17:09,72867033,"22,034.0710","22,024.2710",10.00 AED,10.00,9.8000,0.2000,565440307,1600030,Success,United Arab Emirates,DU UAE,Transguard Group LLC,API User,E6AEAE22430
2022-02-21 17:09,72867042,"22,024.2710","22,014.4710",10.00 AED,10.00,9.8000,0.2000,565440348,1600031,Success,United Arab Emirates,DU UAE,Transguard Group LLC,API User,E6AEAE22430
2022-02-21 17:09,72867081,"22,014.4710","22,009.5710",05.00 AED,5.00,4.9000,0.1000,565440457,1600037,Failure,United Arab Emirates,DU UAE,Transguard Group LLC,API User,E6AEAE17361
2022-02-21 17:09,72867081,"22,009.5710","22,004.6710",05.00 AED,5.00,4.9000,0.1000,565440457,1600037,Failure,United Arab Emirates,DU UAE,Transguard Group LLC,API User,E6AEAE17361
2022-02-21 17:10,72867096,"22,014.4710","21,965.2210",50.00 AED,50.00,49.2500,0.7500,565440473,1600038,Success,United Arab Emirates,App Store & iTunes Gift Card UAE,Transguard Group LLC,API User,IASASA96606
2022-02-21 17:14,72867331,"21,965.2210","21,945.6210",20.00 AED,20.00,19.6000,0.4000,565441213,1600045,Success,United Arab Emirates,DU UAE,Transguard Group LLC,API User,E6AEAE12938
2022-02-21 17:16,72867427,"21,945.6210","21,935.8210",10.00 AED,10.00,9.8000,0.2000,565441514,1600048,Success,United Arab Emirates,DU UAE,Transguard Group LLC,API User,E6AEAE22430
2022-02-21 17:18,72867549,"21,935.8210","21,930.9210",05.00 AED,5.00,4.9000,0.1000,565441838,1600053,Success,United Arab Emirates,DU UAE,Transguard Group LLC,API User,E6AEAE17361
2022-02-21 17:20,72867663,"21,930.9210","21,926.0210",05.00 AED,5.00,4.9000,0.1000,565442151,1600056,Success,United Arab Emirates,DU UAE,Transguard Group LLC,API User,E6AEAE17361
2022-02-21 17:22,72867798,"21,926.0210","21,921.1210",05.00 AED,5.00,4.9000,0.1000,565442481,1600059,Failure,United Arab Emirates,DU UAE,Transguard Group LLC,API User,E6AEAE17361
2022-02-21 17:22,72867798,"21,921.1210","21,916.2210",05.00 AED,5.00,4.9000,0.1000,565442481,1600059,Failure,United Arab Emirates,DU UAE,Transguard Group LLC,API User,E6AEAE17361
2022-02-21 17:23,72867859,"21,926.0210","21,916.2210",10.00 AED,10.00,9.8000,0.2000,565442631,1600062,Success,United Arab Emirates,DU UAE,Transguard Group LLC,API User,E6AEAE22430
2022-02-21 17:28,72868130,"21,916.2210","21,911.3210",05.00 AED,5.00,4.9000,0.1000,565443380,1600072,Success,United Arab Emirates,DU UAE,Transguard Group LLC,API User,E6AEAE17361
2022-02-21 17:29,72868188,"21,911.3210","21,906.4210",05.00 AED,5.00,4.9000,0.1000,565443563,1600075,Success,United Arab Emirates,DU UAE,Transguard Group LLC,API User,E6AEAE17361
2022-02-21 17:33,72868365,"21,906.4210","21,903.3410",108.00 PKR,3.50,3.0800,0.4200,565444123,1600085,Success,Pakistan,Zong Pakistan,Transguard Group LLC,API User,ZNPKPK4829
2022-02-21 17:33,72868373,"21,903.3410","21,883.7410",20.00 AED,20.00,19.6000,0.4000,565444133,1600086,Success,United Arab Emirates,DU UAE,Transguard Group LLC,API User,E6AEAE12938
2022-02-21 17:37,72868599,"21,883.7410","21,844.5410",40.00 AED,40.00,39.2000,0.8000,565444768,1600091,Success,United Arab Emirates,DU UAE,Transguard Group LLC,API User,E6AEAE64011
2022-02-21 17:37,72868649,"21,844.5410","21,834.7410",10.00 AED,10.00,9.8000,0.2000,565444885,1600094,Success,United Arab Emirates,DU UAE,Transguard Group LLC,API User,E6AEAE22430
2022-02-21 17:37,72868667,"21,834.7410","21,829.8410",05.00 AED,5.00,4.9000,0.1000,565444922,1600096,Success,United Arab Emirates,DU UAE,Transguard Group LLC,API User,E6AEAE17361
2022-02-21 17:38,72868688,"21,829.8410","21,820.0410",10.00 AED,10.00,9.8000,0.2000,565444987,1600098,Success,United Arab Emirates,DU UAE,Transguard Group LLC,API User,E6AEAE22430
2022-02-21 17:41,72868872,"21,820.0410","21,810.2410",10.00 AED,10.00,9.8000,0.2000,565445506,1600102,Success,United Arab Emirates,DU UAE,Transguard Group LLC,API User,E6AEAE22430
2022-02-21 17:41,72868891,"21,810.2410","21,805.3410",05.00 AED,5.00,4.9000,0.1000,565445554,1600104,Success,United Arab Emirates,DU UAE,Transguard Group LLC,API User,E6AEAE17361
2022-02-21 17:44,72869059,"21,805.3410","21,800.4410",05.00 AED,5.00,4.9000,0.1000,565446063,1600112,Success,United Arab Emirates,DU UAE,Transguard Group LLC,API User,E6AEAE17361
2022-02-21 17:46,72869184,"21,800.4410","21,795.5410",05.00 AED,5.00,4.9000,0.1000,565446432,1600117,Success,United Arab Emirates,DU UAE,Transguard Group LLC,API User,E6AEAE17361
2022-02-21 17:58,72869911,"21,795.5410","21,785.7410",10.00 AED,10.00,9.8000,0.2000,565448524,1600138,Success,United Arab Emirates,DU UAE,Transguard Group LLC,API User,E6AEAE22430
2022-02-21 17:58,72869923,"21,785.7410","21,766.1410",20.00 AED,20.00,19.6000,0.4000,565448550,1600139,Success,United Arab Emirates,DU UAE,Transguard Group LLC,API User,E6AEAE12938
2022-02-21 18:05,72870389,"21,766.1410","21,761.2410",05.00 AED,5.00,4.9000,0.1000,565449810,1600148,Success,United Arab Emirates,DU UAE,Transguard Group LLC,API User,E6AEAE17361
2022-02-21 18:08,72870624,"21,761.2410","21,751.4410",10.00 AED,10.00,9.8000,0.2000,565450384,1600157,Failure,United Arab Emirates,DU UAE,Transguard Group LLC,API User,E6AEAE22430
2022-02-21 18:08,72870624,"21,751.4410","21,741.6410",10.00 AED,10.00,9.8000,0.2000,565450384,1600157,Failure,United Arab Emirates,DU UAE,Transguard Group LLC,API User,E6AEAE22430
2022-02-21 18:10,72870753,"21,761.2410","21,751.4410",10.00 AED,10.00,9.8000,0.2000,565450749,1600165,Success,United Arab Emirates,DU UAE,Transguard Group LLC,API User,E6AEAE22430
2022-02-21 18:11,72870822,"21,751.4410","21,746.5410",05.00 AED,5.00,4.9000,0.1000,565450943,1600172,Success,United Arab Emirates,DU UAE,Transguard Group LLC,API User,E6AEAE17361
2022-02-21 18:11,72870828,"21,746.5410","21,736.7410",10.00 AED,10.00,9.8000,0.2000,565450967,1600173,Success,United Arab Emirates,DU UAE,Transguard Group LLC,API User,E6AEAE22430
2022-02-21 18:12,72870856,"21,736.7410","21,731.8410",05.00 AED,5.00,4.9000,0.1000,565451083,1600178,Success,United Arab Emirates,DU UAE,Transguard Group LLC,API User,E6AEAE17361
2022-02-21 18:12,72870879,"21,731.8410","21,722.0410",10.00 AED,10.00,9.8000,0.2000,565451141,1600179,Success,United Arab Emirates,DU UAE,Transguard Group LLC,API User,E6AEAE22430
2022-02-21 18:13,72870968,"21,722.0410","21,712.2410",10.00 AED,10.00,9.8000,0.2000,565451369,1600182,Success,United Arab Emirates,DU UAE,Transguard Group LLC,API User,E6AEAE22430
2022-02-21 18:14,72871025,"21,712.2410","21,702.4410",10.00 AED,10.00,9.8000,0.2000,565451507,1600185,Success,United Arab Emirates,DU UAE,Transguard Group LLC,API User,E6AEAE22430
2022-02-21 18:15,72871063,"21,702.4410","21,697.5410",05.00 AED,5.00,4.9000,0.1000,565451638,1600188,Success,United Arab Emirates,DU UAE,Transguard Group LLC,API User,E6AEAE17361
2022-02-21 18:15,72871115,"21,697.5410","21,693.8010",151.00 PKR,4.25,3.7400,0.5100,565451786,1600191,Success,Pakistan,Telenor Pakistan,Transguard Group LLC,API User,TPPKPK94108
2022-02-21 18:20,72871391,"21,693.8010","21,688.9010",05.00 AED,5.00,4.9000,0.1000,565452548,1600199,Success,United Arab Emirates,DU UAE,Transguard Group LLC,API User,E6AEAE17361
2022-02-21 18:21,72871509,"21,688.9010","21,669.3010",20.00 AED,20.00,19.6000,0.4000,565452891,1600204,Success,United Arab Emirates,DU UAE,Transguard Group LLC,API User,E6AEAE12938
2022-02-21 18:29,72872014,"21,669.3010","21,659.5010",10.00 AED,10.00,9.8000,0.2000,565454415,1600222,Success,United Arab Emirates,DU UAE,Transguard Group LLC,API User,E6AEAE22430
2022-02-21 18:31,72872137,"21,659.5010","21,649.7010",10.00 AED,10.00,9.8000,0.2000,565454813,1600229,Success,United Arab Emirates,DU UAE,Transguard Group LLC,API User,E6AEAE22430
2022-02-21 18:34,72872316,"21,649.7010","21,644.8010",05.00 AED,5.00,4.9000,0.1000,565455383,1600235,Success,United Arab Emirates,DU UAE,Transguard Group LLC,API User,E6AEAE17361
2022-02-21 18:37,72872479,"21,644.8010","21,635.0010",10.00 AED,10.00,9.8000,0.2000,565455856,1600239,Success,United Arab Emirates,DU UAE,Transguard Group LLC,API User,E6AEAE22430
2022-02-21 18:38,72872565,"21,635.0010","21,630.1010",05.00 AED,5.00,4.9000,0.1000,565456103,1600243,Success,United Arab Emirates,DU UAE,Transguard Group LLC,API User,E6AEAE17361
2022-02-21 18:42,72872908,"21,630.1010","21,625.2010",05.00 AED,5.00,4.9000,0.1000,565456992,1600254,Success,United Arab Emirates,DU UAE,Transguard Group LLC,API User,E6AEAE17361
2022-02-21 18:43,72872940,"21,625.2010","21,615.4010",10.00 AED,10.00,9.8000,0.2000,565457068,1600257,Success,United Arab Emirates,DU UAE,Transguard Group LLC,API User,E6AEAE22430
2022-02-21 18:44,72873020,"21,615.4010","21,581.1010",35.00 AED,35.00,34.3000,0.7000,565457284,1600260,Success,United Arab Emirates,DU UAE,Transguard Group LLC,API User,E6AEAE73954
2022-02-21 18:45,72873080,"21,581.1010","21,576.2010",05.00 AED,5.00,4.9000,0.1000,565457453,1600265,Success,United Arab Emirates,DU UAE,Transguard Group LLC,API User,E6AEAE17361
2022-02-21 18:45,72873148,"21,576.2010","21,571.3010",05.00 AED,5.00,4.9000,0.1000,565457620,1600270,Success,United Arab Emirates,DU UAE,Transguard Group LLC,API User,E6AEAE17361
2022-02-21 18:47,72873288,"21,571.3010","21,561.5010",10.00 AED,10.00,9.8000,0.2000,565457962,1600276,Success,United Arab Emirates,DU UAE,Transguard Group LLC,API User,E6AEAE22430
2022-02-21 18:48,72873330,"21,561.5010","21,556.6010",05.00 AED,5.00,4.9000,0.1000,565458087,1600281,Success,United Arab Emirates,DU UAE,Transguard Group LLC,API User,E6AEAE17361
2022-02-21 18:48,72873337,"21,556.6010","21,552.8610",100.00 NPR,4.25,3.7400,0.5100,565458112,1600282,Success,Nepal,Ncell Nepal,Transguard Group LLC,API User,NP_NC_TopUp_100.00
2022-02-21 18:52,72873720,"21,552.8610","21,543.0610",10.00 AED,10.00,9.8000,0.2000,565459113,1600297,Success,United Arab Emirates,DU UAE,Transguard Group LLC,API User,E6AEAE22430
2022-02-21 18:54,72873853,"21,543.0610","21,538.1610",05.00 AED,5.00,4.9000,0.1000,565459420,1600306,Success,United Arab Emirates,DU UAE,Transguard Group LLC,API User,E6AEAE17361
2022-02-21 18:54,72873866,"21,538.1610","21,528.3610",10.00 AED,10.00,9.8000,0.2000,565459455,1600307,Success,United Arab Emirates,DU UAE,Transguard Group LLC,API User,E6AEAE22430
2022-02-21 18:56,72873974,"21,528.3610","21,518.5610",10.00 AED,10.00,9.8000,0.2000,565459781,1600312,Success,United Arab Emirates,DU UAE,Transguard Group LLC,API User,E6AEAE22430
2022-02-21 18:58,72874167,"21,518.5610","21,513.6610",05.00 AED,5.00,4.9000,0.1000,565460287,1600320,Success,United Arab Emirates,DU UAE,Transguard Group LLC,API User,E6AEAE17361
2022-02-21 19:00,72874325,"21,513.6610","21,508.7610",05.00 AED,5.00,4.9000,0.1000,565460720,1600333,Success,United Arab Emirates,DU UAE,Transguard Group LLC,API User,E6AEAE17361
2022-02-21 19:01,72874383,"21,508.7610","21,503.8610",05.00 AED,5.00,4.9000,0.1000,565460881,1600335,Success,United Arab Emirates,DU UAE,Transguard Group LLC,API User,E6AEAE17361
2022-02-21 19:08,72875038,"21,503.8610","21,498.9610",05.00 AED,5.00,4.9000,0.1000,565462495,1600350,Success,United Arab Emirates,DU UAE,Transguard Group LLC,API User,E6AEAE17361
2022-02-21 19:11,72875293,"21,498.9610","21,494.0610",05.00 AED,5.00,4.9000,0.1000,565463174,1600359,Success,United Arab Emirates,DU UAE,Transguard Group LLC,API User,E6AEAE17361
2022-02-21 19:11,72875315,"21,494.0610","21,484.2610",10.00 AED,10.00,9.8000,0.2000,565463233,1600361,Success,United Arab Emirates,DU UAE,Transguard Group LLC,API User,E6AEAE22430
2022-02-21 19:13,72875464,"21,484.2610","21,474.4610",10.00 AED,10.00,9.8000,0.2000,565463651,1600367,Success,United Arab Emirates,DU UAE,Transguard Group LLC,API User,E6AEAE22430
2022-02-21 19:14,72875507,"21,474.4610","21,469.5610",05.00 AED,5.00,4.9000,0.1000,565463750,1600369,Success,United Arab Emirates,DU UAE,Transguard Group LLC,API User,E6AEAE17361
2022-02-21 19:15,72875571,"21,469.5610","21,459.7610",10.00 AED,10.00,9.8000,0.2000,565463993,1600373,Success,United Arab Emirates,DU UAE,Transguard Group LLC,API User,E6AEAE22430
2022-02-21 19:18,72875831,"21,459.7610","21,449.9610",10.00 AED,10.00,9.8000,0.2000,565464625,1600386,Success,United Arab Emirates,DU UAE,Transguard Group LLC,API User,E6AEAE22430
2022-02-21 19:18,72875839,"21,449.9610","21,445.0610",05.00 AED,5.00,4.9000,0.1000,565464650,1600387,Success,United Arab Emirates,DU UAE,Transguard Group LLC,API User,E6AEAE17361
2022-02-21 19:20,72876001,"21,445.0610","21,435.2610",10.00 AED,10.00,9.8000,0.2000,565465046,1600392,Success,United Arab Emirates,DU UAE,Transguard Group LLC,API User,E6AEAE22430
2022-02-21 19:23,72876258,"21,435.2610","21,431.0810",150.00 PKR,4.75,4.1800,0.5700,565465810,1600399,Success,Pakistan,Jazz Pakistan,Transguard Group LLC,API User,MBPKPK20699
2022-02-21 19:24,72876270,"21,431.0810","21,426.1810",05.00 AED,5.00,4.9000,0.1000,565465829,1600400,Success,United Arab Emirates,DU UAE,Transguard Group LLC,API User,E6AEAE17361
2022-02-21 19:24,72876282,"21,426.1810","21,421.2810",05.00 AED,5.00,4.9000,0.1000,565465854,1600401,Success,United Arab Emirates,DU UAE,Transguard Group LLC,API User,E6AEAE17361
2022-02-21 19:25,72876370,"21,421.2810","21,411.4810",10.00 AED,10.00,9.8000,0.2000,565466094,1600408,Success,United Arab Emirates,DU UAE,Transguard Group LLC,API User,E6AEAE22430
2022-02-21 19:28,72876628,"21,411.4810","21,406.5810",05.00 AED,5.00,4.9000,0.1000,565466750,1600417,Success,United Arab Emirates,DU UAE,Transguard Group LLC,API User,E6AEAE17361
2022-02-21 19:36,72877312,"21,406.5810","21,402.8410",100.00 NPR,4.25,3.7400,0.5100,565468497,1600433,Success,Nepal,Ncell Nepal,Transguard Group LLC,API User,NP_NC_TopUp_100.00
2022-02-21 19:36,72877332,"21,402.8410","21,399.1010",98.00 NPR,4.25,3.7400,0.5100,565468540,1600435,Success,Nepal,Ncell Nepal,Transguard Group LLC,API User,NCNPNP3715
2022-02-21 19:40,72877622,"21,399.1010","21,394.2010",05.00 AED,5.00,4.9000,0.1000,565469313,1600451,Success,United Arab Emirates,DU UAE,Transguard Group LLC,API User,E6AEAE17361
2022-02-21 19:40,72877647,"21,394.2010","21,389.3010",05.00 AED,5.00,4.9000,0.1000,565469391,1600454,Success,United Arab Emirates,DU UAE,Transguard Group LLC,API User,E6AEAE17361
2022-02-21 19:41,72877726,"21,389.3010","21,384.4010",05.00 AED,5.00,4.9000,0.1000,565469647,1600457,Success,United Arab Emirates,DU UAE,Transguard Group LLC,API User,E6AEAE17361
2022-02-21 19:49,72878301,"21,384.4010","21,379.5010",05.00 AED,5.00,4.9000,0.1000,565471253,1600477,Success,United Arab Emirates,DU UAE,Transguard Group LLC,API User,E6AEAE17361
2022-02-21 19:49,72878309,"21,379.5010","21,374.6010",05.00 AED,5.00,4.9000,0.1000,565471297,1600479,Success,United Arab Emirates,DU UAE,Transguard Group LLC,API User,E6AEAE17361
2022-02-21 19:49,72878331,"21,374.6010","21,366.0210",315.00 PKR,9.75,8.5800,1.1700,565471386,1600485,Success,Pakistan,Zong Pakistan,Transguard Group LLC,API User,ZNPKPK29953
2022-02-21 19:52,72878588,"21,366.0210","21,336.6210",30.00 AED,30.00,29.4000,0.6000,565472108,1600497,Success,United Arab Emirates,DU UAE,Transguard Group LLC,API User,E6AEAE46146
2022-02-21 19:54,72878725,"21,336.6210","21,331.7210",05.00 AED,5.00,4.9000,0.1000,565472465,1600501,Success,United Arab Emirates,DU UAE,Transguard Group LLC,API User,E6AEAE17361
2022-02-21 19:56,72878902,"21,331.7210","21,326.8210",05.00 AED,5.00,4.9000,0.1000,565472962,1600504,Success,United Arab Emirates,DU UAE,Transguard Group LLC,API User,E6AEAE17361
2022-02-21 19:58,72879025,"21,326.8210","21,321.9210",05.00 AED,5.00,4.9000,0.1000,565473284,1600510,Success,United Arab Emirates,DU UAE,Transguard Group LLC,API User,E6AEAE17361
2022-02-21 19:59,72879091,"21,321.9210","21,302.3210",20.00 AED,20.00,19.6000,0.4000,565473460,1600513,Success,United Arab Emirates,DU UAE,Transguard Group LLC,API User,E6AEAE12938
2022-02-21 20:00,72879180,"21,302.3210","21,297.4210",05.00 AED,5.00,4.9000,0.1000,565473732,1600517,Success,United Arab Emirates,DU UAE,Transguard Group LLC,API User,E6AEAE17361
2022-02-21 20:00,72879201,"21,297.4210","21,292.5210",05.00 AED,5.00,4.9000,0.1000,565473809,1600519,Success,United Arab Emirates,DU UAE,Transguard Group LLC,API User,E6AEAE17361
2022-02-21 20:03,72879397,"21,292.5210","21,282.7210",10.00 AED,10.00,9.8000,0.2000,565474345,1600531,Success,United Arab Emirates,DU UAE,Transguard Group LLC,API User,E6AEAE22430
2022-02-21 20:04,72879502,"21,282.7210","21,277.8210",05.00 AED,5.00,4.9000,0.1000,565474620,1600535,Success,United Arab Emirates,DU UAE,Transguard Group LLC,API User,E6AEAE17361
2022-02-21 20:10,72880019,"21,277.8210","21,272.9210",05.00 AED,5.00,4.9000,0.1000,565475971,1600553,Success,United Arab Emirates,DU UAE,Transguard Group LLC,API User,E6AEAE17361
2022-02-21 20:10,72880035,"21,272.9210","21,268.0210",05.00 AED,5.00,4.9000,0.1000,565476012,1600554,Success,United Arab Emirates,DU UAE,Transguard Group LLC,API User,E6AEAE17361
2022-02-21 20:10,72880118,"21,268.0210","21,263.1210",05.00 AED,5.00,4.9000,0.1000,565476215,1600559,Success,United Arab Emirates,DU UAE,Transguard Group LLC,API User,E6AEAE17361
2022-02-21 20:12,72880232,"21,263.1210","21,259.3810",100.00 NPR,4.25,3.7400,0.5100,565476567,1600565,Success,Nepal,Ncell Nepal,Transguard Group LLC,API User,NP_NC_TopUp_100.00
2022-02-21 20:13,72880303,"21,259.3810","21,251.4610",220.00 NPR,9.00,7.9200,1.0800,565476754,1600569,Success,Nepal,Ncell Nepal,Transguard Group LLC,API User,NCNPNP79518
2022-02-21 20:17,72880600,"21,251.4610","21,246.5610",05.00 AED,5.00,4.9000,0.1000,565477561,1600577,Success,United Arab Emirates,DU UAE,Transguard Group LLC,API User,E6AEAE17361
2022-02-21 20:18,72880691,"21,246.5610","21,236.7610",10.00 AED,10.00,9.8000,0.2000,565477781,1600580,Success,United Arab Emirates,DU UAE,Transguard Group LLC,API User,E6AEAE22430
2022-02-21 20:20,72880846,"21,236.7610","21,231.8610",05.00 AED,5.00,4.9000,0.1000,565478205,1600583,Success,United Arab Emirates,DU UAE,Transguard Group LLC,API User,E6AEAE17361
2022-02-21 20:28,72881565,"21,231.8610","21,226.9610",05.00 AED,5.00,4.9000,0.1000,565480167,1600596,Success,United Arab Emirates,DU UAE,Transguard Group LLC,API User,E6AEAE17361
2022-02-21 20:28,72881571,"21,226.9610","21,207.3610",20.00 AED,20.00,19.6000,0.4000,565480173,1600597,Success,United Arab Emirates,DU UAE,Transguard Group LLC,API User,E6AEAE12938
2022-02-21 20:29,72881600,"21,207.3610","21,197.5610",10.00 AED,10.00,9.8000,0.2000,565480248,1600602,Success,United Arab Emirates,DU UAE,Transguard Group LLC,API User,E6AEAE22430
2022-02-21 20:29,72881622,"21,197.5610","21,192.6610",05.00 AED,5.00,4.9000,0.1000,565480280,1600605,Success,United Arab Emirates,DU UAE,Transguard Group LLC,API User,E6AEAE17361
2022-02-21 20:30,72881718,"21,192.6610","21,182.8610",10.00 AED,10.00,9.8000,0.2000,565480566,1600616,Success,United Arab Emirates,DU UAE,Transguard Group LLC,API User,E6AEAE22430
2022-02-21 20:30,72881731,"21,182.8610","21,143.6610",40.00 AED,40.00,39.2000,0.8000,565480604,1600617,Success,United Arab Emirates,DU UAE,Transguard Group LLC,API User,E6AEAE64011
2022-02-21 20:31,72881782,"21,143.6610","21,133.8610",10.00 AED,10.00,9.8000,0.2000,565480738,1600620,Success,United Arab Emirates,DU UAE,Transguard Group LLC,API User,E6AEAE22430
2022-02-21 20:32,72881852,"21,133.8610","21,124.0610",10.00 AED,10.00,9.8000,0.2000,565480949,1600623,Success,United Arab Emirates,DU UAE,Transguard Group LLC,API User,E6AEAE22430
2022-02-21 20:34,72882096,"21,124.0610","21,114.2610",10.00 AED,10.00,9.8000,0.2000,565481593,1600628,Success,United Arab Emirates,DU UAE,Transguard Group LLC,API User,E6AEAE22430
2022-02-21 20:40,72882580,"21,114.2610","21,104.4610",10.00 AED,10.00,9.8000,0.2000,565482916,1600644,Success,United Arab Emirates,DU UAE,Transguard Group LLC,API User,E6AEAE22430
2022-02-21 20:41,72882688,"21,104.4610","21,099.5610",05.00 AED,5.00,4.9000,0.1000,565483177,1600649,Success,United Arab Emirates,DU UAE,Transguard Group LLC,API User,E6AEAE17361
2022-02-21 20:43,72882847,"21,099.5610","21,094.6610",05.00 AED,5.00,4.9000,0.1000,565483621,1600658,Success,United Arab Emirates,DU UAE,Transguard Group LLC,API User,E6AEAE17361
2022-02-21 20:45,72882990,"21,094.6610","21,085.8610",13.20 GHS,10.00,8.8000,1.2000,565484007,1600662,Success,Ghana,MTN Ghana,Transguard Group LLC,API User,GH_MT_TopUp
2022-02-21 20:45,72883009,"21,085.8610","21,080.9610",05.00 AED,5.00,4.9000,0.1000,565484079,1600665,Success,United Arab Emirates,DU UAE,Transguard Group LLC,API User,E6AEAE17361
2022-02-21 20:47,72883173,"21,080.9610","21,073.7010",200.00 NPR,8.25,7.2600,0.9900,565484533,1600670,Success,Nepal,Nepal Telecom Nepal,Transguard Group LLC,API User,NP_NE_TopUp_200.00
2022-02-21 20:48,72883240,"21,073.7010","21,065.3410",300.00 PKR,9.50,8.3600,1.1400,565484743,1600676,Success,Pakistan,Jazz Pakistan,Transguard Group LLC,API User,PK_MB_TopUp_300.00
2022-02-21 20:50,72883362,"21,065.3410","21,060.4410",05.00 AED,5.00,4.9000,0.1000,565485079,1600681,Success,United Arab Emirates,DU UAE,Transguard Group LLC,API User,E6AEAE17361
2022-02-21 20:53,72883553,"21,060.4410","21,031.0410",30.00 AED,30.00,29.4000,0.6000,565485642,1600686,Success,United Arab Emirates,DU UAE,Transguard Group LLC,API User,E6AEAE46146
2022-02-21 20:56,72883781,"21,031.0410","21,026.1410",05.00 AED,5.00,4.9000,0.1000,565486284,1600695,Success,United Arab Emirates,DU UAE,Transguard Group LLC,API User,E6AEAE17361
2022-02-21 20:57,72883919,"21,026.1410","21,016.3410",10.00 AED,10.00,9.8000,0.2000,565486628,1600700,Success,United Arab Emirates,DU UAE,Transguard Group LLC,API User,E6AEAE22430
2022-02-21 20:59,72884042,"21,016.3410","21,011.4410",05.00 AED,5.00,4.9000,0.1000,565486959,1600706,Success,United Arab Emirates,DU UAE,Transguard Group LLC,API User,E6AEAE17361
2022-02-21 20:59,72884068,"21,011.4410","21,001.6410",10.00 AED,10.00,9.8000,0.2000,565487025,1600709,Success,United Arab Emirates,DU UAE,Transguard Group LLC,API User,E6AEAE22430
2022-02-21 21:04,72884411,"21,001.6410","20,996.7410",05.00 AED,5.00,4.9000,0.1000,565487985,1600721,Success,United Arab Emirates,DU UAE,Transguard Group LLC,API User,E6AEAE17361
2022-02-21 21:07,72884584,"20,996.7410","20,991.8410",05.00 AED,5.00,4.9000,0.1000,565488514,1600727,Success,United Arab Emirates,DU UAE,Transguard Group LLC,API User,E6AEAE17361
2022-02-21 21:08,72884690,"20,991.8410","20,982.0410",10.00 AED,10.00,9.8000,0.2000,565488792,1600730,Success,United Arab Emirates,DU UAE,Transguard Group LLC,API User,E6AEAE22430
2022-02-21 21:09,72884767,"20,982.0410","20,977.1410",05.00 AED,5.00,4.9000,0.1000,565489041,1600736,Success,United Arab Emirates,DU UAE,Transguard Group LLC,API User,E6AEAE17361
2022-02-21 21:10,72884787,"20,977.1410","20,967.3410",10.00 AED,10.00,9.8000,0.2000,565489086,1600738,Success,United Arab Emirates,DU UAE,Transguard Group LLC,API User,E6AEAE22430
2022-02-21 21:14,72885093,"20,967.3410","20,962.4410",05.00 AED,5.00,4.9000,0.1000,565489971,1600748,Success,United Arab Emirates,DU UAE,Transguard Group LLC,API User,E6AEAE17361
2022-02-21 21:18,72885320,"20,962.4410","20,957.5410",05.00 AED,5.00,4.9000,0.1000,565490661,1600754,Success,United Arab Emirates,DU UAE,Transguard Group LLC,API User,E6AEAE17361
2022-02-21 21:19,72885388,"20,957.5410","20,952.6410",05.00 AED,5.00,4.9000,0.1000,565490867,1600757,Success,United Arab Emirates,DU UAE,Transguard Group LLC,API User,E6AEAE17361
2022-02-21 21:21,72885575,"20,952.6410","20,942.8410",10.00 AED,10.00,9.8000,0.2000,565491447,1600762,Success,United Arab Emirates,DU UAE,Transguard Group LLC,API User,E6AEAE22430
2022-02-21 21:23,72885670,"20,942.8410","20,936.9010",220.00 PKR,6.75,5.9400,0.8100,565491701,1600766,Success,Pakistan,Telenor Pakistan,Transguard Group LLC,API User,TPPKPK2735
2022-02-21 21:23,72885702,"20,936.9010","20,927.1010",10.00 AED,10.00,9.8000,0.2000,565491783,1600770,Success,United Arab Emirates,DU UAE,Transguard Group LLC,API User,E6AEAE22430
2022-02-21 21:24,72885759,"20,927.1010","20,922.2010",05.00 AED,5.00,4.9000,0.1000,565491951,1600773,Success,United Arab Emirates,DU UAE,Transguard Group LLC,API User,E6AEAE17361
2022-02-21 21:26,72885921,"20,922.2010","20,912.4010",10.00 AED,10.00,9.8000,0.2000,565492473,1600781,Success,United Arab Emirates,DU UAE,Transguard Group LLC,API User,E6AEAE22430
2022-02-21 21:30,72886221,"20,912.4010","20,907.5010",05.00 AED,5.00,4.9000,0.1000,565493270,1600785,Success,United Arab Emirates,DU UAE,Transguard Group LLC,API User,E6AEAE17361
2022-02-21 21:34,72886466,"20,907.5010","20,901.7810",98.00 INR,6.50,5.7200,0.7800,565493946,1600794,Success,India,BSNL India,Transguard Group LLC,API User,BLININ38870
2022-02-21 21:35,72886552,"20,901.7810","20,891.9810",10.00 AED,10.00,9.8000,0.2000,565494230,1600799,Success,United Arab Emirates,DU UAE,Transguard Group LLC,API User,E6AEAE22430
2022-02-21 21:38,72886749,"20,891.9810","20,882.1810",10.00 AED,10.00,9.8000,0.2000,565494786,1600806,Success,United Arab Emirates,DU UAE,Transguard Group LLC,API User,E6AEAE22430
2022-02-21 21:39,72886858,"20,882.1810","20,877.2810",05.00 AED,5.00,4.9000,0.1000,565495076,1600812,Success,United Arab Emirates,DU UAE,Transguard Group LLC,API User,E6AEAE17361
2022-02-21 21:44,72887190,"20,877.2810","20,872.3810",05.00 AED,5.00,4.9000,0.1000,565496047,1600822,Success,United Arab Emirates,DU UAE,Transguard Group LLC,API User,E6AEAE17361
2022-02-21 21:48,72887436,"20,872.3810","20,867.4810",05.00 AED,5.00,4.9000,0.1000,565496750,1600827,Success,United Arab Emirates,DU UAE,Transguard Group LLC,API User,E6AEAE17361
2022-02-21 21:49,72887461,"20,867.4810","20,862.5810",05.00 AED,5.00,4.9000,0.1000,565496839,1600829,Success,United Arab Emirates,DU UAE,Transguard Group LLC,API User,E6AEAE17361
2022-02-21 21:51,72887638,"20,862.5810","20,858.1810",222.40 LKR,5.00,4.4000,0.6000,565497315,1600841,Success,Sri Lanka,Dialog Sri Lanka,Transguard Group LLC,API User,LK_DG_TopUp
2022-02-21 21:54,72887818,"20,858.1810","20,845.6410",460.00 PKR,14.25,12.5400,1.7100,565497824,1600845,Success,Pakistan,Zong Pakistan,Transguard Group LLC,API User,ZNPKPK8741
2022-02-21 21:55,72887896,"20,845.6410","20,840.7410",05.00 AED,5.00,4.9000,0.1000,565498074,1600850,Success,United Arab Emirates,DU UAE,Transguard Group LLC,API User,E6AEAE17361
2022-02-21 21:58,72888084,"20,840.7410","20,830.9410",10.00 AED,10.00,9.8000,0.2000,565498610,1600855,Success,United Arab Emirates,DU UAE,Transguard Group LLC,API User,E6AEAE22430
2022-02-21 22:00,72888229,"20,830.9410","20,826.0410",05.00 AED,5.00,4.9000,0.1000,565499064,1600860,Success,United Arab Emirates,DU UAE,Transguard Group LLC,API User,E6AEAE17361
2022-02-21 22:11,72888853,"20,826.0410","20,817.6810",300.00 PKR,9.50,8.3600,1.1400,565500997,1600867,Success,Pakistan,Jazz Pakistan,Transguard Group LLC,API User,PK_MB_TopUp_300.00
2022-02-21 22:16,72889172,"20,817.6810","20,807.8810",10.00 AED,10.00,9.8000,0.2000,565501955,1600872,Success,United Arab Emirates,DU UAE,Transguard Group LLC,API User,E6AEAE22430
2022-02-21 22:21,72889457,"20,807.8810","20,802.9810",05.00 AED,5.00,4.9000,0.1000,565502834,1600883,Success,United Arab Emirates,DU UAE,Transguard Group LLC,API User,E6AEAE17361
2022-02-21 22:23,72889587,"20,802.9810","20,798.0810",05.00 AED,5.00,4.9000,0.1000,565503194,1600886,Success,United Arab Emirates,DU UAE,Transguard Group LLC,API User,E6AEAE17361
2022-02-21 22:24,72889647,"20,798.0810","20,793.1810",05.00 AED,5.00,4.9000,0.1000,565503391,1600890,Success,United Arab Emirates,DU UAE,Transguard Group LLC,API User,E6AEAE17361
2022-02-21 22:24,72889660,"20,793.1810","20,788.2810",05.00 AED,5.00,4.9000,0.1000,565503433,1600892,Success,United Arab Emirates,DU UAE,Transguard Group LLC,API User,E6AEAE17361
2022-02-21 22:32,72890064,"20,788.2810","20,778.4810",10.00 AED,10.00,9.8000,0.2000,565504780,1600907,Success,United Arab Emirates,DU UAE,Transguard Group LLC,API User,E6AEAE22430
2022-02-21 22:34,72890176,"20,778.4810","20,768.6810",10.00 AED,10.00,9.8000,0.2000,565505169,1600912,Success,United Arab Emirates,DU UAE,Transguard Group LLC,API User,E6AEAE22430
2022-02-21 22:35,72890210,"20,768.6810","20,758.8810",10.00 AED,10.00,9.8000,0.2000,565505298,1600915,Success,United Arab Emirates,DU UAE,Transguard Group LLC,API User,E6AEAE22430
2022-02-21 22:36,72890261,"20,758.8810","20,753.9810",05.00 AED,5.00,4.9000,0.1000,565505444,1600918,Success,United Arab Emirates,DU UAE,Transguard Group LLC,API User,E6AEAE17361
2022-02-21 22:43,72890602,"20,753.9810","20,744.1810",10.00 AED,10.00,9.8000,0.2000,565506584,1600930,Success,United Arab Emirates,DU UAE,Transguard Group LLC,API User,E6AEAE22430
2022-02-21 22:44,72890646,"20,744.1810","20,739.2810",05.00 AED,5.00,4.9000,0.1000,565506746,1600935,Success,United Arab Emirates,DU UAE,Transguard Group LLC,API User,E6AEAE17361
2022-02-21 22:49,72890901,"20,739.2810","20,724.5810",15.00 AED,15.00,14.7000,0.3000,565507573,1600946,Success,United Arab Emirates,DU UAE,Transguard Group LLC,API User,E6AEAE8527
2022-02-21 22:55,72891194,"20,724.5810","20,704.9810",20.00 AED,20.00,19.6000,0.4000,565508522,1600952,Success,United Arab Emirates,DU UAE,Transguard Group LLC,API User,E6AEAE12938
2022-02-21 22:56,72891245,"20,704.9810","20,692.0010",150.00 PHP,14.75,12.9800,1.7700,565508722,1600957,Success,Philippines,Touch Mobile Philippines,Transguard Group LLC,API User,PH_TM_TopUp_150.00
2022-02-21 23:01,72891466,"20,692.0010","20,682.2010",10.00 AED,10.00,9.8000,0.2000,565509490,1600960,Success,United Arab Emirates,DU UAE,Transguard Group LLC,API User,E6AEAE22430
2022-02-21 23:01,72891488,"20,682.2010","20,677.3010",05.00 AED,5.00,4.9000,0.1000,565509568,1600963,Success,United Arab Emirates,DU UAE,Transguard Group LLC,API User,E6AEAE17361
2022-02-21 23:02,72891533,"20,677.3010","20,672.4010",05.00 AED,5.00,4.9000,0.1000,565509703,1600966,Success,United Arab Emirates,DU UAE,Transguard Group LLC,API User,E6AEAE17361
2022-02-21 23:03,72891609,"20,672.4010","20,663.6010",315.00 PKR,10.00,8.8000,1.2000,565509938,1600969,Success,Pakistan,Telenor Pakistan,Transguard Group LLC,API User,TPPKPK75105
2022-02-21 23:04,72891639,"20,663.6010","20,658.7010",05.00 AED,5.00,4.9000,0.1000,565510077,1600975,Success,United Arab Emirates,DU UAE,Transguard Group LLC,API User,E6AEAE17361
2022-02-21 23:11,72891934,"20,658.7010","20,648.9010",10.00 AED,10.00,9.8000,0.2000,565511243,1600978,Success,United Arab Emirates,DU UAE,Transguard Group LLC,API User,E6AEAE22430
2022-02-21 23:21,72892372,"20,648.9010","20,644.0010",05.00 AED,5.00,4.9000,0.1000,565512819,1600984,Success,United Arab Emirates,DU UAE,Transguard Group LLC,API User,E6AEAE17361
2022-02-21 23:22,72892406,"20,644.0010","20,639.1010",05.00 AED,5.00,4.9000,0.1000,565512918,1600987,Success,United Arab Emirates,DU UAE,Transguard Group LLC,API User,E6AEAE17361
2022-02-21 23:47,72893422,"20,639.1010","20,629.3010",10.00 AED,10.00,9.8000,0.2000,565516279,1601000,Success,United Arab Emirates,DU UAE,Transguard Group LLC,API User,E6AEAE22430
2022-02-21 23:53,72893649,"20,629.3010","20,619.5010",10.00 AED,10.00,9.8000,0.2000,565517093,1601003,Success,United Arab Emirates,DU UAE,Transguard Group LLC,API User,E6AEAE22430
2022-02-21 23:55,72893713,"20,619.5010","20,609.7010",10.00 AED,10.00,9.8000,0.2000,565517347,1601006,Success,United Arab Emirates,DU UAE,Transguard Group LLC,API User,E6AEAE22430
2022-02-21 23:57,72893781,"20,609.7010","20,605.5210",50.00 PHP,4.75,4.1800,0.5700,565517634,1601010,Success,Philippines,Smart (SunCellular) Philippines,Transguard Group LLC,API User,PH_SM_TopUp_50.00
2022-02-22 00:01,72893914,"20,605.5210","20,600.6210",05.00 AED,5.00,4.9000,0.1000,565518090,1601017,Success,United Arab Emirates,DU UAE,Transguard Group LLC,API User,E6AEAE17361
2022-02-22 00:01,72893916,"20,600.6210","20,595.7210",05.00 AED,5.00,4.9000,0.1000,565518183,1601019,Success,United Arab Emirates,DU UAE,Transguard Group LLC,API User,E6AEAE17361
2022-02-22 00:32,72894950,"20,595.7210","20,576.1210",20.00 AED,20.00,19.6000,0.4000,565521932,1601026,Success,United Arab Emirates,DU UAE,Transguard Group LLC,API User,E6AEAE12938
2022-02-22 00:37,72895094,"20,576.1210","20,571.2210",05.00 AED,5.00,4.9000,0.1000,565522480,1601029,Success,United Arab Emirates,DU UAE,Transguard Group LLC,API User,E6AEAE17361
2022-02-22 00:45,72895373,"20,571.2210","20,562.4210",13.20 GHS,10.00,8.8000,1.2000,565523448,1601033,Success,Ghana,MTN Ghana,Transguard Group LLC,API User,GH_MT_TopUp
2022-02-22 00:49,72895510,"20,562.4210","20,552.6210",10.00 AED,10.00,9.8000,0.2000,565523947,1601037,Success,United Arab Emirates,DU UAE,Transguard Group LLC,API User,E6AEAE22430
2022-02-22 00:50,72895525,"20,552.6210","20,547.7210",05.00 AED,5.00,4.9000,0.1000,565524022,1601040,Success,United Arab Emirates,DU UAE,Transguard Group LLC,API User,E6AEAE17361
2022-02-22 00:50,72895545,"20,547.7210","20,540.4610",200.00 NPR,8.25,7.2600,0.9900,565524119,1601043,Success,Nepal,Nepal Telecom Nepal,Transguard Group LLC,API User,NP_NE_TopUp_200.00
2022-02-22 00:55,72895701,"20,540.4610","20,530.6610",10.00 AED,10.00,9.8000,0.2000,565524724,1601046,Success,United Arab Emirates,DU UAE,Transguard Group LLC,API User,E6AEAE22430
2022-02-22 01:05,72895964,"20,530.6610","20,525.7610",05.00 AED,5.00,4.9000,0.1000,565525787,1601051,Success,United Arab Emirates,DU UAE,Transguard Group LLC,API User,E6AEAE17361
2022-02-22 01:05,72895978,"20,525.7610","20,520.8610",05.00 AED,5.00,4.9000,0.1000,565525848,1601054,Success,United Arab Emirates,DU UAE,Transguard Group LLC,API User,E6AEAE17361
2022-02-22 02:10,72897910,"20,520.8610","20,501.2610",20.00 AED,20.00,19.6000,0.4000,565533227,1601062,Success,United Arab Emirates,DU UAE,Transguard Group LLC,API User,E6AEAE12938
2022-02-22 02:10,72897919,"20,501.2610","20,481.6610",20.00 AED,20.00,19.6000,0.4000,565533307,1601063,Success,United Arab Emirates,DU UAE,Transguard Group LLC,API User,E6AEAE12938
2022-02-22 02:20,72898223,"20,481.6610","20,476.7610",05.00 AED,5.00,4.9000,0.1000,565534422,1601070,Success,United Arab Emirates,DU UAE,Transguard Group LLC,API User,E6AEAE17361
2022-02-22 02:35,72898772,"20,476.7610","20,466.9610",10.00 AED,10.00,9.8000,0.2000,565536234,1601076,Success,United Arab Emirates,DU UAE,Transguard Group LLC,API User,E6AEAE22430
2022-02-22 02:35,72898782,"20,466.9610","20,462.0610",05.00 AED,5.00,4.9000,0.1000,565536277,1601078,Success,United Arab Emirates,DU UAE,Transguard Group LLC,API User,E6AEAE17361
2022-02-22 02:43,72899009,"20,462.0610","20,457.1610",05.00 AED,5.00,4.9000,0.1000,565537157,1601081,Success,United Arab Emirates,DU UAE,Transguard Group LLC,API User,E6AEAE17361
2022-02-22 02:44,72899068,"20,457.1610","20,452.2610",05.00 AED,5.00,4.9000,0.1000,565537347,1601085,Success,United Arab Emirates,DU UAE,Transguard Group LLC,API User,E6AEAE17361
2022-02-22 02:45,72899107,"20,452.2610","20,447.3610",05.00 AED,5.00,4.9000,0.1000,565537494,1601089,Success,United Arab Emirates,DU UAE,Transguard Group LLC,API User,E6AEAE17361
2022-02-22 02:46,72899127,"20,447.3610","20,442.4610",05.00 AED,5.00,4.9000,0.1000,565537563,1601091,Success,United Arab Emirates,DU UAE,Transguard Group LLC,API User,E6AEAE17361
2022-02-22 02:53,72899324,"20,442.4610","20,437.5610",05.00 AED,5.00,4.9000,0.1000,565538348,1601094,Success,United Arab Emirates,DU UAE,Transguard Group LLC,API User,E6AEAE17361
2022-02-22 03:02,72899603,"20,437.5610","20,417.9610",20.00 AED,20.00,19.6000,0.4000,565539450,1601101,Success,United Arab Emirates,DU UAE,Transguard Group LLC,API User,E6AEAE12938
2022-02-22 03:45,72900910,"20,417.9610","20,414.2210",98.00 NPR,4.25,3.7400,0.5100,565544556,1601110,Success,Nepal,Ncell Nepal,Transguard Group LLC,API User,NCNPNP3715
2022-02-22 03:52,72901086,"20,414.2210","20,404.4210",10.00 AED,10.00,9.8000,0.2000,565545274,1601115,Success,United Arab Emirates,DU UAE,Transguard Group LLC,API User,E6AEAE22430
2022-02-22 03:53,72901116,"20,404.4210","20,399.5210",05.00 AED,5.00,4.9000,0.1000,565545393,1601118,Success,United Arab Emirates,DU UAE,Transguard Group LLC,API User,E6AEAE17361
2022-02-22 03:55,72901163,"20,399.5210","20,379.9210",20.00 AED,20.00,19.6000,0.4000,565545598,1601121,Success,United Arab Emirates,DU UAE,Transguard Group LLC,API User,E6AEAE12938
2022-02-22 03:56,72901190,"20,379.9210","20,360.3210",20.00 AED,20.00,19.6000,0.4000,565545734,1601124,Success,United Arab Emirates,DU UAE,Transguard Group LLC,API User,E6AEAE12938
2022-02-22 03:59,72901255,"20,360.3210","20,355.4210",05.00 AED,5.00,4.9000,0.1000,565546056,1601127,Success,United Arab Emirates,DU UAE,Transguard Group LLC,API User,E6AEAE17361
2022-02-22 04:36,72902306,"20,355.4210","20,345.6210",10.00 AED,10.00,9.8000,0.2000,565550267,1601149,Success,United Arab Emirates,DU UAE,Transguard Group LLC,API User,E6AEAE22430
2022-02-22 04:51,72902722,"20,345.6210","20,340.7210",05.00 AED,5.00,4.9000,0.1000,565551774,1601158,Success,United Arab Emirates,DU UAE,Transguard Group LLC,API User,E6AEAE17361
2022-02-22 04:54,72902782,"20,340.7210","20,330.9210",10.00 AED,10.00,9.8000,0.2000,565551982,1601166,Success,United Arab Emirates,DU UAE,Transguard Group LLC,API User,E6AEAE22430
2022-02-22 04:55,72902820,"20,330.9210","20,326.0210",05.00 AED,5.00,4.9000,0.1000,565552140,1601171,Success,United Arab Emirates,DU UAE,Transguard Group LLC,API User,E6AEAE17361
2022-02-22 05:03,72903036,"20,326.0210","20,321.1210",05.00 AED,5.00,4.9000,0.1000,565552889,1601180,Success,United Arab Emirates,DU UAE,Transguard Group LLC,API User,E6AEAE17361
2022-02-22 05:14,72903336,"20,321.1210","20,311.3210",10.00 AED,10.00,9.8000,0.2000,565553973,1601194,Success,United Arab Emirates,DU UAE,Transguard Group LLC,API User,E6AEAE22430
2022-02-22 05:21,72903515,"20,311.3210","20,301.5210",10.00 AED,10.00,9.8000,0.2000,565554627,1601207,Success,United Arab Emirates,DU UAE,Transguard Group LLC,API User,E6AEAE22430
2022-02-22 05:22,72903548,"20,301.5210","20,291.7210",10.00 AED,10.00,9.8000,0.2000,565554714,1601210,Success,United Arab Emirates,DU UAE,Transguard Group LLC,API User,E6AEAE22430
2022-02-22 05:29,72903764,"20,291.7210","20,286.8210",05.00 AED,5.00,4.9000,0.1000,565555440,1601217,Success,United Arab Emirates,DU UAE,Transguard Group LLC,API User,E6AEAE17361
2022-02-22 05:44,72904181,"20,286.8210","20,277.0210",10.00 AED,10.00,9.8000,0.2000,565556879,1601234,Success,United Arab Emirates,DU UAE,Transguard Group LLC,API User,E6AEAE22430
2022-02-22 05:48,72904333,"20,277.0210","20,267.2210",10.00 AED,10.00,9.8000,0.2000,565557333,1601249,Success,United Arab Emirates,DU UAE,Transguard Group LLC,API User,E6AEAE22430
2022-02-22 05:56,72904573,"20,267.2210","20,262.3210",05.00 AED,5.00,4.9000,0.1000,565558185,1601256,Success,United Arab Emirates,DU UAE,Transguard Group LLC,API User,E6AEAE17361
2022-02-22 05:59,72904661,"20,262.3210","20,257.4210",05.00 AED,5.00,4.9000,0.1000,565558443,1601264,Success,United Arab Emirates,DU UAE,Transguard Group LLC,API User,E6AEAE17361
2022-02-22 06:06,72904896,"20,257.4210","20,252.5210",05.00 AED,5.00,4.9000,0.1000,565559183,1601279,Success,United Arab Emirates,DU UAE,Transguard Group LLC,API User,E6AEAE17361
2022-02-22 06:10,72904996,"20,252.5210","20,242.7210",10.00 AED,10.00,9.8000,0.2000,565559504,1601282,Success,United Arab Emirates,DU UAE,Transguard Group LLC,API User,E6AEAE22430
2022-02-22 06:16,72905164,"20,242.7210","20,237.8210",05.00 AED,5.00,4.9000,0.1000,565560135,1601285,Success,United Arab Emirates,DU UAE,Transguard Group LLC,API User,E6AEAE17361
2022-02-22 06:26,72905479,"20,237.8210","20,232.9210",05.00 AED,5.00,4.9000,0.1000,565561171,1601296,Success,United Arab Emirates,DU UAE,Transguard Group LLC,API User,E6AEAE17361
2022-02-22 06:27,72905511,"20,232.9210","20,228.0210",05.00 AED,5.00,4.9000,0.1000,565561263,1601301,Success,United Arab Emirates,DU UAE,Transguard Group LLC,API User,E6AEAE17361
2022-02-22 06:27,72905528,"20,228.0210","20,208.4210",20.00 AED,20.00,19.6000,0.4000,565561303,1601302,Success,United Arab Emirates,DU UAE,Transguard Group LLC,API User,E6AEAE12938
2022-02-22 06:37,72905829,"20,208.4210","20,198.6210",10.00 AED,10.00,9.8000,0.2000,565562187,1601308,Success,United Arab Emirates,DU UAE,Transguard Group LLC,API User,E6AEAE22430
2022-02-22 06:38,72905864,"20,198.6210","20,194.4410",150.00 PKR,4.75,4.1800,0.5700,565562287,1601317,Success,Pakistan,Zong Pakistan,Transguard Group LLC,API User,ZNPKPK65621
2022-02-22 06:39,72905880,"20,194.4410","20,184.6410",10.00 AED,10.00,9.8000,0.2000,565562333,1601318,Success,United Arab Emirates,DU UAE,Transguard Group LLC,API User,E6AEAE22430
2022-02-22 06:42,72905973,"20,184.6410","20,174.8410",10.00 AED,10.00,9.8000,0.2000,565562596,1601321,Success,United Arab Emirates,DU UAE,Transguard Group LLC,API User,E6AEAE22430
2022-02-22 06:48,72906163,"20,174.8410","20,169.9410",05.00 AED,5.00,4.9000,0.1000,565563135,1601326,Success,United Arab Emirates,DU UAE,Transguard Group LLC,API User,E6AEAE17361
2022-02-22 06:52,72906302,"20,169.9410","20,160.1410",10.00 AED,10.00,9.8000,0.2000,565563547,1601329,Success,United Arab Emirates,DU UAE,Transguard Group LLC,API User,E6AEAE22430
2022-02-22 06:54,72906339,"20,160.1410","20,155.2410",05.00 AED,5.00,4.9000,0.1000,565563664,1601333,Success,United Arab Emirates,DU UAE,Transguard Group LLC,API User,E6AEAE17361
2022-02-22 06:58,72906454,"20,155.2410","20,145.4410",10.00 AED,10.00,9.8000,0.2000,565564021,1601340,Success,United Arab Emirates,DU UAE,Transguard Group LLC,API User,E6AEAE22430
2022-02-22 06:59,72906475,"20,145.4410","20,135.6410",10.00 AED,10.00,9.8000,0.2000,565564084,1601343,Success,United Arab Emirates,DU UAE,Transguard Group LLC,API User,E6AEAE22430
2022-02-22 07:03,72906608,"20,135.6410","20,130.7410",05.00 AED,5.00,4.9000,0.1000,565564457,1601347,Success,United Arab Emirates,DU UAE,Transguard Group LLC,API User,E6AEAE17361
2022-02-22 07:04,72906625,"20,130.7410","20,120.9410",10.00 AED,10.00,9.8000,0.2000,565564488,1601350,Success,United Arab Emirates,DU UAE,Transguard Group LLC,API User,E6AEAE22430
2022-02-22 07:04,72906636,"20,120.9410","20,111.1410",10.00 AED,10.00,9.8000,0.2000,565564518,1601352,Success,United Arab Emirates,DU UAE,Transguard Group LLC,API User,E6AEAE22430
2022-02-22 07:10,72906798,"20,111.1410","20,101.3410",10.00 AED,10.00,9.8000,0.2000,565565037,1601360,Success,United Arab Emirates,DU UAE,Transguard Group LLC,API User,E6AEAE22430
2022-02-22 07:14,72906922,"20,101.3410","20,096.4410",05.00 AED,5.00,4.9000,0.1000,565565403,1601372,Success,United Arab Emirates,DU UAE,Transguard Group LLC,API User,E6AEAE17361
2022-02-22 07:20,72907112,"20,096.4410","20,091.5410",05.00 AED,5.00,4.9000,0.1000,565565953,1601382,Success,United Arab Emirates,DU UAE,Transguard Group LLC,API User,E6AEAE17361
2022-02-22 07:22,72907156,"20,091.5410","20,081.7410",10.00 AED,10.00,9.8000,0.2000,565566043,1601390,Success,United Arab Emirates,DU UAE,Transguard Group LLC,API User,E6AEAE22430
2022-02-22 07:23,72907184,"20,081.7410","20,076.8410",05.00 AED,5.00,4.9000,0.1000,565566118,1601394,Success,United Arab Emirates,DU UAE,Transguard Group LLC,API User,E6AEAE17361
2022-02-22 07:26,72907294,"20,076.8410","20,067.0410",10.00 AED,10.00,9.8000,0.2000,565566429,1601402,Success,United Arab Emirates,DU UAE,Transguard Group LLC,API User,E6AEAE22430
2022-02-22 07:27,72907316,"20,067.0410","20,062.1410",05.00 AED,5.00,4.9000,0.1000,565566485,1601406,Success,United Arab Emirates,DU UAE,Transguard Group LLC,API User,E6AEAE17361
2022-02-22 07:30,72907393,"20,062.1410","20,057.2410",05.00 AED,5.00,4.9000,0.1000,565566733,1601409,Success,United Arab Emirates,DU UAE,Transguard Group LLC,API User,E6AEAE17361
2022-02-22 07:34,72907500,"20,057.2410","20,052.3410",05.00 AED,5.00,4.9000,0.1000,565567055,1601414,Success,United Arab Emirates,DU UAE,Transguard Group LLC,API User,E6AEAE17361
2022-02-22 07:35,72907521,"20,052.3410","20,047.4410",05.00 AED,5.00,4.9000,0.1000,565567130,1601420,Success,United Arab Emirates,DU UAE,Transguard Group LLC,API User,E6AEAE17361
2022-02-22 07:41,72907679,"20,047.4410","20,037.6410",10.00 AED,10.00,9.8000,0.2000,565567625,1601430,Success,United Arab Emirates,DU UAE,Transguard Group LLC,API User,E6AEAE22430
2022-02-22 07:42,72907712,"20,037.6410","20,032.7410",05.00 AED,5.00,4.9000,0.1000,565567718,1601434,Success,United Arab Emirates,DU UAE,Transguard Group LLC,API User,E6AEAE17361
2022-02-22 07:43,72907760,"20,032.7410","20,006.3410",23.00 SAR,30.00,26.4000,3.6000,565567859,1601436,Success,Saudi Arabia,stc-sawa KSA,Transguard Group LLC,API User,S6SASA52404
2022-02-22 07:46,72907860,"20,006.3410","19,996.5410",10.00 AED,10.00,9.8000,0.2000,565568119,1601442,Success,United Arab Emirates,DU UAE,Transguard Group LLC,API User,E6AEAE22430
2022-02-22 07:48,72907892,"19,996.5410","19,991.6410",05.00 AED,5.00,4.9000,0.1000,565568220,1601446,Success,United Arab Emirates,DU UAE,Transguard Group LLC,API User,E6AEAE17361
2022-02-22 07:50,72907968,"19,991.6410","19,972.0410",20.00 AED,20.00,19.6000,0.4000,565568428,1601456,Success,United Arab Emirates,DU UAE,Transguard Group LLC,API User,E6AEAE12938
2022-02-22 07:51,72907989,"19,972.0410","19,964.1210",220.00 NPR,9.00,7.9200,1.0800,565568476,1601459,Success,Nepal,Ncell Nepal,Transguard Group LLC,API User,NCNPNP79518
2022-02-22 07:55,72908117,"19,964.1210","19,944.5210",20.00 AED,20.00,19.6000,0.4000,565568815,1601467,Success,United Arab Emirates,DU UAE,Transguard Group LLC,API User,E6AEAE12938
2022-02-22 07:57,72908162,"19,944.5210","19,934.7210",10.00 AED,10.00,9.8000,0.2000,565568914,1601472,Success,United Arab Emirates,DU UAE,Transguard Group LLC,API User,E6AEAE22430
2022-02-22 07:57,72908188,"19,934.7210","19,929.8210",05.00 AED,5.00,4.9000,0.1000,565568991,1601476,Success,United Arab Emirates,DU UAE,Transguard Group LLC,API User,E6AEAE17361
2022-02-22 08:02,72908332,"19,929.8210","19,924.9210",05.00 AED,5.00,4.9000,0.1000,565569419,1601482,Success,United Arab Emirates,DU UAE,Transguard Group LLC,API User,E6AEAE17361
2022-02-22 08:03,72908333,"19,924.9210","19,917.0010",220.00 NPR,9.00,7.9200,1.0800,565569424,1601483,Success,Nepal,Ncell Nepal,Transguard Group LLC,API User,NCNPNP79518
2022-02-22 08:05,72908400,"19,917.0010","19,912.1010",05.00 AED,5.00,4.9000,0.1000,565569631,1601487,Success,United Arab Emirates,DU UAE,Transguard Group LLC,API User,E6AEAE17361
2022-02-22 08:06,72908443,"19,912.1010","19,902.3010",10.00 AED,10.00,9.8000,0.2000,565569815,1601492,Success,United Arab Emirates,DU UAE,Transguard Group LLC,API User,E6AEAE22430
2022-02-22 08:08,72908492,"19,902.3010","19,868.0010",35.00 AED,35.00,34.3000,0.7000,565569989,1601499,Success,United Arab Emirates,DU UAE,Transguard Group LLC,API User,E6AEAE73954
2022-02-22 08:09,72908510,"19,868.0010","19,863.1010",05.00 AED,5.00,4.9000,0.1000,565570063,1601502,Success,United Arab Emirates,DU UAE,Transguard Group LLC,API User,E6AEAE17361
2022-02-22 08:11,72908564,"19,863.1010","19,858.2010",05.00 AED,5.00,4.9000,0.1000,565570204,1601505,Success,United Arab Emirates,DU UAE,Transguard Group LLC,API User,E6AEAE17361
2022-02-22 08:14,72908662,"19,858.2010","19,853.3010",05.00 AED,5.00,4.9000,0.1000,565570424,1601514,Success,United Arab Emirates,DU UAE,Transguard Group LLC,API User,E6AEAE17361
2022-02-22 08:18,72908794,"19,853.3010","19,843.5010",10.00 AED,10.00,9.8000,0.2000,565570832,1601517,Success,United Arab Emirates,DU UAE,Transguard Group LLC,API User,E6AEAE22430
2022-02-22 08:22,72908900,"19,843.5010","19,833.7010",10.00 AED,10.00,9.8000,0.2000,565571119,1601522,Success,United Arab Emirates,DU UAE,Transguard Group LLC,API User,E6AEAE22430
2022-02-22 08:24,72908965,"19,833.7010","19,829.3010",50.00 PHP,5.00,4.4000,0.6000,565571317,1601526,Success,Philippines,BS_Globe Philippines,Transguard Group LLC,API User,PH_GB_TopUp_50.00
2022-02-22 08:27,72909032,"19,829.3010","19,824.4010",05.00 AED,5.00,4.9000,0.1000,565571515,1601529,Success,United Arab Emirates,DU UAE,Transguard Group LLC,API User,E6AEAE17361
2022-02-22 08:34,72909241,"19,824.4010","19,819.5010",05.00 AED,5.00,4.9000,0.1000,565572129,1601538,Success,United Arab Emirates,DU UAE,Transguard Group LLC,API User,E6AEAE17361
2022-02-22 08:41,72909444,"19,819.5010","19,814.6010",05.00 AED,5.00,4.9000,0.1000,565572799,1601547,Success,United Arab Emirates,DU UAE,Transguard Group LLC,API User,E6AEAE17361
2022-02-22 08:42,72909491,"19,814.6010","19,809.7010",05.00 AED,5.00,4.9000,0.1000,565572925,1601550,Success,United Arab Emirates,DU UAE,Transguard Group LLC,API User,E6AEAE17361
2022-02-22 08:52,72909828,"19,809.7010","19,804.8010",05.00 AED,5.00,4.9000,0.1000,565573799,1601561,Success,United Arab Emirates,DU UAE,Transguard Group LLC,API User,E6AEAE17361
2022-02-22 08:59,72910033,"19,804.8010","19,799.9010",05.00 AED,5.00,4.9000,0.1000,565574399,1601577,Success,United Arab Emirates,DU UAE,Transguard Group LLC,API User,E6AEAE17361
2022-02-22 09:01,72910112,"19,799.9010","19,790.1010",10.00 AED,10.00,9.8000,0.2000,565574616,1601588,Success,United Arab Emirates,DU UAE,Transguard Group LLC,API User,E6AEAE22430
2022-02-22 09:02,72910134,"19,790.1010","19,785.2010",05.00 AED,5.00,4.9000,0.1000,565574699,1601592,Success,United Arab Emirates,DU UAE,Transguard Group LLC,API User,E6AEAE17361
2022-02-22 09:04,72910194,"19,785.2010","19,780.3010",05.00 AED,5.00,4.9000,0.1000,565574870,1601603,Success,United Arab Emirates,DU UAE,Transguard Group LLC,API User,E6AEAE17361
2022-02-22 09:04,72910204,"19,780.3010","19,770.5010",10.00 AED,10.00,9.8000,0.2000,565574891,1601606,Success,United Arab Emirates,DU UAE,Transguard Group LLC,API User,E6AEAE22430
2022-02-22 09:07,72910270,"19,770.5010","19,760.7010",10.00 AED,10.00,9.8000,0.2000,565575107,1601613,Success,United Arab Emirates,DU UAE,Transguard Group LLC,API User,E6AEAE22430
2022-02-22 09:11,72910406,"19,760.7010","19,751.9010",315.00 PKR,10.00,8.8000,1.2000,565575455,1601625,Success,Pakistan,Telenor Pakistan,Transguard Group LLC,API User,TPPKPK75105
2022-02-22 09:14,72910489,"19,751.9010","19,742.1010",10.00 AED,10.00,9.8000,0.2000,565575690,1601629,Success,United Arab Emirates,DU UAE,Transguard Group LLC,API User,E6AEAE22430
2022-02-22 09:14,72910494,"19,742.1010","19,702.9010",40.00 AED,40.00,39.2000,0.8000,565575711,1601631,Success,United Arab Emirates,DU UAE,Transguard Group LLC,API User,E6AEAE64011
2022-02-22 09:20,72910699,"19,702.9010","19,698.0010",05.00 AED,5.00,4.9000,0.1000,565576250,1601642,Success,United Arab Emirates,DU UAE,Transguard Group LLC,API User,E6AEAE17361
2022-02-22 09:24,72910804,"19,698.0010","19,684.8010","11,003.00 UGX",15.00,13.2000,1.8000,565576545,1601646,Success,Uganda,Airtel Uganda,Transguard Group LLC,API User,UG_WA_TopUp
2022-02-22 09:30,72911022,"19,684.8010","19,679.9010",05.00 AED,5.00,4.9000,0.1000,565577086,1601657,Success,United Arab Emirates,DU UAE,Transguard Group LLC,API User,E6AEAE17361
2022-02-22 09:33,72911138,"19,679.9010","19,655.4010",25.00 AED,25.00,24.5000,0.5000,565577393,72911138,Failure,United Arab Emirates,DU UAE,Transguard Group LLC,mohammed.arafath@transguardgroup.com,E6AEAE17343
2022-02-22 09:33,72911138,"19,655.4010","19,630.9010",25.00 AED,25.00,24.5000,0.5000,565577393,72911138,Failure,United Arab Emirates,DU UAE,Transguard Group LLC,mohammed.arafath@transguardgroup.com,E6AEAE17343
2022-02-22 09:44,72911481,"19,679.9010","19,670.1010",10.00 AED,10.00,9.8000,0.2000,565578310,1601679,Success,United Arab Emirates,DU UAE,Transguard Group LLC,API User,E6AEAE22430
2022-02-22 09:47,72911594,"19,670.1010","19,665.2010",05.00 AED,5.00,4.9000,0.1000,565578578,1601687,Success,United Arab Emirates,DU UAE,Transguard Group LLC,API User,E6AEAE17361
2022-02-22 09:48,72911622,"19,665.2010","19,660.3010",05.00 AED,5.00,4.9000,0.1000,565578645,1601690,Success,United Arab Emirates,DU UAE,Transguard Group LLC,API User,E6AEAE17361
2022-02-22 10:00,72912069,"19,660.3010","19,650.5010",10.00 AED,10.00,9.8000,0.2000,565579732,1601709,Success,United Arab Emirates,DU UAE,Transguard Group LLC,API User,E6AEAE22430
2022-02-22 10:00,72912077,"19,650.5010","19,645.6010",05.00 AED,5.00,4.9000,0.1000,565579756,1601711,Success,United Arab Emirates,DU UAE,Transguard Group LLC,API User,E6AEAE17361
2022-02-22 10:06,72912237,"19,645.6010","19,635.8010",10.00 AED,10.00,9.8000,0.2000,565580182,1601718,Success,United Arab Emirates,DU UAE,Transguard Group LLC,API User,E6AEAE22430
2022-02-22 10:06,72912260,"19,635.8010","19,626.0010",10.00 AED,10.00,9.8000,0.2000,565580244,1601724,Success,United Arab Emirates,DU UAE,Transguard Group LLC,API User,E6AEAE22430
2022-02-22 10:10,72912375,"19,626.0010","19,622.2610",151.00 PKR,4.25,3.7400,0.5100,565580529,1601730,Success,Pakistan,Telenor Pakistan,Transguard Group LLC,API User,TPPKPK94108
2022-02-22 10:12,72912457,"19,622.2610","19,617.3610",05.00 AED,5.00,4.9000,0.1000,565580759,1601737,Success,United Arab Emirates,DU UAE,Transguard Group LLC,API User,E6AEAE17361
2022-02-22 10:22,72912799,"19,617.3610","19,607.5610",10.00 AED,10.00,9.8000,0.2000,565581691,1601752,Success,United Arab Emirates,DU UAE,Transguard Group LLC,API User,E6AEAE22430
2022-02-22 10:24,72912870,"19,607.5610","19,603.3810",150.00 PKR,4.75,4.1800,0.5700,565581886,1601760,Success,Pakistan,Zong Pakistan,Transguard Group LLC,API User,ZNPKPK65621
2022-02-22 10:28,72912972,"19,603.3810","19,598.4810",05.00 AED,5.00,4.9000,0.1000,565582168,1601765,Success,United Arab Emirates,DU UAE,Transguard Group LLC,API User,E6AEAE17361
2022-02-22 10:34,72913159,"19,598.4810","19,593.5810",05.00 AED,5.00,4.9000,0.1000,565582756,1601774,Success,United Arab Emirates,DU UAE,Transguard Group LLC,API User,E6AEAE17361
2022-02-22 10:35,72913181,"19,593.5810","19,588.6810",05.00 AED,5.00,4.9000,0.1000,565582838,1601777,Success,United Arab Emirates,DU UAE,Transguard Group LLC,API User,E6AEAE17361
2022-02-22 10:44,72913452,"19,588.6810","19,583.7810",05.00 AED,5.00,4.9000,0.1000,565583614,1601794,Success,United Arab Emirates,DU UAE,Transguard Group LLC,API User,E6AEAE17361
2022-02-22 10:46,72913515,"19,583.7810","19,573.9810",10.00 AED,10.00,9.8000,0.2000,565583782,72913515,Failure,United Arab Emirates,DU UAE,Transguard Group LLC,mohammed.arafath@transguardgroup.com,E6AEAE22430
2022-02-22 10:46,72913515,"19,573.9810","19,564.1810",10.00 AED,10.00,9.8000,0.2000,565583782,72913515,Failure,United Arab Emirates,DU UAE,Transguard Group LLC,mohammed.arafath@transguardgroup.com,E6AEAE22430
2022-02-22 10:47,72913539,"19,583.7810","19,578.8810",05.00 AED,5.00,4.9000,0.1000,565583857,1601797,Success,United Arab Emirates,DU UAE,Transguard Group LLC,API User,E6AEAE17361
2022-02-22 10:50,72913628,"19,578.8810","19,573.9810",05.00 AED,5.00,4.9000,0.1000,565584102,1601807,Success,United Arab Emirates,DU UAE,Transguard Group LLC,API User,E6AEAE17361
2022-02-22 10:51,72913668,"19,573.9810","19,565.8410",300.00 PKR,9.25,8.1400,1.1100,565584225,1601812,Success,Pakistan,Zong Pakistan,Transguard Group LLC,API User,ZNPKPK70504
2022-02-22 11:07,72914181,"19,565.8410","19,556.0410",10.00 AED,10.00,9.8000,0.2000,565585618,1601836,Success,United Arab Emirates,DU UAE,Transguard Group LLC,API User,E6AEAE22430
2022-02-22 11:08,72914204,"19,556.0410","19,551.1410",05.00 AED,5.00,4.9000,0.1000,565585685,1601839,Success,United Arab Emirates,DU UAE,Transguard Group LLC,API User,E6AEAE17361
2022-02-22 11:09,72914237,"19,551.1410","19,546.2410",05.00 AED,5.00,4.9000,0.1000,565585771,1601843,Success,United Arab Emirates,DU UAE,Transguard Group LLC,API User,E6AEAE17361
2022-02-22 11:11,72914278,"19,546.2410","19,541.3410",05.00 AED,5.00,4.9000,0.1000,565585891,1601846,Success,United Arab Emirates,DU UAE,Transguard Group LLC,API User,E6AEAE17361
2022-02-22 11:12,72914305,"19,541.3410","19,536.4410",05.00 AED,5.00,4.9000,0.1000,565585978,72914305,Success,United Arab Emirates,DU UAE,Transguard Group LLC,mohammed.arafath@transguardgroup.com,E6AEAE17361
2022-02-22 11:13,72914355,"19,536.4410","19,526.6410",10.00 AED,10.00,9.8000,0.2000,565586103,72914355,Success,United Arab Emirates,DU UAE,Transguard Group LLC,mohammed.arafath@transguardgroup.com,E6AEAE22430
2022-02-22 11:17,72914474,"19,526.6410","19,516.8410",10.00 AED,10.00,9.8000,0.2000,565586457,1601859,Success,United Arab Emirates,DU UAE,Transguard Group LLC,API User,E6AEAE22430
2022-02-22 11:18,72914506,"19,516.8410","19,492.3410",25.00 AED,25.00,24.5000,0.5000,565586551,1601864,Success,United Arab Emirates,DU UAE,Transguard Group LLC,API User,E6AEAE17343
2022-02-22 11:19,72914586,"19,492.3410","19,467.8410",25.00 AED,25.00,24.5000,0.5000,565586719,1601869,Success,United Arab Emirates,DU UAE,Transguard Group LLC,API User,E6AEAE17343
2022-02-22 11:20,72914619,"19,467.8410","19,462.9410",05.00 AED,5.00,4.9000,0.1000,565586803,1601872,Success,United Arab Emirates,DU UAE,Transguard Group LLC,API User,E6AEAE17361
2022-02-22 11:21,72914652,"19,462.9410","19,458.7610",150.00 PKR,4.75,4.1800,0.5700,565586899,1601876,Success,Pakistan,Jazz Pakistan,Transguard Group LLC,API User,MBPKPK20699
2022-02-22 11:24,72914738,"19,453.8610","19,448.9610",05.00 AED,5.00,4.9000,0.1000,565587161,1601884,Failure,United Arab Emirates,DU UAE,Transguard Group LLC,API User,E6AEAE17361
2022-02-22 11:24,72914738,"19,458.7610","19,453.8610",05.00 AED,5.00,4.9000,0.1000,565587161,1601884,Failure,United Arab Emirates,DU UAE,Transguard Group LLC,API User,E6AEAE17361
2022-02-22 11:29,72914879,"19,458.7610","19,453.8610",05.00 AED,5.00,4.9000,0.1000,565587611,1601893,Success,United Arab Emirates,DU UAE,Transguard Group LLC,API User,E6AEAE17361
2022-02-22 11:31,72914923,"19,453.8610","19,448.9610",05.00 AED,5.00,4.9000,0.1000,565587710,1601900,Success,United Arab Emirates,DU UAE,Transguard Group LLC,API User,E6AEAE17361
2022-02-22 11:31,72914927,"19,448.9610","19,444.0610",05.00 AED,5.00,4.9000,0.1000,565587724,1601902,Success,United Arab Emirates,DU UAE,Transguard Group LLC,API User,E6AEAE17361
2022-02-22 11:31,72914937,"19,444.0610","19,439.1610",05.00 AED,5.00,4.9000,0.1000,565587753,1601903,Success,United Arab Emirates,DU UAE,Transguard Group LLC,API User,E6AEAE17361
2022-02-22 11:38,72915189,"19,439.1610","19,434.2610",05.00 AED,5.00,4.9000,0.1000,565588430,1601913,Success,United Arab Emirates,DU UAE,Transguard Group LLC,API User,E6AEAE17361
2022-02-22 11:41,72915284,"19,434.2610","19,424.4610",10.00 AED,10.00,9.8000,0.2000,565588683,1601920,Success,United Arab Emirates,DU UAE,Transguard Group LLC,API User,E6AEAE22430
2022-02-22 11:44,72915404,"19,424.4610","19,419.5610",05.00 AED,5.00,4.9000,0.1000,565588973,1601924,Success,United Arab Emirates,DU UAE,Transguard Group LLC,API User,E6AEAE17361
2022-02-22 11:48,72915536,"19,419.5610","19,414.6610",05.00 AED,5.00,4.9000,0.1000,565589332,1601929,Success,United Arab Emirates,DU UAE,Transguard Group LLC,API User,E6AEAE17361
2022-02-22 11:51,72915619,"19,414.6610","19,410.9210",100.00 NPR,4.25,3.7400,0.5100,565589566,1601934,Success,Nepal,Ncell Nepal,Transguard Group LLC,API User,NP_NC_TopUp_100.00
2022-02-22 11:53,72915696,"19,410.9210","19,401.1210",10.00 AED,10.00,9.8000,0.2000,565589766,1601946,Success,United Arab Emirates,DU UAE,Transguard Group LLC,API User,E6AEAE22430
2022-02-22 11:56,72915791,"19,401.1210","19,396.2210",05.00 AED,5.00,4.9000,0.1000,565590044,1601956,Success,United Arab Emirates,DU UAE,Transguard Group LLC,API User,E6AEAE17361
2022-02-22 11:57,72915813,"19,396.2210","19,391.3210",05.00 AED,5.00,4.9000,0.1000,565590100,1601961,Success,United Arab Emirates,DU UAE,Transguard Group LLC,API User,E6AEAE17361
2022-02-22 12:01,72915959,"19,391.3210","19,386.4210",05.00 AED,5.00,4.9000,0.1000,565590475,1601972,Success,United Arab Emirates,DU UAE,Transguard Group LLC,API User,E6AEAE17361
2022-02-22 12:01,72915965,"19,386.4210","19,382.6810",100.00 NPR,4.25,3.7400,0.5100,565590493,1601974,Success,Nepal,SmartCell Nepal,Transguard Group LLC,API User,NQNPNP58761
2022-02-22 12:07,72916147,"19,382.6810","19,372.8810",10.00 AED,10.00,9.8000,0.2000,565591033,1601994,Success,United Arab Emirates,DU UAE,Transguard Group LLC,API User,E6AEAE22430
2022-02-22 12:13,72916347,"19,372.8810","19,355.9410",470.00 NPR,19.25,16.9400,2.3100,565591581,1601998,Success,Nepal,Ncell Nepal,Transguard Group LLC,API User,NCNPNP37643
2022-02-22 12:16,72916472,"19,355.9410","19,328.4410","1,000.00 PKR",31.25,27.5000,3.7500,565591916,1602005,Success,Pakistan,Ufone Pakistan,Transguard Group LLC,API User,PK_UF_TopUp_1000.00
2022-02-22 12:18,72916536,"19,328.4410","19,323.5410",05.00 AED,5.00,4.9000,0.1000,565592088,1602010,Success,United Arab Emirates,DU UAE,Transguard Group LLC,API User,E6AEAE17361
2022-02-22 12:21,72916662,"19,323.5410","19,313.7410",10.00 AED,10.00,9.8000,0.2000,565592416,1602015,Success,United Arab Emirates,DU UAE,Transguard Group LLC,API User,E6AEAE22430
2022-02-22 12:30,72916993,"19,313.7410","19,308.8410",05.00 AED,5.00,4.9000,0.1000,565593251,1602025,Success,United Arab Emirates,DU UAE,Transguard Group LLC,API User,E6AEAE17361
2022-02-22 12:33,72917118,"19,308.8410","19,294.1410",15.00 AED,15.00,14.7000,0.3000,565593590,1602032,Success,United Arab Emirates,DU UAE,Transguard Group LLC,API User,E6AEAE8527
2022-02-22 12:35,72917191,"19,294.1410","19,289.2410",05.00 AED,5.00,4.9000,0.1000,565593794,1602035,Success,United Arab Emirates,DU UAE,Transguard Group LLC,API User,E6AEAE17361
2022-02-22 12:38,72917299,"19,289.2410","19,279.4410",10.00 AED,10.00,9.8000,0.2000,565594070,1602041,Success,United Arab Emirates,DU UAE,Transguard Group LLC,API User,E6AEAE22430
2022-02-22 12:40,72917371,"19,279.4410","19,274.5410",05.00 AED,5.00,4.9000,0.1000,565594252,1602050,Success,United Arab Emirates,DU UAE,Transguard Group LLC,API User,E6AEAE17361
2022-02-22 12:40,72917380,"19,274.5410","19,264.7410",10.00 AED,10.00,9.8000,0.2000,565594270,1602052,Success,United Arab Emirates,DU UAE,Transguard Group LLC,API User,E6AEAE22430
2022-02-22 12:41,72917416,"19,264.7410","19,259.8410",05.00 AED,5.00,4.9000,0.1000,565594353,1602055,Success,United Arab Emirates,DU UAE,Transguard Group LLC,API User,E6AEAE17361
2022-02-22 12:45,72917566,"19,259.8410","19,254.9410",05.00 AED,5.00,4.9000,0.1000,565594724,1602065,Success,United Arab Emirates,DU UAE,Transguard Group LLC,API User,E6AEAE17361
2022-02-22 12:48,72917670,"19,254.9410","19,250.0410",05.00 AED,5.00,4.9000,0.1000,565594970,1602072,Success,United Arab Emirates,DU UAE,Transguard Group LLC,API User,E6AEAE17361
2022-02-22 12:53,72917832,"19,250.0410","19,241.6810",100.00 PHP,9.50,8.3600,1.1400,565595406,1602082,Success,Philippines,Smart (SunCellular) Philippines,Transguard Group LLC,API User,PH_SM_TopUp_100.00
2022-02-22 12:56,72917930,"19,241.6810","19,236.7810",05.00 AED,5.00,4.9000,0.1000,565595702,1602088,Success,United Arab Emirates,DU UAE,Transguard Group LLC,API User,E6AEAE17361
2022-02-22 12:57,72917950,"19,236.7810","19,231.8810",05.00 AED,5.00,4.9000,0.1000,565595753,1602090,Success,United Arab Emirates,DU UAE,Transguard Group LLC,API User,E6AEAE17361
2022-02-22 13:04,72918211,"19,231.8810","19,222.0810",10.00 AED,10.00,9.8000,0.2000,565596421,1602097,Success,United Arab Emirates,DU UAE,Transguard Group LLC,API User,E6AEAE22430
2022-02-22 13:08,72918384,"19,222.0810","19,217.1810",05.00 AED,5.00,4.9000,0.1000,565596885,1602106,Success,United Arab Emirates,DU UAE,Transguard Group LLC,API User,E6AEAE17361
2022-02-22 13:12,72918522,"19,217.1810","19,207.3810",10.00 AED,10.00,9.8000,0.2000,565597266,1602111,Success,United Arab Emirates,DU UAE,Transguard Group LLC,API User,E6AEAE22430
2022-02-22 13:12,72918559,"19,207.3810","19,202.4810",05.00 AED,5.00,4.9000,0.1000,565597336,1602114,Success,United Arab Emirates,DU UAE,Transguard Group LLC,API User,E6AEAE17361
2022-02-22 13:15,72918660,"19,202.4810","19,197.5810",05.00 AED,5.00,4.9000,0.1000,565597581,1602119,Success,United Arab Emirates,DU UAE,Transguard Group LLC,API User,E6AEAE17361
2022-02-22 13:18,72918756,"19,197.5810","19,192.6810",05.00 AED,5.00,4.9000,0.1000,565597876,1602126,Success,United Arab Emirates,DU UAE,Transguard Group LLC,API User,E6AEAE17361
2022-02-22 13:29,72919171,"19,192.6810","19,173.0810",20.00 AED,20.00,19.6000,0.4000,565598939,1602135,Success,United Arab Emirates,DU UAE,Transguard Group LLC,API User,E6AEAE12938
2022-02-22 13:35,72919398,"19,173.0810","19,168.1810",05.00 AED,5.00,4.9000,0.1000,565599600,1602147,Success,United Arab Emirates,DU UAE,Transguard Group LLC,API User,E6AEAE17361
2022-02-22 13:35,72919402,"19,168.1810","19,159.3810",315.00 PKR,10.00,8.8000,1.2000,565599619,1602148,Success,Pakistan,Telenor Pakistan,Transguard Group LLC,API User,TPPKPK75105
2022-02-22 13:37,72919466,"19,159.3810","19,154.4810",05.00 AED,5.00,4.9000,0.1000,565599815,1602152,Success,United Arab Emirates,DU UAE,Transguard Group LLC,API User,E6AEAE17361
2022-02-22 13:38,72919514,"19,154.4810","19,149.5810",05.00 AED,5.00,4.9000,0.1000,565599955,1602157,Success,United Arab Emirates,DU UAE,Transguard Group LLC,API User,E6AEAE17361
2022-02-22 13:39,72919535,"19,149.5810","19,129.9810",20.00 AED,20.00,19.6000,0.4000,565600010,1602159,Success,United Arab Emirates,DU UAE,Transguard Group LLC,API User,E6AEAE12938
2022-02-22 13:39,72919551,"19,129.9810","19,120.1810",10.00 AED,10.00,9.8000,0.2000,565600053,1602161,Success,United Arab Emirates,DU UAE,Transguard Group LLC,API User,E6AEAE22430
2022-02-22 13:40,72919577,"19,120.1810","19,115.2810",05.00 AED,5.00,4.9000,0.1000,565600148,1602164,Success,United Arab Emirates,DU UAE,Transguard Group LLC,API User,E6AEAE17361
2022-02-22 13:41,72919597,"19,115.2810","19,110.3810",05.00 AED,5.00,4.9000,0.1000,565600213,1602168,Success,United Arab Emirates,DU UAE,Transguard Group LLC,API User,E6AEAE17361
2022-02-22 13:41,72919607,"19,110.3810","19,090.7810",20.00 AED,20.00,19.6000,0.4000,565600243,1602171,Success,United Arab Emirates,DU UAE,Transguard Group LLC,API User,E6AEAE12938
2022-02-22 13:41,72919622,"19,090.7810","19,080.9810",10.00 AED,10.00,9.8000,0.2000,565600280,1602173,Success,United Arab Emirates,DU UAE,Transguard Group LLC,API User,E6AEAE22430
2022-02-22 13:43,72919670,"19,080.9810","19,061.3810",20.00 AED,20.00,19.6000,0.4000,565600417,1602176,Success,United Arab Emirates,DU UAE,Transguard Group LLC,API User,E6AEAE12938
2022-02-22 13:45,72919767,"19,061.3810","19,041.7810",20.00 AED,20.00,19.6000,0.4000,565600688,1602179,Success,United Arab Emirates,DU UAE,Transguard Group LLC,API User,E6AEAE12938
2022-02-22 13:53,72920007,"19,041.7810","19,036.8810",05.00 AED,5.00,4.9000,0.1000,565601380,1602187,Success,United Arab Emirates,DU UAE,Transguard Group LLC,API User,E6AEAE17361
2022-02-22 13:53,72920029,"19,036.8810","19,027.0810",10.00 AED,10.00,9.8000,0.2000,565601428,1602189,Success,United Arab Emirates,DU UAE,Transguard Group LLC,API User,E6AEAE22430
2022-02-22 13:57,72920168,"19,027.0810","19,022.1810",05.00 AED,5.00,4.9000,0.1000,565601794,1602192,Success,United Arab Emirates,DU UAE,Transguard Group LLC,API User,E6AEAE17361
2022-02-22 13:58,72920182,"19,022.1810","19,002.5810",20.00 AED,20.00,19.6000,0.4000,565601842,1602195,Success,United Arab Emirates,DU UAE,Transguard Group LLC,API User,E6AEAE12938
2022-02-22 13:59,72920248,"19,002.5810","18,997.6810",05.00 AED,5.00,4.9000,0.1000,565601989,1602198,Success,United Arab Emirates,DU UAE,Transguard Group LLC,API User,E6AEAE17361
2022-02-22 14:09,72920568,"18,997.6810","18,987.8810",10.00 AED,10.00,9.8000,0.2000,565602927,1602207,Success,United Arab Emirates,DU UAE,Transguard Group LLC,API User,E6AEAE22430
2022-02-22 14:10,72920608,"18,987.8810","18,982.9810",05.00 AED,5.00,4.9000,0.1000,565603071,1602212,Success,United Arab Emirates,DU UAE,Transguard Group LLC,API User,E6AEAE17361
2022-02-22 14:12,72920664,"18,982.9810","18,978.0810",05.00 AED,5.00,4.9000,0.1000,565603279,1602215,Success,United Arab Emirates,DU UAE,Transguard Group LLC,API User,E6AEAE17361
2022-02-22 14:13,72920694,"18,978.0810","18,968.2810",10.00 AED,10.00,9.8000,0.2000,565603364,1602218,Success,United Arab Emirates,DU UAE,Transguard Group LLC,API User,E6AEAE22430
2022-02-22 14:16,72920826,"18,968.2810","18,963.3810",05.00 AED,5.00,4.9000,0.1000,565603742,1602223,Success,United Arab Emirates,DU UAE,Transguard Group LLC,API User,E6AEAE17361
2022-02-22 14:16,72920829,"18,963.3810","18,943.7810",20.00 AED,20.00,19.6000,0.4000,565603754,1602224,Success,United Arab Emirates,DU UAE,Transguard Group LLC,API User,E6AEAE12938
2022-02-22 14:18,72920869,"18,943.7810","18,938.8810",05.00 AED,5.00,4.9000,0.1000,565603875,1602229,Success,United Arab Emirates,DU UAE,Transguard Group LLC,API User,E6AEAE17361
2022-02-22 14:20,72920940,"18,938.8810","18,929.0810",10.00 AED,10.00,9.8000,0.2000,565604091,1602235,Success,United Arab Emirates,DU UAE,Transguard Group LLC,API User,E6AEAE22430
2022-02-22 14:27,72921204,"18,929.0810","18,924.1810",05.00 AED,5.00,4.9000,0.1000,565604886,1602245,Success,United Arab Emirates,DU UAE,Transguard Group LLC,API User,E6AEAE17361
2022-02-22 14:30,72921316,"18,924.1810","18,914.3810",10.00 AED,10.00,9.8000,0.2000,565605214,1602250,Success,United Arab Emirates,DU UAE,Transguard Group LLC,API User,E6AEAE22430
2022-02-22 14:44,72921816,"18,914.3810","18,904.5810",10.00 AED,10.00,9.8000,0.2000,565606615,1602260,Success,United Arab Emirates,DU UAE,Transguard Group LLC,API User,E6AEAE22430
2022-02-22 14:45,72921860,"18,904.5810","18,899.6810",05.00 AED,5.00,4.9000,0.1000,565606746,1602263,Success,United Arab Emirates,DU UAE,Transguard Group LLC,API User,E6AEAE17361
2022-02-22 14:49,72922013,"18,899.6810","18,884.9410",249.00 INR,16.75,14.7400,2.0100,565607196,1602268,Success,India,Vi India,Transguard Group LLC,API User,VFININ67760
2022-02-22 14:50,72922039,"18,884.9410","18,880.0410",05.00 AED,5.00,4.9000,0.1000,565607254,1602271,Success,United Arab Emirates,DU UAE,Transguard Group LLC,API User,E6AEAE17361
2022-02-22 14:52,72922126,"18,880.0410","18,860.4410",20.00 AED,20.00,19.6000,0.4000,565607558,1602274,Success,United Arab Emirates,DU UAE,Transguard Group LLC,API User,E6AEAE12938
2022-02-22 14:55,72922215,"18,860.4410","18,850.6410",10.00 AED,10.00,9.8000,0.2000,565607853,1602277,Success,United Arab Emirates,DU UAE,Transguard Group LLC,API User,E6AEAE22430
2022-02-22 14:59,72922364,"18,850.6410","18,833.7010",470.00 NPR,19.25,16.9400,2.3100,565608343,1602282,Success,Nepal,Ncell Nepal,Transguard Group LLC,API User,NCNPNP37643
2022-02-22 15:01,72922447,"18,833.7010","18,828.8010",05.00 AED,5.00,4.9000,0.1000,565608563,1602286,Success,United Arab Emirates,DU UAE,Transguard Group LLC,API User,E6AEAE17361
2022-02-22 15:04,72922553,"18,828.8010","18,823.9010",05.00 AED,5.00,4.9000,0.1000,565608873,1602291,Success,United Arab Emirates,DU UAE,Transguard Group LLC,API User,E6AEAE17361
2022-02-22 15:11,72922839,"18,823.9010","18,814.1010",10.00 AED,10.00,9.8000,0.2000,565609723,1602296,Success,United Arab Emirates,DU UAE,Transguard Group LLC,API User,E6AEAE22430
2022-02-22 15:20,72923148,"18,814.1010","18,809.2010",05.00 AED,5.00,4.9000,0.1000,565610650,1602306,Success,United Arab Emirates,DU UAE,Transguard Group LLC,API User,E6AEAE17361
2022-02-22 15:21,72923179,"18,809.2010","18,804.3010",05.00 AED,5.00,4.9000,0.1000,565610748,1602309,Success,United Arab Emirates,DU UAE,Transguard Group LLC,API User,E6AEAE17361
2022-02-22 15:22,72923259,"18,804.3010","18,799.4010",05.00 AED,5.00,4.9000,0.1000,565610971,1602312,Success,United Arab Emirates,DU UAE,Transguard Group LLC,API User,E6AEAE17361
2022-02-22 15:25,72923354,"18,799.4010","18,789.6010",10.00 AED,10.00,9.8000,0.2000,565611260,1602317,Success,United Arab Emirates,DU UAE,Transguard Group LLC,API User,E6AEAE22430
2022-02-22 15:29,72923472,"18,789.6010","18,784.7010",05.00 AED,5.00,4.9000,0.1000,565611680,1602320,Success,United Arab Emirates,DU UAE,Transguard Group LLC,API User,E6AEAE17361
2022-02-22 15:32,72923591,"18,784.7010","18,779.8010",05.00 AED,5.00,4.9000,0.1000,565612067,1602328,Success,United Arab Emirates,DU UAE,Transguard Group LLC,API User,E6AEAE17361
2022-02-22 15:55,72924378,"18,779.8010","18,775.4010",50.00 PHP,5.00,4.4000,0.6000,565614640,1602343,Success,Philippines,BS_Globe Philippines,Transguard Group LLC,API User,PH_GB_TopUp_50.00
2022-02-22 15:56,72924414,"18,775.4010","18,770.5010",05.00 AED,5.00,4.9000,0.1000,565614785,1602346,Success,United Arab Emirates,DU UAE,Transguard Group LLC,API User,E6AEAE17361
2022-02-22 16:01,72924604,"18,770.5010","18,750.9010",20.00 AED,20.00,19.6000,0.4000,565615409,1602354,Success,United Arab Emirates,DU UAE,Transguard Group LLC,API User,E6AEAE12938
2022-02-22 16:02,72924618,"18,750.9010","18,746.7210",150.00 PKR,4.75,4.1800,0.5700,565615439,1602356,Success,Pakistan,Zong Pakistan,Transguard Group LLC,API User,ZNPKPK65621
2022-02-22 16:04,72924712,"18,746.7210","18,731.9460",15.00 AED,15.00,14.7750,0.2250,565615757,72924712,Failure,United Arab Emirates,Etisalat UAE,Transguard Group LLC,mohammed.arafath@transguardgroup.com,ETAEAE35462
2022-02-22 16:04,72924712,"18,731.9460","18,717.1710",15.00 AED,15.00,14.7750,0.2250,565615757,72924712,Failure,United Arab Emirates,Etisalat UAE,Transguard Group LLC,mohammed.arafath@transguardgroup.com,ETAEAE35462
2022-02-22 16:05,72924743,"18,746.7210","18,732.0210",15.00 AED,15.00,14.7000,0.3000,565615865,72924743,Failure,United Arab Emirates,DU UAE,Transguard Group LLC,mohammed.arafath@transguardgroup.com,E6AEAE8527
2022-02-22 16:05,72924743,"18,732.0210","18,717.3210",15.00 AED,15.00,14.7000,0.3000,565615865,72924743,Failure,United Arab Emirates,DU UAE,Transguard Group LLC,mohammed.arafath@transguardgroup.com,E6AEAE8527
2022-02-22 16:19,72925262,"18,746.7210","18,736.9210",10.00 AED,10.00,9.8000,0.2000,565617605,1602374,Success,United Arab Emirates,DU UAE,Transguard Group LLC,API User,E6AEAE22430
2022-02-22 16:19,72925272,"18,736.9210","18,732.0210",05.00 AED,5.00,4.9000,0.1000,565617620,1602376,Success,United Arab Emirates,DU UAE,Transguard Group LLC,API User,E6AEAE17361
2022-02-22 16:20,72925336,"18,732.0210","18,727.1210",05.00 AED,5.00,4.9000,0.1000,565617825,1602379,Success,United Arab Emirates,DU UAE,Transguard Group LLC,API User,E6AEAE17361
2022-02-22 16:24,72925471,"18,727.1210","18,722.2210",05.00 AED,5.00,4.9000,0.1000,565618249,1602387,Success,United Arab Emirates,DU UAE,Transguard Group LLC,API User,E6AEAE17361
2022-02-22 16:28,72925653,"18,722.2210","18,717.3210",05.00 AED,5.00,4.9000,0.1000,565618824,1602392,Success,United Arab Emirates,DU UAE,Transguard Group LLC,API User,E6AEAE17361
2022-02-22 16:30,72925769,"18,717.3210","18,708.5210",100.00 PHP,10.00,8.8000,1.2000,565619155,1602395,Success,Philippines,BS_Globe Philippines,Transguard Group LLC,API User,PH_GB_TopUp_100.00
2022-02-22 16:35,72925974,"18,708.5210","18,698.7210",10.00 AED,10.00,9.8000,0.2000,565619826,1602408,Success,United Arab Emirates,DU UAE,Transguard Group LLC,API User,E6AEAE22430
2022-02-22 16:40,72926184,"18,698.7210","18,693.7960",05.00 AED,5.00,4.9250,0.0750,565620485,72926184,Failure,United Arab Emirates,Etisalat UAE,Transguard Group LLC,mohammed.arafath@transguardgroup.com,ETAEAE54031
2022-02-22 16:40,72926184,"18,693.7960","18,688.8710",05.00 AED,5.00,4.9250,0.0750,565620485,72926184,Failure,United Arab Emirates,Etisalat UAE,Transguard Group LLC,mohammed.arafath@transguardgroup.com,ETAEAE54031
2022-02-22 16:42,72926280,"18,698.7210","18,693.8210",05.00 AED,5.00,4.9000,0.1000,565620771,1602431,Success,United Arab Emirates,DU UAE,Transguard Group LLC,API User,E6AEAE17361
2022-02-22 16:44,72926380,"18,693.8210","18,679.1210",15.00 AED,15.00,14.7000,0.3000,565621055,72926380,Success,United Arab Emirates,DU UAE,Transguard Group LLC,mohammed.arafath@transguardgroup.com,E6AEAE8527
2022-02-22 16:44,72926401,"18,679.1210","18,674.2210",05.00 AED,5.00,4.9000,0.1000,565621101,1602437,Success,United Arab Emirates,DU UAE,Transguard Group LLC,API User,E6AEAE17361
2022-02-22 16:45,72926440,"18,674.2210","18,669.3210",05.00 AED,5.00,4.9000,0.1000,565621204,1602440,Success,United Arab Emirates,DU UAE,Transguard Group LLC,API User,E6AEAE17361
2022-02-22 16:48,72926556,"18,669.3210","18,659.5210",10.00 AED,10.00,9.8000,0.2000,565621524,1602448,Success,United Arab Emirates,DU UAE,Transguard Group LLC,API User,E6AEAE22430
2022-02-22 16:49,72926607,"18,659.5210","18,654.6210",05.00 AED,5.00,4.9000,0.1000,565621639,1602451,Success,United Arab Emirates,DU UAE,Transguard Group LLC,API User,E6AEAE17361
2022-02-22 16:50,72926692,"18,654.6210","18,649.7210",05.00 AED,5.00,4.9000,0.1000,565621897,1602454,Success,United Arab Emirates,DU UAE,Transguard Group LLC,API User,E6AEAE17361
2022-02-22 16:53,72926805,"18,649.7210","18,639.9210",10.00 AED,10.00,9.8000,0.2000,565622226,1602457,Success,United Arab Emirates,DU UAE,Transguard Group LLC,API User,E6AEAE22430
2022-02-22 16:55,72926922,"18,639.9210","18,630.1210",10.00 AED,10.00,9.8000,0.2000,565622607,1602463,Success,United Arab Emirates,DU UAE,Transguard Group LLC,API User,E6AEAE22430
2022-02-22 16:57,72927006,"18,630.1210","18,626.3810",151.00 PKR,4.25,3.7400,0.5100,565622868,1602468,Success,Pakistan,Telenor Pakistan,Transguard Group LLC,API User,TPPKPK94108
2022-02-22 16:59,72927080,"18,626.3810","18,618.4610",220.00 NPR,9.00,7.9200,1.0800,565623048,1602473,Success,Nepal,Ncell Nepal,Transguard Group LLC,API User,NCNPNP79518
2022-02-22 16:59,72927091,"18,618.4610","18,608.6610",10.00 AED,10.00,9.8000,0.2000,565623104,1602476,Success,United Arab Emirates,DU UAE,Transguard Group LLC,API User,E6AEAE22430
2022-02-22 17:03,72927300,"18,608.6610","18,603.7610",05.00 AED,5.00,4.9000,0.1000,565623734,1602485,Success,United Arab Emirates,DU UAE,Transguard Group LLC,API User,E6AEAE17361
2022-02-22 17:04,72927362,"18,603.7610","18,593.9610",10.00 AED,10.00,9.8000,0.2000,565623902,1602489,Success,United Arab Emirates,DU UAE,Transguard Group LLC,API User,E6AEAE22430
2022-02-22 17:06,72927434,"18,593.9610","18,589.0610",05.00 AED,5.00,4.9000,0.1000,565624116,1602495,Success,United Arab Emirates,DU UAE,Transguard Group LLC,API User,E6AEAE17361
2022-02-22 17:08,72927590,"18,589.0610","18,564.5610",25.00 AED,25.00,24.5000,0.5000,565624543,1602498,Success,United Arab Emirates,DU UAE,Transguard Group LLC,API User,E6AEAE17343
2022-02-22 17:09,72927621,"18,564.5610","18,544.9610",20.00 AED,20.00,19.6000,0.4000,565624647,1602503,Success,United Arab Emirates,DU UAE,Transguard Group LLC,API User,E6AEAE12938
2022-02-22 17:15,72927956,"18,544.9610","18,535.1610",10.00 AED,10.00,9.8000,0.2000,565625589,1602512,Success,United Arab Emirates,DU UAE,Transguard Group LLC,API User,E6AEAE22430
2022-02-22 17:15,72927958,"18,535.1610","18,525.3610",10.00 AED,10.00,9.8000,0.2000,565625591,1602513,Success,United Arab Emirates,DU UAE,Transguard Group LLC,API User,E6AEAE22430
2022-02-22 17:18,72928125,"18,525.3610","18,520.4610",05.00 AED,5.00,4.9000,0.1000,565626024,1602519,Success,United Arab Emirates,DU UAE,Transguard Group LLC,API User,E6AEAE17361
2022-02-22 17:23,72928432,"18,520.4610","18,515.5610",05.00 AED,5.00,4.9000,0.1000,565626853,1602522,Success,United Arab Emirates,DU UAE,Transguard Group LLC,API User,E6AEAE17361
2022-02-22 17:24,72928495,"18,515.5610","18,495.9610",20.00 AED,20.00,19.6000,0.4000,565627017,1602525,Success,United Arab Emirates,DU UAE,Transguard Group LLC,API User,E6AEAE12938
2022-02-22 17:28,72928670,"18,495.9610","18,491.0610",05.00 AED,5.00,4.9000,0.1000,565627500,1602535,Success,United Arab Emirates,DU UAE,Transguard Group LLC,API User,E6AEAE17361
2022-02-22 17:29,72928741,"18,491.0610","18,481.2610",10.00 AED,10.00,9.8000,0.2000,565627691,1602541,Success,United Arab Emirates,DU UAE,Transguard Group LLC,API User,E6AEAE22430
2022-02-22 17:30,72928827,"18,481.2610","18,446.9610",35.00 AED,35.00,34.3000,0.7000,565627943,1602545,Success,United Arab Emirates,DU UAE,Transguard Group LLC,API User,E6AEAE73954
2022-02-22 17:31,72928875,"18,446.9610","18,402.8610",45.00 AED,45.00,44.1000,0.9000,565628096,1602549,Success,United Arab Emirates,DU UAE,Transguard Group LLC,API User,E6AEAE35243
2022-02-22 17:32,72928933,"18,402.8610","18,393.0610",10.00 AED,10.00,9.8000,0.2000,565628247,1602553,Success,United Arab Emirates,DU UAE,Transguard Group LLC,API User,E6AEAE22430
2022-02-22 17:34,72929012,"18,393.0610","18,383.2610",10.00 AED,10.00,9.8000,0.2000,565628440,1602557,Success,United Arab Emirates,DU UAE,Transguard Group LLC,API User,E6AEAE22430
2022-02-22 17:34,72929032,"18,383.2610","18,373.4610",10.00 AED,10.00,9.8000,0.2000,565628486,1602559,Success,United Arab Emirates,DU UAE,Transguard Group LLC,API User,E6AEAE22430
2022-02-22 17:35,72929076,"18,373.4610","18,363.6610",10.00 AED,10.00,9.8000,0.2000,565628633,1602564,Success,United Arab Emirates,DU UAE,Transguard Group LLC,API User,E6AEAE22430
2022-02-22 17:36,72929148,"18,363.6610","18,358.7610",05.00 AED,5.00,4.9000,0.1000,565628802,1602567,Success,United Arab Emirates,DU UAE,Transguard Group LLC,API User,E6AEAE17361
2022-02-22 17:39,72929352,"18,358.7610","18,348.9610",10.00 AED,10.00,9.8000,0.2000,565629336,1602574,Success,United Arab Emirates,DU UAE,Transguard Group LLC,API User,E6AEAE22430
2022-02-22 17:44,72929614,"18,348.9610","18,344.0610",05.00 AED,5.00,4.9000,0.1000,565630104,1602584,Success,United Arab Emirates,DU UAE,Transguard Group LLC,API User,E6AEAE17361
2022-02-22 17:46,72929726,"18,344.0610","18,334.2610",10.00 AED,10.00,9.8000,0.2000,565630388,1602591,Success,United Arab Emirates,DU UAE,Transguard Group LLC,API User,E6AEAE22430
2022-02-22 17:46,72929774,"18,334.2610","18,309.8410",899.00 PKR,27.75,24.4200,3.3300,565630521,1602594,Success,Pakistan,Zong Pakistan,Transguard Group LLC,API User,ZNPKPK48367
2022-02-22 17:51,72930040,"18,309.8410","18,300.0410",10.00 AED,10.00,9.8000,0.2000,565631287,1602598,Success,United Arab Emirates,DU UAE,Transguard Group LLC,API User,E6AEAE22430
2022-02-22 17:56,72930322,"18,300.0410","18,290.2410",10.00 AED,10.00,9.8000,0.2000,565632125,1602609,Success,United Arab Emirates,DU UAE,Transguard Group LLC,API User,E6AEAE22430
2022-02-22 17:56,72930338,"18,290.2410","18,280.4410",10.00 AED,10.00,9.8000,0.2000,565632165,1602610,Success,United Arab Emirates,DU UAE,Transguard Group LLC,API User,E6AEAE22430
2022-02-22 17:57,72930414,"18,280.4410","18,275.5410",05.00 AED,5.00,4.9000,0.1000,565632330,1602615,Success,United Arab Emirates,DU UAE,Transguard Group LLC,API User,E6AEAE17361
2022-02-22 17:57,72930454,"18,275.5410","18,270.6410",05.00 AED,5.00,4.9000,0.1000,565632434,1602618,Success,United Arab Emirates,DU UAE,Transguard Group LLC,API User,E6AEAE17361
2022-02-22 17:59,72930548,"18,270.6410","18,265.7410",05.00 AED,5.00,4.9000,0.1000,565632700,1602624,Success,United Arab Emirates,DU UAE,Transguard Group LLC,API User,E6AEAE17361
2022-02-22 18:01,72930659,"18,265.7410","18,260.8410",05.00 AED,5.00,4.9000,0.1000,565633024,1602631,Success,United Arab Emirates,DU UAE,Transguard Group LLC,API User,E6AEAE17361
2022-02-22 18:01,72930677,"18,260.8410","18,251.0410",10.00 AED,10.00,9.8000,0.2000,565633070,1602634,Success,United Arab Emirates,DU UAE,Transguard Group LLC,API User,E6AEAE22430
2022-02-22 18:02,72930722,"18,251.0410","18,241.2410",10.00 AED,10.00,9.8000,0.2000,565633226,1602638,Success,United Arab Emirates,DU UAE,Transguard Group LLC,API User,E6AEAE22430
2022-02-22 18:02,72930750,"18,241.2410","18,202.0410",40.00 AED,40.00,39.2000,0.8000,565633306,1602640,Success,United Arab Emirates,DU UAE,Transguard Group LLC,API User,E6AEAE64011
2022-02-22 18:03,72930771,"18,202.0410","18,197.1410",05.00 AED,5.00,4.9000,0.1000,565633371,1602644,Success,United Arab Emirates,DU UAE,Transguard Group LLC,API User,E6AEAE17361
2022-02-22 18:03,72930799,"18,197.1410","18,177.5410",20.00 AED,20.00,19.6000,0.4000,565633450,1602649,Success,United Arab Emirates,DU UAE,Transguard Group LLC,API User,E6AEAE12938
2022-02-22 18:05,72930875,"18,177.5410","18,172.6410",05.00 AED,5.00,4.9000,0.1000,565633660,1602656,Success,United Arab Emirates,DU UAE,Transguard Group LLC,API User,E6AEAE17361
2022-02-22 18:17,72931714,"18,172.6410","18,162.8410",10.00 AED,10.00,9.8000,0.2000,565635921,1602670,Success,United Arab Emirates,DU UAE,Transguard Group LLC,API User,E6AEAE22430
2022-02-22 18:19,72931880,"18,162.8410","18,153.0410",10.00 AED,10.00,9.8000,0.2000,565636312,1602677,Success,United Arab Emirates,DU UAE,Transguard Group LLC,API User,E6AEAE22430
2022-02-22 18:20,72931915,"18,153.0410","18,148.1410",05.00 AED,5.00,4.9000,0.1000,565636417,1602681,Success,United Arab Emirates,DU UAE,Transguard Group LLC,API User,E6AEAE17361
2022-02-22 18:30,72932620,"18,148.1410","18,138.3410",10.00 AED,10.00,9.8000,0.2000,565638333,1602694,Success,United Arab Emirates,DU UAE,Transguard Group LLC,API User,E6AEAE22430
2022-02-22 18:33,72932813,"18,138.3410","18,133.4410",05.00 AED,5.00,4.9000,0.1000,565638817,1602704,Success,United Arab Emirates,DU UAE,Transguard Group LLC,API User,E6AEAE17361
2022-02-22 18:33,72932842,"18,133.4410","18,104.0410",30.00 AED,30.00,29.4000,0.6000,565638900,1602706,Success,United Arab Emirates,DU UAE,Transguard Group LLC,API User,E6AEAE46146
2022-02-22 18:34,72932916,"18,104.0410","18,084.4410",20.00 AED,20.00,19.6000,0.4000,565639071,1602711,Success,United Arab Emirates,DU UAE,Transguard Group LLC,API User,E6AEAE12938
2022-02-22 18:34,72932948,"18,084.4410","18,074.6410",10.00 AED,10.00,9.8000,0.2000,565639157,1602714,Success,United Arab Emirates,DU UAE,Transguard Group LLC,API User,E6AEAE22430
2022-02-22 18:43,72933517,"18,074.6410","18,064.8410",10.00 AED,10.00,9.8000,0.2000,565640766,1602728,Success,United Arab Emirates,DU UAE,Transguard Group LLC,API User,E6AEAE22430
2022-02-22 18:43,72933527,"18,064.8410","18,059.9410",05.00 AED,5.00,4.9000,0.1000,565640787,1602729,Success,United Arab Emirates,DU UAE,Transguard Group LLC,API User,E6AEAE17361
2022-02-22 18:43,72933587,"18,059.9410","18,055.0410",05.00 AED,5.00,4.9000,0.1000,565640915,1602735,Success,United Arab Emirates,DU UAE,Transguard Group LLC,API User,E6AEAE17361
2022-02-22 18:45,72933693,"18,055.0410","18,050.1410",05.00 AED,5.00,4.9000,0.1000,565641239,1602741,Success,United Arab Emirates,DU UAE,Transguard Group LLC,API User,E6AEAE17361
2022-02-22 18:45,72933748,"18,050.1410","18,045.2410",05.00 AED,5.00,4.9000,0.1000,565641369,1602745,Success,United Arab Emirates,DU UAE,Transguard Group LLC,API User,E6AEAE17361
2022-02-22 18:48,72933936,"18,045.2410","18,040.3410",05.00 AED,5.00,4.9000,0.1000,565641875,1602750,Success,United Arab Emirates,DU UAE,Transguard Group LLC,API User,E6AEAE17361
2022-02-22 18:48,72933951,"18,040.3410","18,030.5410",10.00 AED,10.00,9.8000,0.2000,565641904,1602751,Success,United Arab Emirates,DU UAE,Transguard Group LLC,API User,E6AEAE22430
2022-02-22 18:51,72934143,"18,030.5410","18,025.6410",05.00 AED,5.00,4.9000,0.1000,565642406,1602763,Success,United Arab Emirates,DU UAE,Transguard Group LLC,API User,E6AEAE17361
2022-02-22 18:51,72934193,"18,025.6410","18,021.4610",150.00 PKR,4.75,4.1800,0.5700,565642521,1602767,Success,Pakistan,Zong Pakistan,Transguard Group LLC,API User,ZNPKPK65621
2022-02-22 18:52,72934266,"18,021.4610","18,011.6610",10.00 AED,10.00,9.8000,0.2000,565642684,1602770,Success,United Arab Emirates,DU UAE,Transguard Group LLC,API User,E6AEAE22430
2022-02-22 18:53,72934325,"18,011.6610","18,001.8610",10.00 AED,10.00,9.8000,0.2000,565642845,1602776,Success,United Arab Emirates,DU UAE,Transguard Group LLC,API User,E6AEAE22430
2022-02-22 18:53,72934342,"18,001.8610","17,992.0610",10.00 AED,10.00,9.8000,0.2000,565642891,1602778,Success,United Arab Emirates,DU UAE,Transguard Group LLC,API User,E6AEAE22430
2022-02-22 18:53,72934352,"17,992.0610","17,979.3010",350.00 NPR,14.50,12.7600,1.7400,565642921,1602780,Success,Nepal,Ncell Nepal,Transguard Group LLC,API User,NCNPNP22699
2022-02-22 18:54,72934439,"17,979.3010","17,974.4010",05.00 AED,5.00,4.9000,0.1000,565643149,1602788,Success,United Arab Emirates,DU UAE,Transguard Group LLC,API User,E6AEAE17361
2022-02-22 18:59,72934825,"17,974.4010","17,969.5010",05.00 AED,5.00,4.9000,0.1000,565644145,1602801,Success,United Arab Emirates,DU UAE,Transguard Group LLC,API User,E6AEAE17361
2022-02-22 19:00,72934887,"17,969.5010","17,964.6010",05.00 AED,5.00,4.9000,0.1000,565644321,1602806,Success,United Arab Emirates,DU UAE,Transguard Group LLC,API User,E6AEAE17361
2022-02-22 19:00,72934947,"17,964.6010","17,954.8010",10.00 AED,10.00,9.8000,0.2000,565644441,1602811,Success,United Arab Emirates,DU UAE,Transguard Group LLC,API User,E6AEAE22430
2022-02-22 19:01,72934990,"17,954.8010","17,949.9010",05.00 AED,5.00,4.9000,0.1000,565644575,1602817,Success,United Arab Emirates,DU UAE,Transguard Group LLC,API User,E6AEAE17361
2022-02-22 19:01,72935002,"17,949.9010","17,930.3010",20.00 AED,20.00,19.6000,0.4000,565644594,1602818,Success,United Arab Emirates,DU UAE,Transguard Group LLC,API User,E6AEAE12938
2022-02-22 19:01,72935013,"17,930.3010","17,910.7010",20.00 AED,20.00,19.6000,0.4000,565644625,1602819,Success,United Arab Emirates,DU UAE,Transguard Group LLC,API User,E6AEAE12938
2022-02-22 19:05,72935331,"17,910.7010","17,901.9010",315.00 PKR,10.00,8.8000,1.2000,565645441,1602822,Success,Pakistan,Telenor Pakistan,Transguard Group LLC,API User,TPPKPK75105
2022-02-22 19:10,72935700,"17,901.9010","17,892.1010",10.00 AED,10.00,9.8000,0.2000,565646444,1602831,Success,United Arab Emirates,DU UAE,Transguard Group LLC,API User,E6AEAE22430
2022-02-22 19:11,72935807,"17,892.1010","17,875.8210",200.00 PHP,18.50,16.2800,2.2200,565646712,1602837,Success,Philippines,Smart (SunCellular) Philippines,Transguard Group LLC,API User,PH_SM_TopUp_200.00
2022-02-22 19:11,72935832,"17,875.8210","17,870.9210",05.00 AED,5.00,4.9000,0.1000,565646779,1602839,Success,United Arab Emirates,DU UAE,Transguard Group LLC,API User,E6AEAE17361
2022-02-22 19:12,72935915,"17,870.9210","17,866.7410",50.00 PHP,4.75,4.1800,0.5700,565646972,1602844,Success,Philippines,Smart (SunCellular) Philippines,Transguard Group LLC,API User,PH_SM_TopUp_50.00
2022-02-22 19:13,72935945,"17,866.7410","17,861.8410",05.00 AED,5.00,4.9000,0.1000,565647058,1602845,Success,United Arab Emirates,DU UAE,Transguard Group LLC,API User,E6AEAE17361
2022-02-22 19:16,72936215,"17,861.8410","17,852.0410",10.00 AED,10.00,9.8000,0.2000,565647782,1602849,Success,United Arab Emirates,DU UAE,Transguard Group LLC,API User,E6AEAE22430
2022-02-22 19:17,72936287,"17,852.0410","17,847.1410",05.00 AED,5.00,4.9000,0.1000,565647992,1602853,Success,United Arab Emirates,DU UAE,Transguard Group LLC,API User,E6AEAE17361
2022-02-22 19:20,72936505,"17,847.1410","17,837.3410",10.00 AED,10.00,9.8000,0.2000,565648595,1602860,Success,United Arab Emirates,DU UAE,Transguard Group LLC,API User,E6AEAE22430
2022-02-22 19:20,72936548,"17,837.3410","17,827.5410",10.00 AED,10.00,9.8000,0.2000,565648744,1602861,Success,United Arab Emirates,DU UAE,Transguard Group LLC,API User,E6AEAE22430
2022-02-22 19:22,72936690,"17,827.5410","17,793.2410",35.00 AED,35.00,34.3000,0.7000,565649131,1602867,Success,United Arab Emirates,DU UAE,Transguard Group LLC,API User,E6AEAE73954
2022-02-22 19:23,72936725,"17,793.2410","17,788.3410",05.00 AED,5.00,4.9000,0.1000,565649234,1602871,Success,United Arab Emirates,DU UAE,Transguard Group LLC,API User,E6AEAE17361
2022-02-22 19:23,72936774,"17,788.3410","17,778.5410",10.00 AED,10.00,9.8000,0.2000,565649397,1602877,Success,United Arab Emirates,DU UAE,Transguard Group LLC,API User,E6AEAE22430
2022-02-22 19:24,72936857,"17,778.5410","17,773.6410",05.00 AED,5.00,4.9000,0.1000,565649593,1602883,Success,United Arab Emirates,DU UAE,Transguard Group LLC,API User,E6AEAE17361
2022-02-22 19:25,72936887,"17,773.6410","17,768.7410",05.00 AED,5.00,4.9000,0.1000,565649688,1602885,Success,United Arab Emirates,DU UAE,Transguard Group LLC,API User,E6AEAE17361
2022-02-22 19:28,72937202,"17,768.7410","17,763.8410",05.00 AED,5.00,4.9000,0.1000,565650458,1602890,Success,United Arab Emirates,DU UAE,Transguard Group LLC,API User,E6AEAE17361
2022-02-22 19:35,72937737,"17,763.8410","17,758.9410",05.00 AED,5.00,4.9000,0.1000,565651912,1602899,Success,United Arab Emirates,DU UAE,Transguard Group LLC,API User,E6AEAE17361
2022-02-22 19:35,72937768,"17,758.9410","17,754.0410",05.00 AED,5.00,4.9000,0.1000,565651987,1602900,Success,United Arab Emirates,DU UAE,Transguard Group LLC,API User,E6AEAE17361
2022-02-22 19:37,72937953,"17,754.0410","17,749.1410",05.00 AED,5.00,4.9000,0.1000,565652477,1602905,Success,United Arab Emirates,DU UAE,Transguard Group LLC,API User,E6AEAE17361
2022-02-22 19:38,72938009,"17,749.1410","17,739.3410",10.00 AED,10.00,9.8000,0.2000,565652603,1602909,Success,United Arab Emirates,DU UAE,Transguard Group LLC,API User,E6AEAE22430
2022-02-22 19:38,72938073,"17,739.3410","17,734.4410",05.00 AED,5.00,4.9000,0.1000,565652789,1602914,Success,United Arab Emirates,DU UAE,Transguard Group LLC,API User,E6AEAE17361
2022-02-22 19:40,72938174,"17,734.4410","17,724.6410",10.00 AED,10.00,9.8000,0.2000,565653068,1602918,Success,United Arab Emirates,DU UAE,Transguard Group LLC,API User,E6AEAE22430
2022-02-22 19:40,72938180,"17,724.6410","17,719.7410",05.00 AED,5.00,4.9000,0.1000,565653070,1602919,Success,United Arab Emirates,DU UAE,Transguard Group LLC,API User,E6AEAE17361
2022-02-22 19:41,72938307,"17,719.7410","17,700.1410",20.00 AED,20.00,19.6000,0.4000,565653374,1602925,Success,United Arab Emirates,DU UAE,Transguard Group LLC,API User,E6AEAE12938
2022-02-22 19:42,72938347,"17,700.1410","17,690.3410",10.00 AED,10.00,9.8000,0.2000,565653482,1602930,Success,United Arab Emirates,DU UAE,Transguard Group LLC,API User,E6AEAE22430
2022-02-22 19:42,72938396,"17,690.3410","17,685.4410",05.00 AED,5.00,4.9000,0.1000,565653607,1602934,Success,United Arab Emirates,DU UAE,Transguard Group LLC,API User,E6AEAE17361
2022-02-22 19:42,72938419,"17,685.4410","17,680.5410",05.00 AED,5.00,4.9000,0.1000,565653676,1602938,Success,United Arab Emirates,DU UAE,Transguard Group LLC,API User,E6AEAE17361
2022-02-22 19:43,72938508,"17,680.5410","17,675.6410",05.00 AED,5.00,4.9000,0.1000,565653874,1602948,Success,United Arab Emirates,DU UAE,Transguard Group LLC,API User,E6AEAE17361
2022-02-22 19:43,72938520,"17,675.6410","17,670.7410",05.00 AED,5.00,4.9000,0.1000,565653906,1602952,Success,United Arab Emirates,DU UAE,Transguard Group LLC,API User,E6AEAE17361
2022-02-22 19:44,72938577,"17,670.7410","17,660.9410",10.00 AED,10.00,9.8000,0.2000,565654036,1602956,Success,United Arab Emirates,DU UAE,Transguard Group LLC,API User,E6AEAE22430
2022-02-22 19:44,72938590,"17,660.9410","17,656.0410",05.00 AED,5.00,4.9000,0.1000,565654066,1602957,Success,United Arab Emirates,DU UAE,Transguard Group LLC,API User,E6AEAE17361
2022-02-22 19:45,72938672,"17,656.0410","17,646.2410",10.00 AED,10.00,9.8000,0.2000,565654280,1602965,Success,United Arab Emirates,DU UAE,Transguard Group LLC,API User,E6AEAE22430
2022-02-22 19:46,72938775,"17,646.2410","17,641.3410",05.00 AED,5.00,4.9000,0.1000,565654512,1602969,Success,United Arab Emirates,DU UAE,Transguard Group LLC,API User,E6AEAE17361
2022-02-22 19:47,72938904,"17,641.3410","17,636.4410",05.00 AED,5.00,4.9000,0.1000,565654872,1602974,Success,United Arab Emirates,DU UAE,Transguard Group LLC,API User,E6AEAE17361
2022-02-22 19:50,72939145,"17,636.4410","17,626.6410",10.00 AED,10.00,9.8000,0.2000,565655538,1602983,Success,United Arab Emirates,DU UAE,Transguard Group LLC,API User,E6AEAE22430
2022-02-22 19:52,72939281,"17,626.6410","17,616.8410",10.00 AED,10.00,9.8000,0.2000,565655861,1602987,Success,United Arab Emirates,DU UAE,Transguard Group LLC,API User,E6AEAE22430
2022-02-22 19:52,72939315,"17,616.8410","17,611.9410",05.00 AED,5.00,4.9000,0.1000,565655936,1602993,Success,United Arab Emirates,DU UAE,Transguard Group LLC,API User,E6AEAE17361
2022-02-22 19:52,72939320,"17,611.9410","17,607.0410",05.00 AED,5.00,4.9000,0.1000,565655945,1602994,Success,United Arab Emirates,DU UAE,Transguard Group LLC,API User,E6AEAE17361
2022-02-22 19:52,72939323,"17,607.0410","17,597.2410",10.00 AED,10.00,9.8000,0.2000,565655953,1602995,Success,United Arab Emirates,DU UAE,Transguard Group LLC,API User,E6AEAE22430
2022-02-22 19:54,72939485,"17,597.2410","17,593.0610",150.00 PKR,4.75,4.1800,0.5700,565656370,1603003,Success,Pakistan,Jazz Pakistan,Transguard Group LLC,API User,MBPKPK20699
2022-02-22 19:54,72939528,"17,593.0610","17,583.2610",10.00 AED,10.00,9.8000,0.2000,565656489,1603006,Success,United Arab Emirates,DU UAE,Transguard Group LLC,API User,E6AEAE22430
2022-02-22 19:55,72939538,"17,583.2610","17,568.5610",15.00 AED,15.00,14.7000,0.3000,565656509,1603007,Success,United Arab Emirates,DU UAE,Transguard Group LLC,API User,E6AEAE8527
2022-02-22 19:56,72939662,"17,568.5610","17,563.6610",05.00 AED,5.00,4.9000,0.1000,565656841,1603013,Success,United Arab Emirates,DU UAE,Transguard Group LLC,API User,E6AEAE17361
2022-02-22 19:57,72939710,"17,563.6610","17,555.3010",100.00 PHP,9.50,8.3600,1.1400,565656975,1603017,Success,Philippines,Smart (SunCellular) Philippines,Transguard Group LLC,API User,PH_SM_TopUp_100.00
2022-02-22 19:59,72939861,"17,555.3010","17,550.4010",05.00 AED,5.00,4.9000,0.1000,565657403,1603023,Success,United Arab Emirates,DU UAE,Transguard Group LLC,API User,E6AEAE17361
2022-02-22 19:59,72939922,"17,550.4010","17,545.5010",05.00 AED,5.00,4.9000,0.1000,565657547,1603026,Success,United Arab Emirates,DU UAE,Transguard Group LLC,API User,E6AEAE17361
2022-02-22 20:03,72940199,"17,545.5010","17,540.6010",05.00 AED,5.00,4.9000,0.1000,565658316,1603037,Success,United Arab Emirates,DU UAE,Transguard Group LLC,API User,E6AEAE17361
2022-02-22 20:03,72940211,"17,540.6010","17,535.7010",05.00 AED,5.00,4.9000,0.1000,565658352,1603038,Success,United Arab Emirates,DU UAE,Transguard Group LLC,API User,E6AEAE17361
2022-02-22 20:04,72940267,"17,535.7010","17,530.8010",05.00 AED,5.00,4.9000,0.1000,565658533,1603043,Success,United Arab Emirates,DU UAE,Transguard Group LLC,API User,E6AEAE17361
2022-02-22 20:04,72940278,"17,530.8010","17,525.9010",05.00 AED,5.00,4.9000,0.1000,565658568,1603044,Success,United Arab Emirates,DU UAE,Transguard Group LLC,API User,E6AEAE17361
2022-02-22 20:06,72940438,"17,525.9010","17,517.5410",300.00 PKR,9.50,8.3600,1.1400,565659025,1603052,Success,Pakistan,Jazz Pakistan,Transguard Group LLC,API User,PK_MB_TopUp_300.00
2022-02-22 20:07,72940574,"17,517.5410","17,512.6410",05.00 AED,5.00,4.9000,0.1000,565659384,1603058,Success,United Arab Emirates,DU UAE,Transguard Group LLC,API User,E6AEAE17361
2022-02-22 20:08,72940617,"17,512.6410","17,502.8410",10.00 AED,10.00,9.8000,0.2000,565659486,1603060,Success,United Arab Emirates,DU UAE,Transguard Group LLC,API User,E6AEAE22430
2022-02-22 20:10,72940792,"17,502.8410","17,498.6610",01.00 USD,4.75,4.1800,0.5700,565659878,1603065,Success,Gambia,QCell Gambia,Transguard Group LLC,API User,QLGMGM48501
2022-02-22 20:12,72940972,"17,498.6610","17,493.7610",05.00 AED,5.00,4.9000,0.1000,565660508,1603073,Success,United Arab Emirates,DU UAE,Transguard Group LLC,API User,E6AEAE17361
2022-02-22 20:13,72940980,"17,493.7610","17,489.5810",01.00 USD,4.75,4.1800,0.5700,565660537,1603074,Success,Gambia,QCell Gambia,Transguard Group LLC,API User,QLGMGM48501
2022-02-22 20:13,72941035,"17,489.5810","17,479.7810",10.00 AED,10.00,9.8000,0.2000,565660704,1603077,Success,United Arab Emirates,DU UAE,Transguard Group LLC,API User,E6AEAE22430
2022-02-22 20:16,72941230,"17,479.7810","17,469.9810",10.00 AED,10.00,9.8000,0.2000,565661271,1603084,Success,United Arab Emirates,DU UAE,Transguard Group LLC,API User,E6AEAE22430
2022-02-22 20:16,72941287,"17,469.9810","17,465.0810",05.00 AED,5.00,4.9000,0.1000,565661436,1603087,Failure,United Arab Emirates,DU UAE,Transguard Group LLC,API User,E6AEAE17361
2022-02-22 20:16,72941287,"17,465.0810","17,460.1810",05.00 AED,5.00,4.9000,0.1000,565661436,1603087,Failure,United Arab Emirates,DU UAE,Transguard Group LLC,API User,E6AEAE17361
2022-02-22 20:17,72941335,"17,469.9810","17,465.0810",05.00 AED,5.00,4.9000,0.1000,565661558,1603091,Success,United Arab Emirates,DU UAE,Transguard Group LLC,API User,E6AEAE17361
2022-02-22 20:20,72941587,"17,465.0810","17,455.2810",10.00 AED,10.00,9.8000,0.2000,565662293,1603101,Success,United Arab Emirates,DU UAE,Transguard Group LLC,API User,E6AEAE22430
2022-02-22 20:20,72941605,"17,455.2810","17,445.4810",10.00 AED,10.00,9.8000,0.2000,565662349,1603103,Success,United Arab Emirates,DU UAE,Transguard Group LLC,API User,E6AEAE22430
2022-02-22 20:21,72941628,"17,445.4810","17,441.7410",130.00 PKR,4.25,3.7400,0.5100,565662430,1603106,Success,Pakistan,Telenor Pakistan,Transguard Group LLC,API User,TPPKPK26966
2022-02-22 20:21,72941642,"17,441.7410","17,436.8410",05.00 AED,5.00,4.9000,0.1000,565662444,1603107,Success,United Arab Emirates,DU UAE,Transguard Group LLC,API User,E6AEAE17361
2022-02-22 20:21,72941672,"17,436.8410","17,431.9410",05.00 AED,5.00,4.9000,0.1000,565662531,1603110,Success,United Arab Emirates,DU UAE,Transguard Group LLC,API User,E6AEAE17361
2022-02-22 20:22,72941768,"17,431.9410","17,423.1410","7,350.82 UGX",10.00,8.8000,1.2000,565662777,1603115,Success,Uganda,MTN Uganda,Transguard Group LLC,API User,UG_MT_TopUp
2022-02-22 20:24,72941970,"17,423.1410","17,403.5410",20.00 AED,20.00,19.6000,0.4000,565663259,1603120,Success,United Arab Emirates,DU UAE,Transguard Group LLC,API User,E6AEAE12938
2022-02-22 20:26,72942104,"17,403.5410","17,398.6410",05.00 AED,5.00,4.9000,0.1000,565663662,1603128,Success,United Arab Emirates,DU UAE,Transguard Group LLC,API User,E6AEAE17361
2022-02-22 20:33,72942630,"17,398.6410","17,393.7410",05.00 AED,5.00,4.9000,0.1000,565665170,1603131,Success,United Arab Emirates,DU UAE,Transguard Group LLC,API User,E6AEAE17361
2022-02-22 20:33,72942647,"17,393.7410","17,388.8410",05.00 AED,5.00,4.9000,0.1000,565665214,1603134,Success,United Arab Emirates,DU UAE,Transguard Group LLC,API User,E6AEAE17361
2022-02-22 20:34,72942661,"17,388.8410","17,379.0410",10.00 AED,10.00,9.8000,0.2000,565665278,1603138,Success,United Arab Emirates,DU UAE,Transguard Group LLC,API User,E6AEAE22430
2022-02-22 20:35,72942742,"17,379.0410","17,369.2410",10.00 AED,10.00,9.8000,0.2000,565665533,1603142,Success,United Arab Emirates,DU UAE,Transguard Group LLC,API User,E6AEAE22430
2022-02-22 20:36,72942851,"17,369.2410","17,359.4410",10.00 AED,10.00,9.8000,0.2000,565665836,1603146,Success,United Arab Emirates,DU UAE,Transguard Group LLC,API User,E6AEAE22430
2022-02-22 20:38,72942999,"17,359.4410","17,354.5410",05.00 AED,5.00,4.9000,0.1000,565666255,1603153,Success,United Arab Emirates,DU UAE,Transguard Group LLC,API User,E6AEAE17361
2022-02-22 20:41,72943216,"17,354.5410","17,344.7410",10.00 AED,10.00,9.8000,0.2000,565666844,1603158,Success,United Arab Emirates,DU UAE,Transguard Group LLC,API User,E6AEAE22430
2022-02-22 20:45,72943523,"17,344.7410","17,339.8410",05.00 AED,5.00,4.9000,0.1000,565667623,1603168,Success,United Arab Emirates,DU UAE,Transguard Group LLC,API User,E6AEAE17361
2022-02-22 20:45,72943534,"17,339.8410","17,334.9410",05.00 AED,5.00,4.9000,0.1000,565667648,1603169,Success,United Arab Emirates,DU UAE,Transguard Group LLC,API User,E6AEAE17361
2022-02-22 20:46,72943629,"17,334.9410","17,330.0410",05.00 AED,5.00,4.9000,0.1000,565667940,1603178,Success,United Arab Emirates,DU UAE,Transguard Group LLC,API User,E6AEAE17361
2022-02-22 20:46,72943635,"17,330.0410","17,325.1410",05.00 AED,5.00,4.9000,0.1000,565667952,1603179,Success,United Arab Emirates,DU UAE,Transguard Group LLC,API User,E6AEAE17361
2022-02-22 20:46,72943641,"17,325.1410","17,320.2410",05.00 AED,5.00,4.9000,0.1000,565667971,1603180,Success,United Arab Emirates,DU UAE,Transguard Group LLC,API User,E6AEAE17361
2022-02-22 20:52,72944061,"17,320.2410","17,315.3410",05.00 AED,5.00,4.9000,0.1000,565669271,1603188,Success,United Arab Emirates,DU UAE,Transguard Group LLC,API User,E6AEAE17361
2022-02-22 20:54,72944143,"17,315.3410","17,299.2810",575.00 PKR,18.25,16.0600,2.1900,565669563,1603192,Success,Pakistan,Telenor Pakistan,Transguard Group LLC,API User,TPPKPK7947
2022-02-22 20:54,72944198,"17,299.2810","17,294.3810",05.00 AED,5.00,4.9000,0.1000,565669719,1603195,Success,United Arab Emirates,DU UAE,Transguard Group LLC,API User,E6AEAE17361
2022-02-22 20:55,72944274,"17,294.3810","17,284.5810",10.00 AED,10.00,9.8000,0.2000,565669965,1603203,Success,United Arab Emirates,DU UAE,Transguard Group LLC,API User,E6AEAE22430
2022-02-22 20:56,72944314,"17,284.5810","17,274.7810",10.00 AED,10.00,9.8000,0.2000,565670088,1603205,Success,United Arab Emirates,DU UAE,Transguard Group LLC,API User,E6AEAE22430
2022-02-22 20:56,72944345,"17,274.7810","17,269.8810",05.00 AED,5.00,4.9000,0.1000,565670180,1603209,Success,United Arab Emirates,DU UAE,Transguard Group LLC,API User,E6AEAE17361
2022-02-22 20:58,72944475,"17,269.8810","17,264.9810",05.00 AED,5.00,4.9000,0.1000,565670538,1603218,Success,United Arab Emirates,DU UAE,Transguard Group LLC,API User,E6AEAE17361
2022-02-22 21:01,72944679,"17,264.9810","17,255.1810",10.00 AED,10.00,9.8000,0.2000,565671171,1603228,Success,United Arab Emirates,DU UAE,Transguard Group LLC,API User,E6AEAE22430
2022-02-22 21:02,72944748,"17,255.1810","17,251.0010",150.00 PKR,4.75,4.1800,0.5700,565671386,1603232,Success,Pakistan,Jazz Pakistan,Transguard Group LLC,API User,MBPKPK20699
2022-02-22 21:04,72944889,"17,251.0010","17,246.1010",05.00 AED,5.00,4.9000,0.1000,565671757,1603237,Success,United Arab Emirates,DU UAE,Transguard Group LLC,API User,E6AEAE17361
2022-02-22 21:05,72944948,"17,246.1010","17,241.9210",150.00 PKR,4.75,4.1800,0.5700,565671982,1603241,Success,Pakistan,Jazz Pakistan,Transguard Group LLC,API User,MBPKPK20699
2022-02-22 21:05,72944987,"17,241.9210","17,237.0210",05.00 AED,5.00,4.9000,0.1000,565672080,1603245,Success,United Arab Emirates,DU UAE,Transguard Group LLC,API User,E6AEAE17361
2022-02-22 21:05,72945012,"17,237.0210","17,232.1210",05.00 AED,5.00,4.9000,0.1000,565672154,1603248,Success,United Arab Emirates,DU UAE,Transguard Group LLC,API User,E6AEAE17361
2022-02-22 21:06,72945023,"17,232.1210","17,227.2210",05.00 AED,5.00,4.9000,0.1000,565672185,1603249,Success,United Arab Emirates,DU UAE,Transguard Group LLC,API User,E6AEAE17361
2022-02-22 21:07,72945128,"17,227.2210","17,217.4210",10.00 AED,10.00,9.8000,0.2000,565672512,1603254,Success,United Arab Emirates,DU UAE,Transguard Group LLC,API User,E6AEAE22430
2022-02-22 21:09,72945254,"17,217.4210","17,212.5210",05.00 AED,5.00,4.9000,0.1000,565672859,1603261,Success,United Arab Emirates,DU UAE,Transguard Group LLC,API User,E6AEAE17361
2022-02-22 21:09,72945282,"17,212.5210","17,202.7210",10.00 AED,10.00,9.8000,0.2000,565672938,1603263,Success,United Arab Emirates,DU UAE,Transguard Group LLC,API User,E6AEAE22430
2022-02-22 21:10,72945346,"17,202.7210","17,197.8210",05.00 AED,5.00,4.9000,0.1000,565673153,1603267,Success,United Arab Emirates,DU UAE,Transguard Group LLC,API User,E6AEAE17361
2022-02-22 21:10,72945386,"17,197.8210","17,192.9210",05.00 AED,5.00,4.9000,0.1000,565673258,1603270,Success,United Arab Emirates,DU UAE,Transguard Group LLC,API User,E6AEAE17361
2022-02-22 21:12,72945486,"17,192.9210","17,188.0210",05.00 AED,5.00,4.9000,0.1000,565673579,1603274,Success,United Arab Emirates,DU UAE,Transguard Group LLC,API User,E6AEAE17361
2022-02-22 21:12,72945522,"17,188.0210","17,178.2210",10.00 AED,10.00,9.8000,0.2000,565673691,1603276,Success,United Arab Emirates,DU UAE,Transguard Group LLC,API User,E6AEAE22430
2022-02-22 21:14,72945627,"17,178.2210","17,173.3210",05.00 AED,5.00,4.9000,0.1000,565674008,1603281,Success,United Arab Emirates,DU UAE,Transguard Group LLC,API User,E6AEAE17361
2022-02-22 21:23,72946242,"17,173.3210","17,168.4210",05.00 AED,5.00,4.9000,0.1000,565675819,1603294,Success,United Arab Emirates,DU UAE,Transguard Group LLC,API User,E6AEAE17361
2022-02-22 21:25,72946369,"17,168.4210","17,148.8210",20.00 AED,20.00,19.6000,0.4000,565676200,1603297,Success,United Arab Emirates,DU UAE,Transguard Group LLC,API User,E6AEAE12938
2022-02-22 21:28,72946556,"17,148.8210","17,139.0210",10.00 AED,10.00,9.8000,0.2000,565676825,1603301,Success,United Arab Emirates,DU UAE,Transguard Group LLC,API User,E6AEAE22430
2022-02-22 21:34,72946972,"17,139.0210","17,134.1210",05.00 AED,5.00,4.9000,0.1000,565678097,1603316,Success,United Arab Emirates,DU UAE,Transguard Group LLC,API User,E6AEAE17361
2022-02-22 21:38,72947146,"17,134.1210","17,129.2210",05.00 AED,5.00,4.9000,0.1000,565678696,1603323,Success,United Arab Emirates,DU UAE,Transguard Group LLC,API User,E6AEAE17361
2022-02-22 21:39,72947232,"17,129.2210","17,125.0410",50.00 PHP,4.75,4.1800,0.5700,565678991,1603327,Failure,Philippines,Smart (SunCellular) Philippines,Transguard Group LLC,API User,PH_SM_TopUp_50.00
2022-02-22 21:39,72947232,"17,125.0410","17,120.8610",50.00 PHP,4.75,4.1800,0.5700,565678991,1603327,Failure,Philippines,Smart (SunCellular) Philippines,Transguard Group LLC,API User,PH_SM_TopUp_50.00
2022-02-22 21:49,72947830,"17,129.2210","17,124.3210",05.00 AED,5.00,4.9000,0.1000,565680980,1603346,Success,United Arab Emirates,DU UAE,Transguard Group LLC,API User,E6AEAE17361
2022-02-22 21:50,72947912,"17,124.3210","17,114.5210",10.00 AED,10.00,9.8000,0.2000,565681217,1603352,Success,United Arab Emirates,DU UAE,Transguard Group LLC,API User,E6AEAE22430
2022-02-22 21:51,72947917,"17,114.5210","17,104.7210",10.00 AED,10.00,9.8000,0.2000,565681231,1603353,Success,United Arab Emirates,DU UAE,Transguard Group LLC,API User,E6AEAE22430
2022-02-22 21:57,72948301,"17,104.7210","17,094.9210",10.00 AED,10.00,9.8000,0.2000,565682469,1603361,Success,United Arab Emirates,DU UAE,Transguard Group LLC,API User,E6AEAE22430
2022-02-22 21:58,72948331,"17,094.9210","17,085.1210",10.00 AED,10.00,9.8000,0.2000,565682550,1603364,Success,United Arab Emirates,DU UAE,Transguard Group LLC,API User,E6AEAE22430
2022-02-22 21:59,72948422,"17,085.1210","17,075.3210",10.00 AED,10.00,9.8000,0.2000,565682802,1603369,Success,United Arab Emirates,DU UAE,Transguard Group LLC,API User,E6AEAE22430
2022-02-22 22:04,72948684,"17,075.3210","17,041.6610","1,200.00 PKR",38.25,33.6600,4.5900,565683585,1603374,Success,Pakistan,Telenor Pakistan,Transguard Group LLC,API User,TPPKPK27334
2022-02-22 22:05,72948796,"17,041.6610","17,031.8610",10.00 AED,10.00,9.8000,0.2000,565683953,1603379,Success,United Arab Emirates,DU UAE,Transguard Group LLC,API User,E6AEAE22430
2022-02-22 22:07,72948889,"17,031.8610","17,026.9610",05.00 AED,5.00,4.9000,0.1000,565684259,1603383,Success,United Arab Emirates,DU UAE,Transguard Group LLC,API User,E6AEAE17361
2022-02-22 22:19,72949504,"17,026.9610","17,007.3610",20.00 AED,20.00,19.6000,0.4000,565686306,1603407,Success,United Arab Emirates,DU UAE,Transguard Group LLC,API User,E6AEAE12938
2022-02-22 22:20,72949554,"17,007.3610","17,002.4610",05.00 AED,5.00,4.9000,0.1000,565686468,1603412,Success,United Arab Emirates,DU UAE,Transguard Group LLC,API User,E6AEAE17361
2022-02-22 22:20,72949564,"17,002.4610","16,992.6610",10.00 AED,10.00,9.8000,0.2000,565686495,1603414,Success,United Arab Emirates,DU UAE,Transguard Group LLC,API User,E6AEAE22430
2022-02-22 22:22,72949687,"16,992.6610","16,958.3610",35.00 AED,35.00,34.3000,0.7000,565686869,1603419,Success,United Arab Emirates,DU UAE,Transguard Group LLC,API User,E6AEAE73954
2022-02-22 22:23,72949762,"16,958.3610","16,953.4610",05.00 AED,5.00,4.9000,0.1000,565687116,1603422,Success,United Arab Emirates,DU UAE,Transguard Group LLC,API User,E6AEAE17361
2022-02-22 22:26,72949903,"16,953.4610","16,933.8610",20.00 AED,20.00,19.6000,0.4000,565687609,1603425,Success,United Arab Emirates,DU UAE,Transguard Group LLC,API User,E6AEAE12938
2022-02-22 22:28,72949984,"16,933.8610","16,928.9610",05.00 AED,5.00,4.9000,0.1000,565687881,1603428,Success,United Arab Emirates,DU UAE,Transguard Group LLC,API User,E6AEAE17361
2022-02-22 22:32,72950157,"16,928.9610","16,924.7810",150.00 PKR,4.75,4.1800,0.5700,565688455,1603435,Success,Pakistan,Zong Pakistan,Transguard Group LLC,API User,ZNPKPK65621
2022-02-22 22:34,72950303,"16,924.7810","16,905.1810",20.00 AED,20.00,19.6000,0.4000,565688897,1603442,Success,United Arab Emirates,DU UAE,Transguard Group LLC,API User,E6AEAE12938
2022-02-22 22:38,72950456,"16,905.1810","16,895.3810",10.00 AED,10.00,9.8000,0.2000,565689406,1603445,Success,United Arab Emirates,DU UAE,Transguard Group LLC,API User,E6AEAE22430
2022-02-22 22:43,72950662,"16,895.3810","16,890.4810",05.00 AED,5.00,4.9000,0.1000,565690200,1603452,Success,United Arab Emirates,DU UAE,Transguard Group LLC,API User,E6AEAE17361
2022-02-22 23:03,72951577,"16,890.4810","16,885.5810",05.00 AED,5.00,4.9000,0.1000,565693260,1603468,Success,United Arab Emirates,DU UAE,Transguard Group LLC,API User,E6AEAE17361
2022-02-22 23:04,72951607,"16,885.5810","16,876.7810",100.00 PHP,10.00,8.8000,1.2000,565693389,1603471,Success,Philippines,BS_Globe Philippines,Transguard Group LLC,API User,PH_GB_TopUp_100.00
2022-02-22 23:05,72951617,"16,876.7810","16,866.9810",10.00 AED,10.00,9.8000,0.2000,565693459,1603475,Success,United Arab Emirates,DU UAE,Transguard Group LLC,API User,E6AEAE22430
2022-02-22 23:09,72951769,"16,866.9810","16,862.0810",05.00 AED,5.00,4.9000,0.1000,565693997,1603481,Success,United Arab Emirates,DU UAE,Transguard Group LLC,API User,E6AEAE17361
2022-02-22 23:09,72951776,"16,862.0810","16,857.1810",05.00 AED,5.00,4.9000,0.1000,565694009,1603482,Success,United Arab Emirates,DU UAE,Transguard Group LLC,API User,E6AEAE17361
2022-02-22 23:11,72951881,"16,857.1810","16,847.3810",10.00 AED,10.00,9.8000,0.2000,565694389,1603485,Success,United Arab Emirates,DU UAE,Transguard Group LLC,API User,E6AEAE22430
2022-02-22 23:39,72952927,"16,847.3810","16,838.5810","25,452.00 SLL",10.00,8.8000,1.2000,565698262,1603494,Success,Sierra Leone,Africell Sierra Leone,Transguard Group LLC,API User,SL_AF_TopUp
2022-02-22 23:46,72953143,"16,838.5810","16,828.7810",10.00 AED,10.00,9.8000,0.2000,565699049,1603498,Success,United Arab Emirates,DU UAE,Transguard Group LLC,API User,E6AEAE22430
2022-02-22 23:55,72953455,"16,828.7810","16,823.8810",05.00 AED,5.00,4.9000,0.1000,565700149,1603504,Success,United Arab Emirates,DU UAE,Transguard Group LLC,API User,E6AEAE17361
2022-02-22 23:56,72953482,"16,823.8810","16,818.9810",05.00 AED,5.00,4.9000,0.1000,565700238,1603507,Success,United Arab Emirates,DU UAE,Transguard Group LLC,API User,E6AEAE17361
2022-02-23 00:07,72953828,"16,818.9810","16,814.0810",05.00 AED,5.00,4.9000,0.1000,565701579,1603511,Success,United Arab Emirates,DU UAE,Transguard Group LLC,API User,E6AEAE17361
2022-02-23 00:13,72954040,"16,814.0810","16,806.1610","1,000.00 XAF",9.00,7.9200,1.0800,565702324,1603518,Success,Cameroon,MTN Cameroon,Transguard Group LLC,API User,CM_MT_TopUp_1000.00
2022-02-23 00:42,72954911,"16,806.1610","16,796.3610",10.00 AED,10.00,9.8000,0.2000,565705498,1603530,Success,United Arab Emirates,DU UAE,Transguard Group LLC,API User,E6AEAE22430
2022-02-23 00:53,72955220,"16,796.3610","16,791.4610",05.00 AED,5.00,4.9000,0.1000,565706694,1603535,Success,United Arab Emirates,DU UAE,Transguard Group LLC,API User,E6AEAE17361
2022-02-23 00:57,72955327,"16,791.4610","16,786.5610",05.00 AED,5.00,4.9000,0.1000,565707134,1603540,Success,United Arab Emirates,DU UAE,Transguard Group LLC,API User,E6AEAE17361
2022-02-23 01:05,72955533,"16,786.5610","16,762.0610",25.00 AED,25.00,24.5000,0.5000,565708001,1603549,Success,United Arab Emirates,DU UAE,Transguard Group LLC,API User,E6AEAE17343
2022-02-23 01:07,72955587,"16,762.0610","16,752.2610",10.00 AED,10.00,9.8000,0.2000,565708190,1603552,Success,United Arab Emirates,DU UAE,Transguard Group LLC,API User,E6AEAE22430
2022-02-23 01:08,72955638,"16,752.2610","16,708.1610",45.00 AED,45.00,44.1000,0.9000,565708383,1603556,Success,United Arab Emirates,DU UAE,Transguard Group LLC,API User,E6AEAE35243
2022-02-23 01:10,72955685,"16,708.1610","16,698.3610",10.00 AED,10.00,9.8000,0.2000,565708573,1603561,Success,United Arab Emirates,DU UAE,Transguard Group LLC,API User,E6AEAE22430
2022-02-23 01:10,72955695,"16,698.3610","16,693.4610",05.00 AED,5.00,4.9000,0.1000,565708620,1603563,Success,United Arab Emirates,DU UAE,Transguard Group LLC,API User,E6AEAE17361
2022-02-23 01:20,72955924,"16,693.4610","16,684.6610",802.00 NGN,10.00,8.8000,1.2000,565709650,1603566,Success,Nigeria,MTN Nigeria,Transguard Group LLC,API User,NG_MT_TopUp
2022-02-23 01:28,72956168,"16,684.6610","16,663.5410",80.00 EGP,24.00,21.1200,2.8800,565710605,1603571,Success,Egypt,Etisalat Egypt,Transguard Group LLC,API User,EG_ET_TopUp_80.00
2022-02-23 01:53,72956777,"16,663.5410","16,658.6410",05.00 AED,5.00,4.9000,0.1000,565713514,1603576,Success,United Arab Emirates,DU UAE,Transguard Group LLC,API User,E6AEAE17361
2022-02-23 02:11,72957266,"16,658.6410","16,648.8410",10.00 AED,10.00,9.8000,0.2000,565715532,1603581,Success,United Arab Emirates,DU UAE,Transguard Group LLC,API User,E6AEAE22430
2022-02-23 02:24,72957603,"16,648.8410","16,609.6410",40.00 AED,40.00,39.2000,0.8000,565716960,1603589,Success,United Arab Emirates,DU UAE,Transguard Group LLC,API User,E6AEAE64011
2022-02-23 02:41,72958060,"16,609.6410","16,604.7410",05.00 AED,5.00,4.9000,0.1000,565719042,1603596,Success,United Arab Emirates,DU UAE,Transguard Group LLC,API User,E6AEAE17361
2022-02-23 02:44,72958128,"16,604.7410","16,599.8410",05.00 AED,5.00,4.9000,0.1000,565719303,1603599,Success,United Arab Emirates,DU UAE,Transguard Group LLC,API User,E6AEAE17361
2022-02-23 03:35,72959532,"16,599.8410","16,594.9410",05.00 AED,5.00,4.9000,0.1000,565725281,1603606,Success,United Arab Emirates,DU UAE,Transguard Group LLC,API User,E6AEAE17361
2022-02-23 03:40,72959665,"16,594.9410","16,590.0410",05.00 AED,5.00,4.9000,0.1000,565725838,1603609,Success,United Arab Emirates,DU UAE,Transguard Group LLC,API User,E6AEAE17361
2022-02-23 03:49,72959949,"16,590.0410","16,570.4410",20.00 AED,20.00,19.6000,0.4000,565726858,1603612,Success,United Arab Emirates,DU UAE,Transguard Group LLC,API User,E6AEAE12938
2022-02-23 04:02,72960309,"16,570.4410","16,560.6410",10.00 AED,10.00,9.8000,0.2000,565728367,1603616,Success,United Arab Emirates,DU UAE,Transguard Group LLC,API User,E6AEAE22430
2022-02-23 04:04,72960363,"16,560.6410","16,550.8410",10.00 AED,10.00,9.8000,0.2000,565728590,1603624,Success,United Arab Emirates,DU UAE,Transguard Group LLC,API User,E6AEAE22430
2022-02-23 04:15,72960634,"16,550.8410","16,531.2410",20.00 AED,20.00,19.6000,0.4000,565729770,1603627,Success,United Arab Emirates,DU UAE,Transguard Group LLC,API User,E6AEAE12938
2022-02-23 04:26,72960914,"16,531.2410","16,526.3410",05.00 AED,5.00,4.9000,0.1000,565731035,1603630,Success,United Arab Emirates,DU UAE,Transguard Group LLC,API User,E6AEAE17361
2022-02-23 04:29,72960965,"16,526.3410","16,516.5410",10.00 AED,10.00,9.8000,0.2000,565731273,1603633,Success,United Arab Emirates,DU UAE,Transguard Group LLC,API User,E6AEAE22430
2022-02-23 04:34,72961095,"16,516.5410","16,511.6410",05.00 AED,5.00,4.9000,0.1000,565731791,1603638,Success,United Arab Emirates,DU UAE,Transguard Group LLC,API User,E6AEAE17361
2022-02-23 04:40,72961229,"16,511.6410","16,506.7410",05.00 AED,5.00,4.9000,0.1000,565732365,1603641,Success,United Arab Emirates,DU UAE,Transguard Group LLC,API User,E6AEAE17361
2022-02-23 04:47,72961404,"16,506.7410","16,496.9410",10.00 AED,10.00,9.8000,0.2000,565733115,1603648,Success,United Arab Emirates,DU UAE,Transguard Group LLC,API User,E6AEAE22430
2022-02-23 04:48,72961434,"16,496.9410","16,492.0410",05.00 AED,5.00,4.9000,0.1000,565733206,1603652,Success,United Arab Emirates,DU UAE,Transguard Group LLC,API User,E6AEAE17361
2022-02-23 04:52,72961533,"16,492.0410","16,487.1410",05.00 AED,5.00,4.9000,0.1000,565733626,1603658,Success,United Arab Emirates,DU UAE,Transguard Group LLC,API User,E6AEAE17361
2022-02-23 04:58,72961688,"16,487.1410","16,482.2410",05.00 AED,5.00,4.9000,0.1000,565734216,1603665,Success,United Arab Emirates,DU UAE,Transguard Group LLC,API User,E6AEAE17361
2022-02-23 05:03,72961841,"16,482.2410","16,462.6410",20.00 AED,20.00,19.6000,0.4000,565734720,1603673,Success,United Arab Emirates,DU UAE,Transguard Group LLC,API User,E6AEAE12938
2022-02-23 05:06,72961920,"16,462.6410","16,452.8410",10.00 AED,10.00,9.8000,0.2000,565735018,1603679,Success,United Arab Emirates,DU UAE,Transguard Group LLC,API User,E6AEAE22430
2022-02-23 05:56,72963429,"16,452.8410","16,447.9410",05.00 AED,5.00,4.9000,0.1000,565739745,1603724,Success,United Arab Emirates,DU UAE,Transguard Group LLC,API User,E6AEAE17361
2022-02-23 05:58,72963498,"16,447.9410","16,443.0410",05.00 AED,5.00,4.9000,0.1000,565739950,1603730,Success,United Arab Emirates,DU UAE,Transguard Group LLC,API User,E6AEAE17361
2022-02-23 05:58,72963513,"16,443.0410","16,438.1410",05.00 AED,5.00,4.9000,0.1000,565739995,1603734,Success,United Arab Emirates,DU UAE,Transguard Group LLC,API User,E6AEAE17361
2022-02-23 05:59,72963529,"16,438.1410","16,429.3410",149.00 INR,10.00,8.8000,1.2000,565740029,1603737,Success,India,Vi India,Transguard Group LLC,API User,VFININ21772
2022-02-23 06:03,72963674,"16,429.3410","16,409.7410",20.00 AED,20.00,19.6000,0.4000,565740459,1603746,Success,United Arab Emirates,DU UAE,Transguard Group LLC,API User,E6AEAE12938
2022-02-23 06:15,72964029,"16,409.7410","16,404.8410",05.00 AED,5.00,4.9000,0.1000,565741481,1603757,Success,United Arab Emirates,DU UAE,Transguard Group LLC,API User,E6AEAE17361
2022-02-23 06:28,72964430,"16,404.8410","16,399.9410",05.00 AED,5.00,4.9000,0.1000,565742676,1603766,Success,United Arab Emirates,DU UAE,Transguard Group LLC,API User,E6AEAE17361
2022-02-23 06:29,72964449,"16,399.9410","16,396.2010",130.00 PKR,4.25,3.7400,0.5100,565742726,1603769,Success,Pakistan,Telenor Pakistan,Transguard Group LLC,API User,TPPKPK26966
2022-02-23 06:34,72964627,"16,396.2010","16,387.4010",315.00 PKR,10.00,8.8000,1.2000,565743197,1603776,Success,Pakistan,Telenor Pakistan,Transguard Group LLC,API User,TPPKPK75105
2022-02-23 06:37,72964706,"16,387.4010","16,377.6010",10.00 AED,10.00,9.8000,0.2000,565743399,1603783,Success,United Arab Emirates,DU UAE,Transguard Group LLC,API User,E6AEAE22430
2022-02-23 06:37,72964729,"16,377.6010","16,372.7010",05.00 AED,5.00,4.9000,0.1000,565743447,1603786,Success,United Arab Emirates,DU UAE,Transguard Group LLC,API User,E6AEAE17361
2022-02-23 06:41,72964828,"16,372.7010","16,362.9010",10.00 AED,10.00,9.8000,0.2000,565743761,1603790,Success,United Arab Emirates,DU UAE,Transguard Group LLC,API User,E6AEAE22430
2022-02-23 06:50,72965091,"16,362.9010","16,353.1010",10.00 AED,10.00,9.8000,0.2000,565744504,1603799,Success,United Arab Emirates,DU UAE,Transguard Group LLC,API User,E6AEAE22430
2022-02-23 06:57,72965314,"16,353.1010","16,335.7210",299.00 INR,19.75,17.3800,2.3700,565745159,1603812,Success,India,Airtel India,Transguard Group LLC,API User,AIININ55294
2022-02-23 07:01,72965402,"16,335.7210","16,330.8210",05.00 AED,5.00,4.9000,0.1000,565745407,1603821,Success,United Arab Emirates,DU UAE,Transguard Group LLC,API User,E6AEAE17361
2022-02-23 07:02,72965442,"16,330.8210","16,321.0210",10.00 AED,10.00,9.8000,0.2000,565745502,1603825,Success,United Arab Emirates,DU UAE,Transguard Group LLC,API User,E6AEAE22430
2022-02-23 07:06,72965553,"16,321.0210","16,316.1210",05.00 AED,5.00,4.9000,0.1000,565745811,1603831,Success,United Arab Emirates,DU UAE,Transguard Group LLC,API User,E6AEAE17361
2022-02-23 07:17,72965877,"16,316.1210","16,311.2210",05.00 AED,5.00,4.9000,0.1000,565746812,1603838,Success,United Arab Emirates,DU UAE,Transguard Group LLC,API User,E6AEAE17361
2022-02-23 07:19,72965916,"16,311.2210","16,301.4210",10.00 AED,10.00,9.8000,0.2000,565746925,1603841,Success,United Arab Emirates,DU UAE,Transguard Group LLC,API User,E6AEAE22430
2022-02-23 07:20,72965958,"16,301.4210","16,291.6210",10.00 AED,10.00,9.8000,0.2000,565747018,1603846,Success,United Arab Emirates,DU UAE,Transguard Group LLC,API User,E6AEAE22430
2022-02-23 07:29,72966220,"16,291.6210","16,286.7210",05.00 AED,5.00,4.9000,0.1000,565747799,1603856,Success,United Arab Emirates,DU UAE,Transguard Group LLC,API User,E6AEAE17361
2022-02-23 07:32,72966316,"16,286.7210","16,281.8210",05.00 AED,5.00,4.9000,0.1000,565748043,1603862,Success,United Arab Emirates,DU UAE,Transguard Group LLC,API User,E6AEAE17361
2022-02-23 07:33,72966345,"16,281.8210","16,276.9210",05.00 AED,5.00,4.9000,0.1000,565748121,1603865,Success,United Arab Emirates,DU UAE,Transguard Group LLC,API User,E6AEAE17361
2022-02-23 07:38,72966471,"16,276.9210","16,267.1210",10.00 AED,10.00,9.8000,0.2000,565748488,1603872,Success,United Arab Emirates,DU UAE,Transguard Group LLC,API User,E6AEAE22430
2022-02-23 07:40,72966537,"16,267.1210","16,258.3210",100.00 PHP,10.00,8.8000,1.2000,565748700,1603875,Success,Philippines,BS_Globe Philippines,Transguard Group LLC,API User,PH_GB_TopUp_100.00
2022-02-23 07:42,72966576,"16,258.3210","16,253.4210",05.00 AED,5.00,4.9000,0.1000,565748802,1603878,Success,United Arab Emirates,DU UAE,Transguard Group LLC,API User,E6AEAE17361
2022-02-23 07:54,72966895,"16,253.4210","16,248.5210",05.00 AED,5.00,4.9000,0.1000,565749754,1603885,Success,United Arab Emirates,DU UAE,Transguard Group LLC,API User,E6AEAE17361
2022-02-23 07:56,72966969,"16,248.5210","16,239.7210",13.20 GHS,10.00,8.8000,1.2000,565749945,1603890,Success,Ghana,MTN Ghana,Transguard Group LLC,API User,GH_MT_TopUp
2022-02-23 07:58,72967011,"16,239.7210","16,235.3210",06.60 GHS,5.00,4.4000,0.6000,565750029,1603897,Success,Ghana,MTN Ghana,Transguard Group LLC,API User,GH_MT_TopUp
2022-02-23 08:01,72967111,"16,235.3210","16,225.5210",10.00 AED,10.00,9.8000,0.2000,565750321,1603904,Success,United Arab Emirates,DU UAE,Transguard Group LLC,API User,E6AEAE22430
2022-02-23 08:03,72967192,"16,225.5210","16,215.7210",10.00 AED,10.00,9.8000,0.2000,565750532,1603912,Success,United Arab Emirates,DU UAE,Transguard Group LLC,API User,E6AEAE22430
2022-02-23 08:09,72967392,"16,215.7210","16,210.8210",05.00 AED,5.00,4.9000,0.1000,565751032,1603916,Success,United Arab Emirates,DU UAE,Transguard Group LLC,API User,E6AEAE17361
2022-02-23 08:13,72967485,"16,210.8210","16,201.0210",10.00 AED,10.00,9.8000,0.2000,565751300,1603921,Success,United Arab Emirates,DU UAE,Transguard Group LLC,API User,E6AEAE22430
2022-02-23 08:25,72967829,"16,201.0210","16,191.2210",10.00 AED,10.00,9.8000,0.2000,565752279,1603935,Success,United Arab Emirates,DU UAE,Transguard Group LLC,API User,E6AEAE22430
2022-02-23 08:29,72967956,"16,191.2210","16,186.3210",05.00 AED,5.00,4.9000,0.1000,565752643,1603942,Success,United Arab Emirates,DU UAE,Transguard Group LLC,API User,E6AEAE17361
2022-02-23 08:35,72968116,"16,186.3210","16,178.1810",160.00 BDT,9.25,8.1400,1.1100,565753075,1603949,Success,Bangladesh,Grameenphone Bangladesh,Transguard Group LLC,API User,GEBDBD61211
2022-02-23 08:39,72968234,"16,178.1810","16,153.6810",25.00 AED,25.00,24.5000,0.5000,565753403,1603959,Success,United Arab Emirates,DU UAE,Transguard Group LLC,API User,E6AEAE17343
2022-02-23 08:39,72968250,"16,153.6810","16,148.7810",05.00 AED,5.00,4.9000,0.1000,565753443,1603961,Success,United Arab Emirates,DU UAE,Transguard Group LLC,API User,E6AEAE17361
2022-02-23 08:41,72968306,"16,148.7810","16,143.8810",05.00 AED,5.00,4.9000,0.1000,565753564,1603965,Success,United Arab Emirates,DU UAE,Transguard Group LLC,API User,E6AEAE17361
2022-02-23 08:41,72968316,"16,143.8810","16,134.0810",10.00 AED,10.00,9.8000,0.2000,565753592,1603967,Success,United Arab Emirates,DU UAE,Transguard Group LLC,API User,E6AEAE22430
2022-02-23 08:43,72968374,"16,134.0810","16,124.2810",10.00 AED,10.00,9.8000,0.2000,565753751,1603972,Success,United Arab Emirates,DU UAE,Transguard Group LLC,API User,E6AEAE22430
2022-02-23 08:44,72968397,"16,124.2810","16,119.3810",05.00 AED,5.00,4.9000,0.1000,565753828,1603975,Success,United Arab Emirates,DU UAE,Transguard Group LLC,API User,E6AEAE17361
2022-02-23 08:45,72968440,"16,119.3810","16,109.5810",10.00 AED,10.00,9.8000,0.2000,565753946,1603981,Success,United Arab Emirates,DU UAE,Transguard Group LLC,API User,E6AEAE22430
2022-02-23 08:53,72968672,"16,109.5810","16,104.6810",05.00 AED,5.00,4.9000,0.1000,565754602,1603993,Success,United Arab Emirates,DU UAE,Transguard Group LLC,API User,E6AEAE17361
2022-02-23 08:53,72968679,"16,104.6810","16,094.8810",10.00 AED,10.00,9.8000,0.2000,565754615,1603995,Success,United Arab Emirates,DU UAE,Transguard Group LLC,API User,E6AEAE22430
2022-02-23 08:59,72968831,"16,094.8810","16,089.9810",05.00 AED,5.00,4.9000,0.1000,565755069,1604011,Success,United Arab Emirates,DU UAE,Transguard Group LLC,API User,E6AEAE17361
2022-02-23 09:02,72968921,"16,089.9810","16,080.1810",10.00 AED,10.00,9.8000,0.2000,565755330,1604017,Success,United Arab Emirates,DU UAE,Transguard Group LLC,API User,E6AEAE22430
2022-02-23 09:03,72968950,"16,080.1810","16,075.2810",05.00 AED,5.00,4.9000,0.1000,565755415,1604021,Success,United Arab Emirates,DU UAE,Transguard Group LLC,API User,E6AEAE17361
2022-02-23 09:04,72968983,"16,075.2810","16,070.3810",05.00 AED,5.00,4.9000,0.1000,565755501,72968983,Success,United Arab Emirates,DU UAE,Transguard Group LLC,mohammed.arafath@transguardgroup.com,E6AEAE17361
2022-02-23 09:05,72969020,"16,070.3810","16,062.2410",300.00 PKR,9.25,8.1400,1.1100,565755597,1604027,Success,Pakistan,Zong Pakistan,Transguard Group LLC,API User,ZNPKPK70504
2022-02-23 09:05,72969027,"16,062.2410","16,057.3410",05.00 AED,5.00,4.9000,0.1000,565755611,1604029,Success,United Arab Emirates,DU UAE,Transguard Group LLC,API User,E6AEAE17361
2022-02-23 09:07,72969078,"16,057.3410","16,042.6410",15.00 AED,15.00,14.7000,0.3000,565755742,72969078,Failure,United Arab Emirates,DU UAE,Transguard Group LLC,mohammed.arafath@transguardgroup.com,E6AEAE8527
2022-02-23 09:07,72969078,"16,042.6410","16,027.9410",15.00 AED,15.00,14.7000,0.3000,565755742,72969078,Failure,United Arab Emirates,DU UAE,Transguard Group LLC,mohammed.arafath@transguardgroup.com,E6AEAE8527
2022-02-23 09:09,72969145,"16,057.3410","16,047.5410",10.00 AED,10.00,9.8000,0.2000,565755943,1604034,Success,United Arab Emirates,DU UAE,Transguard Group LLC,API User,E6AEAE22430
2022-02-23 09:11,72969180,"16,047.5410","16,042.6410",05.00 AED,5.00,4.9000,0.1000,565756058,1604038,Success,United Arab Emirates,DU UAE,Transguard Group LLC,API User,E6AEAE17361
2022-02-23 09:11,72969200,"16,042.6410","16,032.8410",10.00 AED,10.00,9.8000,0.2000,565756100,1604040,Success,United Arab Emirates,DU UAE,Transguard Group LLC,API User,E6AEAE22430
2022-02-23 09:16,72969365,"16,032.8410","16,027.9410",05.00 AED,5.00,4.9000,0.1000,565756535,1604048,Success,United Arab Emirates,DU UAE,Transguard Group LLC,API User,E6AEAE17361
2022-02-23 09:17,72969397,"16,027.9410","16,022.0010",100.00 INR,6.75,5.9400,0.8100,565756628,1604051,Success,India,Vi India,Transguard Group LLC,API User,VFININ43046
2022-02-23 09:18,72969423,"16,022.0010","16,016.0610",100.00 INR,6.75,5.9400,0.8100,565756682,1604054,Failure,India,Vi India,Transguard Group LLC,API User,VFININ43046
2022-02-23 09:18,72969423,"16,016.0610","16,010.1210",100.00 INR,6.75,5.9400,0.8100,565756682,1604054,Failure,India,Vi India,Transguard Group LLC,API User,VFININ43046
2022-02-23 09:28,72969734,"16,022.0010","16,012.2010",10.00 AED,10.00,9.8000,0.2000,565757531,1604066,Success,United Arab Emirates,DU UAE,Transguard Group LLC,API User,E6AEAE22430
2022-02-23 09:28,72969747,"16,012.2010","16,002.4010",10.00 AED,10.00,9.8000,0.2000,565757554,1604068,Success,United Arab Emirates,DU UAE,Transguard Group LLC,API User,E6AEAE22430
2022-02-23 09:29,72969779,"16,002.4010","15,998.0010","3,675.41 UGX",5.00,4.4000,0.6000,565757645,1604071,Success,Uganda,MTN Uganda,Transguard Group LLC,API User,UG_MT_TopUp
2022-02-23 09:30,72969813,"15,998.0010","15,993.1010",05.00 AED,5.00,4.9000,0.1000,565757732,1604075,Success,United Arab Emirates,DU UAE,Transguard Group LLC,API User,E6AEAE17361
2022-02-23 09:32,72969846,"15,993.1010","15,983.3010",10.00 AED,10.00,9.8000,0.2000,565757853,1604079,Success,United Arab Emirates,DU UAE,Transguard Group LLC,API User,E6AEAE22430
2022-02-23 09:36,72969978,"15,983.3010","15,973.5010",10.00 AED,10.00,9.8000,0.2000,565758224,1604086,Success,United Arab Emirates,DU UAE,Transguard Group LLC,API User,E6AEAE22430
2022-02-23 09:38,72970048,"15,973.5010","15,944.1010",30.00 AED,30.00,29.4000,0.6000,565758416,1604095,Success,United Arab Emirates,DU UAE,Transguard Group LLC,API User,E6AEAE46146
2022-02-23 09:40,72970086,"15,944.1010","15,934.3010",10.00 AED,10.00,9.8000,0.2000,565758531,1604100,Success,United Arab Emirates,DU UAE,Transguard Group LLC,API User,E6AEAE22430
2022-02-23 09:42,72970158,"15,934.3010","15,924.5010",10.00 AED,10.00,9.8000,0.2000,565758732,1604108,Success,United Arab Emirates,DU UAE,Transguard Group LLC,API User,E6AEAE22430
2022-02-23 09:45,72970259,"15,924.5010","15,919.6010",05.00 AED,5.00,4.9000,0.1000,565758996,1604112,Success,United Arab Emirates,DU UAE,Transguard Group LLC,API User,E6AEAE17361
2022-02-23 09:50,72970387,"15,919.6010","15,915.2010","3,675.41 UGX",5.00,4.4000,0.6000,565759379,1604117,Success,Uganda,MTN Uganda,Transguard Group LLC,API User,UG_MT_TopUp
2022-02-23 10:08,72970920,"15,915.2010","15,910.3010",05.00 AED,5.00,4.9000,0.1000,565760896,1604144,Success,United Arab Emirates,DU UAE,Transguard Group LLC,API User,E6AEAE17361
2022-02-23 10:09,72970925,"15,910.3010","15,905.4010",05.00 AED,5.00,4.9000,0.1000,565760915,1604145,Success,United Arab Emirates,DU UAE,Transguard Group LLC,API User,E6AEAE17361
2022-02-23 10:11,72971026,"15,905.4010","15,895.6010",10.00 AED,10.00,9.8000,0.2000,565761185,1604152,Success,United Arab Emirates,DU UAE,Transguard Group LLC,API User,E6AEAE22430
2022-02-23 10:16,72971138,"15,895.6010","15,890.7010",05.00 AED,5.00,4.9000,0.1000,565761495,1604155,Success,United Arab Emirates,DU UAE,Transguard Group LLC,API User,E6AEAE17361
2022-02-23 10:18,72971216,"15,890.7010","15,871.1010",20.00 AED,20.00,19.6000,0.4000,565761692,1604161,Success,United Arab Emirates,DU UAE,Transguard Group LLC,API User,E6AEAE12938
2022-02-23 10:29,72971561,"15,871.1010","15,861.3010",10.00 AED,10.00,9.8000,0.2000,565762635,1604175,Success,United Arab Emirates,DU UAE,Transguard Group LLC,API User,E6AEAE22430
2022-02-23 10:30,72971579,"15,861.3010","15,856.4010",05.00 AED,5.00,4.9000,0.1000,565762699,1604179,Success,United Arab Emirates,DU UAE,Transguard Group LLC,API User,E6AEAE17361
2022-02-23 10:32,72971612,"15,856.4010","15,846.6010",10.00 AED,10.00,9.8000,0.2000,565762796,1604183,Success,United Arab Emirates,DU UAE,Transguard Group LLC,API User,E6AEAE22430
2022-02-23 10:32,72971619,"15,846.6010","15,812.3010",35.00 AED,35.00,34.3000,0.7000,565762814,1604184,Success,United Arab Emirates,DU UAE,Transguard Group LLC,API User,E6AEAE73954
2022-02-23 10:34,72971689,"15,812.3010","15,802.5010",10.00 AED,10.00,9.8000,0.2000,565763022,1604189,Success,United Arab Emirates,DU UAE,Transguard Group LLC,API User,E6AEAE22430
2022-02-23 10:36,72971760,"15,802.5010","15,797.6010",05.00 AED,5.00,4.9000,0.1000,565763228,1604194,Success,United Arab Emirates,DU UAE,Transguard Group LLC,API User,E6AEAE17361
2022-02-23 10:37,72971779,"15,797.6010","15,792.7010",05.00 AED,5.00,4.9000,0.1000,565763296,1604197,Success,United Arab Emirates,DU UAE,Transguard Group LLC,API User,E6AEAE17361
2022-02-23 10:38,72971805,"15,792.7010","15,787.8010",05.00 AED,5.00,4.9000,0.1000,565763360,1604200,Success,United Arab Emirates,DU UAE,Transguard Group LLC,API User,E6AEAE17361
2022-02-23 10:41,72971909,"15,787.8010","15,782.9010",05.00 AED,5.00,4.9000,0.1000,565763643,1604205,Success,United Arab Emirates,DU UAE,Transguard Group LLC,API User,E6AEAE17361
2022-02-23 10:46,72972064,"15,782.9010","15,778.0010",05.00 AED,5.00,4.9000,0.1000,565764064,1604214,Success,United Arab Emirates,DU UAE,Transguard Group LLC,API User,E6AEAE17361
2022-02-23 10:48,72972115,"15,778.0010","15,768.2010",10.00 AED,10.00,9.8000,0.2000,565764214,1604217,Success,United Arab Emirates,DU UAE,Transguard Group LLC,API User,E6AEAE22430
2022-02-23 10:48,72972126,"15,768.2010","15,763.3010",05.00 AED,5.00,4.9000,0.1000,565764244,1604220,Success,United Arab Emirates,DU UAE,Transguard Group LLC,API User,E6AEAE17361
2022-02-23 10:50,72972159,"15,763.3010","15,758.4010",05.00 AED,5.00,4.9000,0.1000,565764340,1604224,Success,United Arab Emirates,DU UAE,Transguard Group LLC,API User,E6AEAE17361
2022-02-23 10:50,72972183,"15,758.4010","15,753.5010",05.00 AED,5.00,4.9000,0.1000,565764402,1604226,Success,United Arab Emirates,DU UAE,Transguard Group LLC,API User,E6AEAE17361
2022-02-23 10:53,72972289,"15,753.5010","15,748.6010",05.00 AED,5.00,4.9000,0.1000,565764664,1604229,Success,United Arab Emirates,DU UAE,Transguard Group LLC,API User,E6AEAE17361
2022-02-23 10:54,72972341,"15,748.6010","15,743.7010",05.00 AED,5.00,4.9000,0.1000,565764772,1604232,Success,United Arab Emirates,DU UAE,Transguard Group LLC,API User,E6AEAE17361
2022-02-23 10:56,72972394,"15,743.7010","15,738.8010",05.00 AED,5.00,4.9000,0.1000,565764915,1604239,Success,United Arab Emirates,DU UAE,Transguard Group LLC,API User,E6AEAE17361
2022-02-23 11:00,72972481,"15,738.8010","15,733.9010",05.00 AED,5.00,4.9000,0.1000,565765157,1604244,Success,United Arab Emirates,DU UAE,Transguard Group LLC,API User,E6AEAE17361
2022-02-23 11:02,72972562,"15,733.9010","15,724.1010",10.00 AED,10.00,9.8000,0.2000,565765362,1604249,Success,United Arab Emirates,DU UAE,Transguard Group LLC,API User,E6AEAE22430
2022-02-23 11:03,72972608,"15,724.1010","15,719.2010",05.00 AED,5.00,4.9000,0.1000,565765491,1604254,Success,United Arab Emirates,DU UAE,Transguard Group LLC,API User,E6AEAE17361
2022-02-23 11:10,72972806,"15,719.2010","15,715.0210",150.00 PKR,4.75,4.1800,0.5700,565766048,1604261,Success,Pakistan,Jazz Pakistan,Transguard Group LLC,API User,MBPKPK20699
2022-02-23 11:12,72972855,"15,715.0210","15,705.2210",10.00 AED,10.00,9.8000,0.2000,565766188,1604268,Success,United Arab Emirates,DU UAE,Transguard Group LLC,API User,E6AEAE22430
2022-02-23 11:13,72972880,"15,705.2210","15,701.4810",151.00 PKR,4.25,3.7400,0.5100,565766277,1604273,Success,Pakistan,Telenor Pakistan,Transguard Group LLC,API User,TPPKPK94108
2022-02-23 11:14,72972919,"15,701.4810","15,696.5810",05.00 AED,5.00,4.9000,0.1000,565766387,1604277,Success,United Arab Emirates,DU UAE,Transguard Group LLC,API User,E6AEAE17361
2022-02-23 11:27,72973375,"15,696.5810","15,691.6810",05.00 AED,5.00,4.9000,0.1000,565767534,1604290,Success,United Arab Emirates,DU UAE,Transguard Group LLC,API User,E6AEAE17361
2022-02-23 11:34,72973580,"15,691.6810","15,681.8810",10.00 AED,10.00,9.8000,0.2000,565768136,1604301,Success,United Arab Emirates,DU UAE,Transguard Group LLC,API User,E6AEAE22430
2022-02-23 11:37,72973658,"15,681.8810","15,672.0810",10.00 AED,10.00,9.8000,0.2000,565768361,1604309,Success,United Arab Emirates,DU UAE,Transguard Group LLC,API User,E6AEAE22430
2022-02-23 11:39,72973743,"15,672.0810","15,667.1810",05.00 AED,5.00,4.9000,0.1000,565768612,1604313,Success,United Arab Emirates,DU UAE,Transguard Group LLC,API User,E6AEAE17361
2022-02-23 11:41,72973825,"15,667.1810","15,657.3810",10.00 AED,10.00,9.8000,0.2000,565768799,1604317,Success,United Arab Emirates,DU UAE,Transguard Group LLC,API User,E6AEAE22430
2022-02-23 11:45,72973937,"15,657.3810","15,637.7810",20.00 AED,20.00,19.6000,0.4000,565769124,1604322,Success,United Arab Emirates,DU UAE,Transguard Group LLC,API User,E6AEAE12938
2022-02-23 11:47,72973988,"15,637.7810","15,627.9810",10.00 AED,10.00,9.8000,0.2000,565769255,1604327,Success,United Arab Emirates,DU UAE,Transguard Group LLC,API User,E6AEAE22430
2022-02-23 11:47,72974001,"15,627.9810","15,623.0810",05.00 AED,5.00,4.9000,0.1000,565769300,1604329,Success,United Arab Emirates,DU UAE,Transguard Group LLC,API User,E6AEAE17361
2022-02-23 11:54,72974199,"15,623.0810","15,618.1810",05.00 AED,5.00,4.9000,0.1000,565769798,1604340,Success,United Arab Emirates,DU UAE,Transguard Group LLC,API User,E6AEAE17361
2022-02-23 11:56,72974261,"15,618.1810","15,613.2810",05.00 AED,5.00,4.9000,0.1000,565770017,1604347,Success,United Arab Emirates,DU UAE,Transguard Group LLC,API User,E6AEAE17361
2022-02-23 11:58,72974319,"15,613.2810","15,608.3810",05.00 AED,5.00,4.9000,0.1000,565770178,1604353,Success,United Arab Emirates,DU UAE,Transguard Group LLC,API User,E6AEAE17361
2022-02-23 12:00,72974382,"15,608.3810","15,598.5810",10.00 AED,10.00,9.8000,0.2000,565770331,1604356,Success,United Arab Emirates,DU UAE,Transguard Group LLC,API User,E6AEAE22430
2022-02-23 12:01,72974428,"15,598.5810","15,588.7810",10.00 AED,10.00,9.8000,0.2000,565770446,1604360,Success,United Arab Emirates,DU UAE,Transguard Group LLC,API User,E6AEAE22430
2022-02-23 12:01,72974434,"15,588.7810","15,569.1810",20.00 AED,20.00,19.6000,0.4000,565770458,1604363,Success,United Arab Emirates,DU UAE,Transguard Group LLC,API User,E6AEAE12938
2022-02-23 12:07,72974611,"15,569.1810","15,549.5810",20.00 AED,20.00,19.6000,0.4000,565770945,1604375,Success,United Arab Emirates,DU UAE,Transguard Group LLC,API User,E6AEAE12938
2022-02-23 12:08,72974627,"15,549.5810","15,544.6810",05.00 AED,5.00,4.9000,0.1000,565770982,1604377,Success,United Arab Emirates,DU UAE,Transguard Group LLC,API User,E6AEAE17361
2022-02-23 12:09,72974670,"15,544.6810","15,539.7810",05.00 AED,5.00,4.9000,0.1000,565771076,1604380,Success,United Arab Emirates,DU UAE,Transguard Group LLC,API User,E6AEAE17361
2022-02-23 12:09,72974694,"15,539.7810","15,520.1810",20.00 AED,20.00,19.6000,0.4000,565771138,1604383,Success,United Arab Emirates,DU UAE,Transguard Group LLC,API User,E6AEAE12938
2022-02-23 12:11,72974736,"15,520.1810","15,515.2810",05.00 AED,5.00,4.9000,0.1000,565771261,1604386,Success,United Arab Emirates,DU UAE,Transguard Group LLC,API User,E6AEAE17361
2022-02-23 12:21,72975069,"15,515.2810","15,505.4810",10.00 AED,10.00,9.8000,0.2000,565772146,1604397,Success,United Arab Emirates,DU UAE,Transguard Group LLC,API User,E6AEAE22430
2022-02-23 12:23,72975139,"15,505.4810","15,495.6810",10.00 AED,10.00,9.8000,0.2000,565772336,1604401,Success,United Arab Emirates,DU UAE,Transguard Group LLC,API User,E6AEAE22430
2022-02-23 12:30,72975358,"15,495.6810","15,485.8810",10.00 AED,10.00,9.8000,0.2000,565772921,1604406,Success,United Arab Emirates,DU UAE,Transguard Group LLC,API User,E6AEAE22430
2022-02-23 12:39,72975653,"15,485.8810","15,480.9810",05.00 AED,5.00,4.9000,0.1000,565773708,1604419,Failure,United Arab Emirates,DU UAE,Transguard Group LLC,API User,E6AEAE17361
2022-02-23 12:39,72975653,"15,480.9810","15,476.0810",05.00 AED,5.00,4.9000,0.1000,565773708,1604419,Failure,United Arab Emirates,DU UAE,Transguard Group LLC,API User,E6AEAE17361
2022-02-23 12:39,72975671,"15,485.8810","15,480.9810",05.00 AED,5.00,4.9000,0.1000,565773771,1604423,Success,United Arab Emirates,DU UAE,Transguard Group LLC,API User,E6AEAE17361
2022-02-23 12:41,72975715,"15,480.9810","15,476.0810",05.00 AED,5.00,4.9000,0.1000,565773876,1604432,Success,United Arab Emirates,DU UAE,Transguard Group LLC,API User,E6AEAE17361
2022-02-23 12:41,72975721,"15,476.0810","15,466.2810",10.00 AED,10.00,9.8000,0.2000,565773895,1604434,Success,United Arab Emirates,DU UAE,Transguard Group LLC,API User,E6AEAE22430
2022-02-23 12:44,72975818,"15,466.2810","15,461.3810",05.00 AED,5.00,4.9000,0.1000,565774199,1604438,Success,United Arab Emirates,DU UAE,Transguard Group LLC,API User,E6AEAE17361
2022-02-23 12:49,72975985,"15,461.3810","15,456.4810",05.00 AED,5.00,4.9000,0.1000,565774640,1604441,Success,United Arab Emirates,DU UAE,Transguard Group LLC,API User,E6AEAE17361
2022-02-23 12:53,72976131,"15,456.4810","15,451.5810",05.00 AED,5.00,4.9000,0.1000,565775008,1604448,Success,United Arab Emirates,DU UAE,Transguard Group LLC,API User,E6AEAE17361
2022-02-23 12:55,72976214,"15,451.5810","15,446.6810",05.00 AED,5.00,4.9000,0.1000,565775217,1604455,Success,United Arab Emirates,DU UAE,Transguard Group LLC,API User,E6AEAE17361
2022-02-23 13:06,72976541,"15,446.6810","15,441.7810",05.00 AED,5.00,4.9000,0.1000,565776103,1604473,Success,United Arab Emirates,DU UAE,Transguard Group LLC,API User,E6AEAE17361
2022-02-23 13:16,72976912,"15,441.7810","15,436.8810",05.00 AED,5.00,4.9000,0.1000,565777084,1604484,Success,United Arab Emirates,DU UAE,Transguard Group LLC,API User,E6AEAE17361
2022-02-23 13:21,72977067,"15,436.8810","15,431.9810",05.00 AED,5.00,4.9000,0.1000,565777578,1604488,Success,United Arab Emirates,DU UAE,Transguard Group LLC,API User,E6AEAE17361
2022-02-23 13:22,72977080,"15,431.9810","15,422.1810",10.00 AED,10.00,9.8000,0.2000,565777602,1604490,Success,United Arab Emirates,DU UAE,Transguard Group LLC,API User,E6AEAE22430
2022-02-23 13:26,72977222,"15,422.1810","15,412.3810",10.00 AED,10.00,9.8000,0.2000,565778018,1604498,Success,United Arab Emirates,DU UAE,Transguard Group LLC,API User,E6AEAE22430
2022-02-23 13:31,72977390,"15,412.3810","15,407.4810",05.00 AED,5.00,4.9000,0.1000,565778473,1604506,Success,United Arab Emirates,DU UAE,Transguard Group LLC,API User,E6AEAE17361
2022-02-23 13:34,72977507,"15,407.4810","15,397.6810",10.00 AED,10.00,9.8000,0.2000,565778778,1604509,Success,United Arab Emirates,DU UAE,Transguard Group LLC,API User,E6AEAE22430
2022-02-23 13:38,72977654,"15,397.6810","15,392.7810",05.00 AED,5.00,4.9000,0.1000,565779182,1604518,Success,United Arab Emirates,DU UAE,Transguard Group LLC,API User,E6AEAE17361
2022-02-23 13:38,72977656,"15,392.7810","15,387.8810",05.00 AED,5.00,4.9000,0.1000,565779190,1604519,Success,United Arab Emirates,DU UAE,Transguard Group LLC,API User,E6AEAE17361
2022-02-23 13:45,72977899,"15,387.8810","15,382.9810",05.00 AED,5.00,4.9000,0.1000,565779826,1604524,Success,United Arab Emirates,DU UAE,Transguard Group LLC,API User,E6AEAE17361
2022-02-23 13:49,72978045,"15,382.9810","15,370.6610",150.00 PHP,14.00,12.3200,1.6800,565780210,1604527,Success,Philippines,Smart (SunCellular) Philippines,Transguard Group LLC,API User,PH_SM_TopUp_150
2022-02-23 13:57,72978318,"15,370.6610","15,360.8610",10.00 AED,10.00,9.8000,0.2000,565780999,1604537,Success,United Arab Emirates,DU UAE,Transguard Group LLC,API User,E6AEAE22430
2022-02-23 14:01,72978465,"15,360.8610","15,355.9610",05.00 AED,5.00,4.9000,0.1000,565781427,1604542,Success,United Arab Emirates,DU UAE,Transguard Group LLC,API User,E6AEAE17361
2022-02-23 14:06,72978632,"15,355.9610","15,342.9810",219.00 INR,14.75,12.9800,1.7700,565781937,1604545,Success,India,Vi India,Transguard Group LLC,API User,VFININ40021
2022-02-23 14:12,72978811,"15,342.9810","15,338.0810",05.00 AED,5.00,4.9000,0.1000,565782434,1604548,Success,United Arab Emirates,DU UAE,Transguard Group LLC,API User,E6AEAE17361
2022-02-23 14:14,72978883,"15,338.0810","15,330.1610",220.00 NPR,9.00,7.9200,1.0800,565782656,1604553,Success,Nepal,Ncell Nepal,Transguard Group LLC,API User,NCNPNP79518
2022-02-23 14:16,72978969,"15,330.1610","15,322.2410",220.00 NPR,9.00,7.9200,1.0800,565782898,1604561,Success,Nepal,Ncell Nepal,Transguard Group LLC,API User,NCNPNP79518
2022-02-23 14:18,72979014,"15,322.2410","15,317.3410",05.00 AED,5.00,4.9000,0.1000,565783032,1604564,Success,United Arab Emirates,DU UAE,Transguard Group LLC,API User,E6AEAE17361
2022-02-23 14:24,72979207,"15,317.3410","15,312.4410",05.00 AED,5.00,4.9000,0.1000,565783589,1604574,Success,United Arab Emirates,DU UAE,Transguard Group LLC,API User,E6AEAE17361
2022-02-23 14:24,72979217,"15,312.4410","15,302.6410",10.00 AED,10.00,9.8000,0.2000,565783618,1604576,Success,United Arab Emirates,DU UAE,Transguard Group LLC,API User,E6AEAE22430
2022-02-23 14:30,72979405,"15,302.6410","15,297.7410",05.00 AED,5.00,4.9000,0.1000,565784154,1604582,Success,United Arab Emirates,DU UAE,Transguard Group LLC,API User,E6AEAE17361
2022-02-23 14:38,72979719,"15,297.7410","15,292.8410",05.00 AED,5.00,4.9000,0.1000,565785042,1604593,Success,United Arab Emirates,DU UAE,Transguard Group LLC,API User,E6AEAE17361
2022-02-23 14:43,72979873,"15,292.8410","15,288.6610",150.00 PKR,4.75,4.1800,0.5700,565785465,1604600,Success,Pakistan,Zong Pakistan,Transguard Group LLC,API User,ZNPKPK65621
2022-02-23 14:44,72979893,"15,288.6610","15,278.8610",10.00 AED,10.00,9.8000,0.2000,565785534,1604603,Success,United Arab Emirates,DU UAE,Transguard Group LLC,API User,E6AEAE22430
2022-02-23 14:44,72979916,"15,278.8610","15,273.9610",05.00 AED,5.00,4.9000,0.1000,565785597,1604606,Success,United Arab Emirates,DU UAE,Transguard Group LLC,API User,E6AEAE17361
2022-02-23 14:51,72980134,"15,273.9610","15,269.0610",05.00 AED,5.00,4.9000,0.1000,565786252,1604612,Success,United Arab Emirates,DU UAE,Transguard Group LLC,API User,E6AEAE17361
2022-02-23 14:52,72980141,"15,269.0610","15,259.2610",10.00 AED,10.00,9.8000,0.2000,565786276,1604614,Success,United Arab Emirates,DU UAE,Transguard Group LLC,API User,E6AEAE22430
2022-02-23 14:56,72980253,"15,259.2610","15,220.0610",40.00 AED,40.00,39.2000,0.8000,565786647,1604620,Success,United Arab Emirates,DU UAE,Transguard Group LLC,API User,E6AEAE64011
2022-02-23 15:00,72980389,"15,220.0610","15,215.1610",05.00 AED,5.00,4.9000,0.1000,565787072,1604629,Success,United Arab Emirates,DU UAE,Transguard Group LLC,API User,E6AEAE17361
2022-02-23 15:03,72980491,"15,215.1610","15,205.3610",10.00 AED,10.00,9.8000,0.2000,565787370,1604638,Success,United Arab Emirates,DU UAE,Transguard Group LLC,API User,E6AEAE22430
2022-02-23 15:04,72980522,"15,205.3610","15,200.4610",05.00 AED,5.00,4.9000,0.1000,565787452,1604643,Success,United Arab Emirates,DU UAE,Transguard Group LLC,API User,E6AEAE17361
2022-02-23 15:15,72980889,"15,200.4610","15,195.5610",05.00 AED,5.00,4.9000,0.1000,565788552,1604651,Success,United Arab Emirates,DU UAE,Transguard Group LLC,API User,E6AEAE17361
2022-02-23 15:19,72981062,"15,195.5610","15,190.6610",05.00 AED,5.00,4.9000,0.1000,565789064,1604655,Success,United Arab Emirates,DU UAE,Transguard Group LLC,API User,E6AEAE17361
2022-02-23 15:20,72981070,"15,190.6610","15,180.8610",10.00 AED,10.00,9.8000,0.2000,565789102,1604657,Success,United Arab Emirates,DU UAE,Transguard Group LLC,API User,E6AEAE22430
2022-02-23 15:25,72981243,"15,180.8610","15,171.0610",10.00 AED,10.00,9.8000,0.2000,565789664,1604663,Success,United Arab Emirates,DU UAE,Transguard Group LLC,API User,E6AEAE22430
2022-02-23 15:26,72981274,"15,171.0610","15,166.1610",05.00 AED,5.00,4.9000,0.1000,565789754,1604668,Success,United Arab Emirates,DU UAE,Transguard Group LLC,API User,E6AEAE17361
2022-02-23 15:26,72981303,"15,166.1610","15,161.2610",05.00 AED,5.00,4.9000,0.1000,565789830,1604672,Success,United Arab Emirates,DU UAE,Transguard Group LLC,API User,E6AEAE17361
2022-02-23 15:28,72981359,"15,161.2610","15,156.3610",05.00 AED,5.00,4.9000,0.1000,565789983,1604675,Success,United Arab Emirates,DU UAE,Transguard Group LLC,API User,E6AEAE17361
2022-02-23 15:33,72981533,"15,156.3610","15,151.4610",05.00 AED,5.00,4.9000,0.1000,565790485,1604678,Success,United Arab Emirates,DU UAE,Transguard Group LLC,API User,E6AEAE17361
2022-02-23 15:33,72981553,"15,151.4610","15,146.5610",05.00 AED,5.00,4.9000,0.1000,565790564,1604681,Success,United Arab Emirates,DU UAE,Transguard Group LLC,API User,E6AEAE17361
2022-02-23 15:40,72981789,"15,146.5610","15,141.6610",05.00 AED,5.00,4.9000,0.1000,565791344,1604686,Success,United Arab Emirates,DU UAE,Transguard Group LLC,API User,E6AEAE17361
2022-02-23 15:46,72982009,"15,141.6610","15,137.2610",401.00 NGN,5.00,4.4000,0.6000,565791997,1604691,Success,Nigeria,MTN Nigeria,Transguard Group LLC,API User,NG_MT_TopUp
2022-02-23 15:47,72982035,"15,137.2610","15,132.3610",05.00 AED,5.00,4.9000,0.1000,565792099,1604694,Success,United Arab Emirates,DU UAE,Transguard Group LLC,API User,E6AEAE17361
2022-02-23 15:48,72982060,"15,132.3610","15,127.4610",05.00 AED,5.00,4.9000,0.1000,565792197,1604697,Success,United Arab Emirates,DU UAE,Transguard Group LLC,API User,E6AEAE17361
2022-02-23 15:53,72982250,"15,127.4610","15,117.6610",10.00 AED,10.00,9.8000,0.2000,565792783,1604700,Success,United Arab Emirates,DU UAE,Transguard Group LLC,API User,E6AEAE22430
2022-02-23 15:55,72982313,"15,117.6610","15,112.7610",05.00 AED,5.00,4.9000,0.1000,565792970,1604706,Success,United Arab Emirates,DU UAE,Transguard Group LLC,API User,E6AEAE17361
2022-02-23 15:58,72982438,"15,112.7610","15,096.4810",200.00 PHP,18.50,16.2800,2.2200,565793326,1604713,Success,Philippines,Smart (SunCellular) Philippines,Transguard Group LLC,API User,PH_SM_TopUp_200.00
2022-02-23 15:59,72982462,"15,096.4810","15,083.5010",219.00 INR,14.75,12.9800,1.7700,565793419,1604715,Success,India,Vi India,Transguard Group LLC,API User,VFININ40021
2022-02-23 16:05,72982665,"15,083.5010","15,073.7010",10.00 AED,10.00,9.8000,0.2000,565794093,1604728,Success,United Arab Emirates,DU UAE,Transguard Group LLC,API User,E6AEAE22430
2022-02-23 16:06,72982702,"15,073.7010","15,068.8010",05.00 AED,5.00,4.9000,0.1000,565794196,1604732,Success,United Arab Emirates,DU UAE,Transguard Group LLC,API User,E6AEAE17361
2022-02-23 16:07,72982737,"15,068.8010","15,063.9010",05.00 AED,5.00,4.9000,0.1000,565794315,1604737,Success,United Arab Emirates,DU UAE,Transguard Group LLC,API User,E6AEAE17361
2022-02-23 16:07,72982742,"15,063.9010","15,059.0010",05.00 AED,5.00,4.9000,0.1000,565794334,1604738,Success,United Arab Emirates,DU UAE,Transguard Group LLC,API User,E6AEAE17361
2022-02-23 16:07,72982758,"15,059.0010","15,049.2010",10.00 AED,10.00,9.8000,0.2000,565794395,1604741,Success,United Arab Emirates,DU UAE,Transguard Group LLC,API User,E6AEAE22430
2022-02-23 16:09,72982791,"15,049.2010","15,039.4010",10.00 AED,10.00,9.8000,0.2000,565794509,1604744,Success,United Arab Emirates,DU UAE,Transguard Group LLC,API User,E6AEAE22430
2022-02-23 16:23,72983385,"15,039.4010","15,029.6010",10.00 AED,10.00,9.8000,0.2000,565796433,1604749,Success,United Arab Emirates,DU UAE,Transguard Group LLC,API User,E6AEAE22430
2022-02-23 16:28,72983558,"15,029.6010","15,024.7010",05.00 AED,5.00,4.9000,0.1000,565796992,1604754,Success,United Arab Emirates,DU UAE,Transguard Group LLC,API User,E6AEAE17361
2022-02-23 16:28,72983574,"15,024.7010","15,020.5210",150.00 PKR,4.75,4.1800,0.5700,565797050,1604757,Success,Pakistan,Ufone Pakistan,Transguard Group LLC,API User,UFPKPK90336
2022-02-23 16:31,72983692,"15,020.5210","14,991.1210",30.00 AED,30.00,29.4000,0.6000,565797400,1604762,Success,United Arab Emirates,DU UAE,Transguard Group LLC,API User,E6AEAE46146
2022-02-23 16:32,72983753,"14,991.1210","14,961.7210",30.00 AED,30.00,29.4000,0.6000,565797618,1604765,Success,United Arab Emirates,DU UAE,Transguard Group LLC,API User,E6AEAE46146
2022-02-23 16:37,72983954,"14,961.7210","14,956.8210",05.00 AED,5.00,4.9000,0.1000,565798214,1604770,Success,United Arab Emirates,DU UAE,Transguard Group LLC,API User,E6AEAE17361
2022-02-23 16:40,72984048,"14,956.8210","14,948.4610",100.00 PHP,9.50,8.3600,1.1400,565798573,1604777,Success,Philippines,Smart (SunCellular) Philippines,Transguard Group LLC,API User,PH_SM_TopUp_100.00
2022-02-23 16:44,72984193,"14,948.4610","14,943.5610",05.00 AED,5.00,4.9000,0.1000,565799013,1604782,Success,United Arab Emirates,DU UAE,Transguard Group LLC,API User,E6AEAE17361
2022-02-23 16:47,72984336,"14,943.5610","14,938.6610",05.00 AED,5.00,4.9000,0.1000,565799467,1604785,Success,United Arab Emirates,DU UAE,Transguard Group LLC,API User,E6AEAE17361
2022-02-23 16:48,72984372,"14,938.6610","14,933.7610",05.00 AED,5.00,4.9000,0.1000,565799577,1604788,Success,United Arab Emirates,DU UAE,Transguard Group LLC,API User,E6AEAE17361
2022-02-23 16:49,72984392,"14,933.7610","14,928.8610",05.00 AED,5.00,4.9000,0.1000,565799633,1604791,Success,United Arab Emirates,DU UAE,Transguard Group LLC,API User,E6AEAE17361
2022-02-23 16:49,72984425,"14,928.8610","14,923.9610",05.00 AED,5.00,4.9000,0.1000,565799757,1604794,Success,United Arab Emirates,DU UAE,Transguard Group LLC,API User,E6AEAE17361
2022-02-23 16:55,72984672,"14,923.9610","14,919.0610",05.00 AED,5.00,4.9000,0.1000,565800534,1604805,Success,United Arab Emirates,DU UAE,Transguard Group LLC,API User,E6AEAE17361
2022-02-23 16:57,72984735,"14,919.0610","14,914.1610",05.00 AED,5.00,4.9000,0.1000,565800708,1604808,Success,United Arab Emirates,DU UAE,Transguard Group LLC,API User,E6AEAE17361
2022-02-23 16:59,72984837,"14,914.1610","14,870.0610",45.00 AED,45.00,44.1000,0.9000,565800991,1604813,Success,United Arab Emirates,DU UAE,Transguard Group LLC,API User,E6AEAE35243
2022-02-23 17:01,72984900,"14,870.0610","14,865.1610",05.00 AED,5.00,4.9000,0.1000,565801176,1604819,Success,United Arab Emirates,DU UAE,Transguard Group LLC,API User,E6AEAE17361
2022-02-23 17:01,72984922,"14,865.1610","14,860.2610",05.00 AED,5.00,4.9000,0.1000,565801230,1604821,Success,United Arab Emirates,DU UAE,Transguard Group LLC,API User,E6AEAE17361
2022-02-23 17:02,72984956,"14,860.2610","14,850.4610",10.00 AED,10.00,9.8000,0.2000,565801324,1604828,Success,United Arab Emirates,DU UAE,Transguard Group LLC,API User,E6AEAE22430
2022-02-23 17:02,72984961,"14,850.4610","14,845.5610",05.00 AED,5.00,4.9000,0.1000,565801334,1604830,Success,United Arab Emirates,DU UAE,Transguard Group LLC,API User,E6AEAE17361
2022-02-23 17:02,72984979,"14,845.5610","14,840.6610",05.00 AED,5.00,4.9000,0.1000,565801400,1604835,Success,United Arab Emirates,DU UAE,Transguard Group LLC,API User,E6AEAE17361
2022-02-23 17:05,72985083,"14,840.6610","14,835.7610",05.00 AED,5.00,4.9000,0.1000,565801742,1604840,Success,United Arab Emirates,DU UAE,Transguard Group LLC,API User,E6AEAE17361
2022-02-23 17:09,72985245,"14,835.7610","14,825.9610",10.00 AED,10.00,9.8000,0.2000,565802275,1604849,Success,United Arab Emirates,DU UAE,Transguard Group LLC,API User,E6AEAE22430
2022-02-23 17:09,72985278,"14,825.9610","14,816.1610",10.00 AED,10.00,9.8000,0.2000,565802394,1604854,Success,United Arab Emirates,DU UAE,Transguard Group LLC,API User,E6AEAE22430
2022-02-23 17:11,72985339,"14,816.1610","14,811.2610",05.00 AED,5.00,4.9000,0.1000,565802565,1604857,Success,United Arab Emirates,DU UAE,Transguard Group LLC,API User,E6AEAE17361
2022-02-23 17:16,72985579,"14,811.2610","14,786.7610",25.00 AED,25.00,24.5000,0.5000,565803317,1604867,Success,United Arab Emirates,DU UAE,Transguard Group LLC,API User,E6AEAE17343
2022-02-23 17:19,72985740,"14,786.7610","14,776.9610",10.00 AED,10.00,9.8000,0.2000,565803838,1604878,Success,United Arab Emirates,DU UAE,Transguard Group LLC,API User,E6AEAE22430
2022-02-23 17:29,72986173,"14,776.9610","14,773.2210",100.00 NPR,4.25,3.7400,0.5100,565805252,1604884,Success,Nepal,Ncell Nepal,Transguard Group LLC,API User,NP_NC_TopUp_100.00
2022-02-23 17:37,72986586,"14,773.2210","14,768.3210",05.00 AED,5.00,4.9000,0.1000,565806570,1604892,Success,United Arab Emirates,DU UAE,Transguard Group LLC,API User,E6AEAE17361
2022-02-23 17:38,72986650,"14,768.3210","14,763.4210",05.00 AED,5.00,4.9000,0.1000,565806743,1604897,Success,United Arab Emirates,DU UAE,Transguard Group LLC,API User,E6AEAE17361
2022-02-23 17:39,72986718,"14,763.4210","14,758.5210",05.00 AED,5.00,4.9000,0.1000,565806937,1604901,Success,United Arab Emirates,DU UAE,Transguard Group LLC,API User,E6AEAE17361
2022-02-23 17:41,72986821,"14,758.5210","14,753.6210",05.00 AED,5.00,4.9000,0.1000,565807295,1604908,Success,United Arab Emirates,DU UAE,Transguard Group LLC,API User,E6AEAE17361
2022-02-23 17:42,72986845,"14,753.6210","14,743.8210",10.00 AED,10.00,9.8000,0.2000,565807349,1604910,Success,United Arab Emirates,DU UAE,Transguard Group LLC,API User,E6AEAE22430
2022-02-23 17:43,72986941,"14,743.8210","14,738.9210",05.00 AED,5.00,4.9000,0.1000,565807613,1604915,Success,United Arab Emirates,DU UAE,Transguard Group LLC,API User,E6AEAE17361
2022-02-23 17:45,72987039,"14,738.9210","14,734.0210",05.00 AED,5.00,4.9000,0.1000,565807896,1604920,Success,United Arab Emirates,DU UAE,Transguard Group LLC,API User,E6AEAE17361
2022-02-23 17:49,72987286,"14,734.0210","14,729.1210",05.00 AED,5.00,4.9000,0.1000,565808649,1604931,Success,United Arab Emirates,DU UAE,Transguard Group LLC,API User,E6AEAE17361
2022-02-23 17:50,72987314,"14,729.1210","14,724.2210",05.00 AED,5.00,4.9000,0.1000,565808738,1604937,Success,United Arab Emirates,DU UAE,Transguard Group LLC,API User,E6AEAE17361
2022-02-23 17:51,72987367,"14,724.2210","14,714.4210",10.00 AED,10.00,9.8000,0.2000,565808910,1604944,Success,United Arab Emirates,DU UAE,Transguard Group LLC,API User,E6AEAE22430
2022-02-23 17:52,72987426,"14,714.4210","14,709.5210",05.00 AED,5.00,4.9000,0.1000,565809080,1604945,Success,United Arab Emirates,DU UAE,Transguard Group LLC,API User,E6AEAE17361
2022-02-23 17:55,72987563,"14,709.5210","14,705.3410",150.00 PKR,4.75,4.1800,0.5700,565809511,1604954,Success,Pakistan,Jazz Pakistan,Transguard Group LLC,API User,MBPKPK20699
2022-02-23 17:56,72987631,"14,705.3410","14,700.4410",05.00 AED,5.00,4.9000,0.1000,565809735,1604957,Success,United Arab Emirates,DU UAE,Transguard Group LLC,API User,E6AEAE17361
2022-02-23 18:01,72987840,"14,700.4410","14,690.6410",10.00 AED,10.00,9.8000,0.2000,565810523,1604962,Success,United Arab Emirates,DU UAE,Transguard Group LLC,API User,E6AEAE22430
2022-02-23 18:03,72987968,"14,690.6410","14,680.8410",10.00 AED,10.00,9.8000,0.2000,565810935,1604965,Success,United Arab Emirates,DU UAE,Transguard Group LLC,API User,E6AEAE22430
2022-02-23 18:04,72988025,"14,680.8410","14,675.9410",05.00 AED,5.00,4.9000,0.1000,565811103,1604969,Success,United Arab Emirates,DU UAE,Transguard Group LLC,API User,E6AEAE17361
2022-02-23 18:07,72988167,"14,675.9410","14,666.1410",10.00 AED,10.00,9.8000,0.2000,565811566,1604980,Success,United Arab Emirates,DU UAE,Transguard Group LLC,API User,E6AEAE22430
2022-02-23 18:09,72988288,"14,666.1410","14,661.2410",05.00 AED,5.00,4.9000,0.1000,565811953,1604985,Success,United Arab Emirates,DU UAE,Transguard Group LLC,API User,E6AEAE17361
2022-02-23 18:09,72988310,"14,661.2410","14,651.4410",10.00 AED,10.00,9.8000,0.2000,565812012,1604987,Success,United Arab Emirates,DU UAE,Transguard Group LLC,API User,E6AEAE22430
2022-02-23 18:10,72988331,"14,651.4410","14,646.5410",05.00 AED,5.00,4.9000,0.1000,565812083,1604990,Success,United Arab Emirates,DU UAE,Transguard Group LLC,API User,E6AEAE17361
2022-02-23 18:11,72988380,"14,646.5410","14,636.7410",10.00 AED,10.00,9.8000,0.2000,565812230,1604993,Success,United Arab Emirates,DU UAE,Transguard Group LLC,API User,E6AEAE22430
2022-02-23 18:12,72988473,"14,636.7410","14,626.9410",10.00 AED,10.00,9.8000,0.2000,565812510,1604998,Success,United Arab Emirates,DU UAE,Transguard Group LLC,API User,E6AEAE22430
2022-02-23 18:12,72988489,"14,626.9410","14,622.0410",05.00 AED,5.00,4.9000,0.1000,565812564,1604999,Success,United Arab Emirates,DU UAE,Transguard Group LLC,API User,E6AEAE17361
2022-02-23 18:13,72988554,"14,622.0410","14,612.2410",10.00 AED,10.00,9.8000,0.2000,565812737,1605002,Success,United Arab Emirates,DU UAE,Transguard Group LLC,API User,E6AEAE22430
2022-02-23 18:18,72988848,"14,612.2410","14,597.7210",399.00 NPR,16.50,14.5200,1.9800,565813603,1605015,Success,Nepal,Ncell Nepal,Transguard Group LLC,API User,NCNPNP63507
2022-02-23 18:19,72988930,"14,597.7210","14,592.8210",05.00 AED,5.00,4.9000,0.1000,565813846,1605019,Success,United Arab Emirates,DU UAE,Transguard Group LLC,API User,E6AEAE17361
2022-02-23 18:20,72988950,"14,592.8210","14,583.0210",10.00 AED,10.00,9.8000,0.2000,565813927,1605021,Success,United Arab Emirates,DU UAE,Transguard Group LLC,API User,E6AEAE22430
2022-02-23 18:29,72989499,"14,583.0210","14,578.1210",05.00 AED,5.00,4.9000,0.1000,565815528,1605033,Success,United Arab Emirates,DU UAE,Transguard Group LLC,API User,E6AEAE17361
2022-02-23 18:29,72989521,"14,578.1210","14,568.3210",10.00 AED,10.00,9.8000,0.2000,565815581,1605035,Success,United Arab Emirates,DU UAE,Transguard Group LLC,API User,E6AEAE22430
2022-02-23 18:31,72989646,"14,568.3210","14,564.5810",102.00 NPR,4.25,3.7400,0.5100,565816021,1605044,Failure,Nepal,Nepal Telecom Nepal,Transguard Group LLC,API User,NENPNP19715
2022-02-23 18:31,72989646,"14,564.5810","14,560.8410",102.00 NPR,4.25,3.7400,0.5100,565816021,1605044,Failure,Nepal,Nepal Telecom Nepal,Transguard Group LLC,API User,NENPNP19715
2022-02-23 18:36,72989950,"14,568.3210","14,558.5210",10.00 AED,10.00,9.8000,0.2000,565816855,1605047,Success,United Arab Emirates,DU UAE,Transguard Group LLC,API User,E6AEAE22430
2022-02-23 18:45,72990566,"14,558.5210","14,548.7210",10.00 AED,10.00,9.8000,0.2000,565818728,1605061,Success,United Arab Emirates,DU UAE,Transguard Group LLC,API User,E6AEAE22430
2022-02-23 18:49,72990817,"14,548.7210","14,538.9210",10.00 AED,10.00,9.8000,0.2000,565819423,1605069,Success,United Arab Emirates,DU UAE,Transguard Group LLC,API User,E6AEAE22430
2022-02-23 18:50,72990853,"14,538.9210","14,534.0210",05.00 AED,5.00,4.9000,0.1000,565819549,1605072,Success,United Arab Emirates,DU UAE,Transguard Group LLC,API User,E6AEAE17361
2022-02-23 18:52,72990994,"14,534.0210","14,524.2210",10.00 AED,10.00,9.8000,0.2000,565819999,1605081,Success,United Arab Emirates,DU UAE,Transguard Group LLC,API User,E6AEAE22430
2022-02-23 18:52,72991034,"14,524.2210","14,514.4210",10.00 AED,10.00,9.8000,0.2000,565820112,1605086,Success,United Arab Emirates,DU UAE,Transguard Group LLC,API User,E6AEAE22430
2022-02-23 18:53,72991048,"14,514.4210","14,509.5210",05.00 AED,5.00,4.9000,0.1000,565820138,1605087,Success,United Arab Emirates,DU UAE,Transguard Group LLC,API User,E6AEAE17361
2022-02-23 18:53,72991105,"14,509.5210","14,501.1610",300.00 PKR,9.50,8.3600,1.1400,565820316,1605091,Success,Pakistan,Jazz Pakistan,Transguard Group LLC,API User,PK_MB_TopUp_300.00
2022-02-23 19:03,72991801,"14,501.1610","14,461.9610",40.00 AED,40.00,39.2000,0.8000,565822158,1605111,Success,United Arab Emirates,DU UAE,Transguard Group LLC,API User,E6AEAE64011
2022-02-23 19:06,72991985,"14,461.9610","14,452.1610",10.00 AED,10.00,9.8000,0.2000,565822707,1605114,Success,United Arab Emirates,DU UAE,Transguard Group LLC,API User,E6AEAE22430
2022-02-23 19:07,72992061,"14,452.1610","14,447.2610",05.00 AED,5.00,4.9000,0.1000,565822904,1605120,Success,United Arab Emirates,DU UAE,Transguard Group LLC,API User,E6AEAE17361
2022-02-23 19:14,72992637,"14,447.2610","14,444.1810",50.00 INR,3.50,3.0800,0.4200,565824517,1605140,Success,India,Vi India,Transguard Group LLC,API User,VFININ24286
2022-02-23 19:20,72993051,"14,444.1810","14,439.2810",05.00 AED,5.00,4.9000,0.1000,565825643,1605155,Success,United Arab Emirates,DU UAE,Transguard Group LLC,API User,E6AEAE17361
2022-02-23 19:24,72993317,"14,439.2810","14,434.3810",05.00 AED,5.00,4.9000,0.1000,565826409,1605163,Success,United Arab Emirates,DU UAE,Transguard Group LLC,API User,E6AEAE17361
2022-02-23 19:27,72993552,"14,434.3810","14,429.4810",05.00 AED,5.00,4.9000,0.1000,565827058,1605167,Success,United Arab Emirates,DU UAE,Transguard Group LLC,API User,E6AEAE17361
2022-02-23 19:28,72993682,"14,429.4810","14,424.5810",05.00 AED,5.00,4.9000,0.1000,565827435,1605175,Success,United Arab Emirates,DU UAE,Transguard Group LLC,API User,E6AEAE17361
2022-02-23 19:29,72993707,"14,424.5810","14,414.7810",10.00 AED,10.00,9.8000,0.2000,565827520,1605177,Success,United Arab Emirates,DU UAE,Transguard Group LLC,API User,E6AEAE22430
2022-02-23 19:31,72993885,"14,414.7810","14,409.8810",05.00 AED,5.00,4.9000,0.1000,565828053,1605186,Success,United Arab Emirates,DU UAE,Transguard Group LLC,API User,E6AEAE17361
2022-02-23 19:32,72993911,"14,409.8810","14,400.0810",10.00 AED,10.00,9.8000,0.2000,565828105,1605188,Success,United Arab Emirates,DU UAE,Transguard Group LLC,API User,E6AEAE22430
2022-02-23 19:33,72993987,"14,400.0810","14,395.1810",05.00 AED,5.00,4.9000,0.1000,565828303,1605193,Success,United Arab Emirates,DU UAE,Transguard Group LLC,API User,E6AEAE17361
2022-02-23 19:33,72993994,"14,395.1810","14,390.2810",05.00 AED,5.00,4.9000,0.1000,565828336,1605194,Success,United Arab Emirates,DU UAE,Transguard Group LLC,API User,E6AEAE17361
2022-02-23 19:35,72994156,"14,390.2810","14,346.2810","36,679.00 UGX",50.00,44.0000,6.0000,565828849,1605201,Success,Uganda,Airtel Uganda,Transguard Group LLC,API User,UG_WA_TopUp
2022-02-23 19:36,72994198,"14,346.2810","14,341.3810",05.00 AED,5.00,4.9000,0.1000,565828953,1605209,Success,United Arab Emirates,DU UAE,Transguard Group LLC,API User,E6AEAE17361
2022-02-23 19:36,72994204,"14,341.3810","14,337.2010",150.00 PKR,4.75,4.1800,0.5700,565828987,1605210,Success,Pakistan,Jazz Pakistan,Transguard Group LLC,API User,MBPKPK20699
2022-02-23 19:36,72994224,"14,337.2010","14,327.4010",10.00 AED,10.00,9.8000,0.2000,565829041,1605214,Success,United Arab Emirates,DU UAE,Transguard Group LLC,API User,E6AEAE22430
2022-02-23 19:36,72994232,"14,327.4010","14,322.5010",05.00 AED,5.00,4.9000,0.1000,565829065,1605215,Success,United Arab Emirates,DU UAE,Transguard Group LLC,API User,E6AEAE17361
2022-02-23 19:37,72994275,"14,322.5010","14,312.7010",10.00 AED,10.00,9.8000,0.2000,565829198,1605220,Success,United Arab Emirates,DU UAE,Transguard Group LLC,API User,E6AEAE22430
2022-02-23 19:37,72994303,"14,312.7010","14,307.8010",05.00 AED,5.00,4.9000,0.1000,565829274,1605225,Success,United Arab Emirates,DU UAE,Transguard Group LLC,API User,E6AEAE17361
2022-02-23 19:37,72994311,"14,307.8010","14,302.9010",05.00 AED,5.00,4.9000,0.1000,565829296,1605226,Success,United Arab Emirates,DU UAE,Transguard Group LLC,API User,E6AEAE17361
2022-02-23 19:41,72994533,"14,302.9010","14,298.0010",05.00 AED,5.00,4.9000,0.1000,565829961,1605239,Success,United Arab Emirates,DU UAE,Transguard Group LLC,API User,E6AEAE17361
2022-02-23 19:41,72994577,"14,298.0010","14,289.6410",300.00 PKR,9.50,8.3600,1.1400,565830084,1605242,Success,Pakistan,Jazz Pakistan,Transguard Group LLC,API User,PK_MB_TopUp_300.00
2022-02-23 19:43,72994708,"14,289.6410","14,279.8410",10.00 AED,10.00,9.8000,0.2000,565830519,1605245,Success,United Arab Emirates,DU UAE,Transguard Group LLC,API User,E6AEAE22430
2022-02-23 19:45,72994798,"14,279.8410","14,274.9410",05.00 AED,5.00,4.9000,0.1000,565830794,1605249,Success,United Arab Emirates,DU UAE,Transguard Group LLC,API User,E6AEAE17361
2022-02-23 19:51,72995197,"14,274.9410","14,270.0410",05.00 AED,5.00,4.9000,0.1000,565831933,1605262,Success,United Arab Emirates,DU UAE,Transguard Group LLC,API User,E6AEAE17361
2022-02-23 19:51,72995218,"14,270.0410","14,265.1410",05.00 AED,5.00,4.9000,0.1000,565831983,1605263,Success,United Arab Emirates,DU UAE,Transguard Group LLC,API User,E6AEAE17361
2022-02-23 19:53,72995405,"14,265.1410","14,211.2410",55.00 AED,55.00,53.9000,1.1000,565832538,1605273,Failure,United Arab Emirates,DU UAE,Transguard Group LLC,API User,E6AEAE81767
2022-02-23 19:53,72995405,"14,211.2410","14,157.3410",55.00 AED,55.00,53.9000,1.1000,565832538,1605273,Failure,United Arab Emirates,DU UAE,Transguard Group LLC,API User,E6AEAE81767
2022-02-23 19:57,72995634,"14,265.1410","14,230.8410",35.00 AED,35.00,34.3000,0.7000,565833329,1605285,Success,United Arab Emirates,DU UAE,Transguard Group LLC,API User,E6AEAE73954
2022-02-23 20:05,72996153,"14,230.8410","14,226.6610",150.00 PKR,4.75,4.1800,0.5700,565834871,1605298,Success,Pakistan,Zong Pakistan,Transguard Group LLC,API User,ZNPKPK65621
2022-02-23 20:07,72996345,"14,226.6610","14,221.7610",05.00 AED,5.00,4.9000,0.1000,565835414,1605308,Success,United Arab Emirates,DU UAE,Transguard Group LLC,API User,E6AEAE17361
2022-02-23 20:11,72996593,"14,221.7610","14,211.9610",10.00 AED,10.00,9.8000,0.2000,565836202,1605316,Success,United Arab Emirates,DU UAE,Transguard Group LLC,API User,E6AEAE22430
2022-02-23 20:13,72996783,"14,211.9610","14,202.1610",10.00 AED,10.00,9.8000,0.2000,565836695,1605323,Success,United Arab Emirates,DU UAE,Transguard Group LLC,API User,E6AEAE22430
2022-02-23 20:16,72996978,"14,202.1610","14,197.2610",05.00 AED,5.00,4.9000,0.1000,565837303,1605328,Success,United Arab Emirates,DU UAE,Transguard Group LLC,API User,E6AEAE17361
2022-02-23 20:19,72997210,"14,197.2610","14,192.3610",05.00 AED,5.00,4.9000,0.1000,565837909,1605332,Success,United Arab Emirates,DU UAE,Transguard Group LLC,API User,E6AEAE17361
2022-02-23 20:20,72997252,"14,192.3610","14,188.6210",151.00 PKR,4.25,3.7400,0.5100,565838032,1605337,Success,Pakistan,Telenor Pakistan,Transguard Group LLC,API User,TPPKPK94108
2022-02-23 20:23,72997487,"14,188.6210","14,178.8210",10.00 AED,10.00,9.8000,0.2000,565838685,1605343,Success,United Arab Emirates,DU UAE,Transguard Group LLC,API User,E6AEAE22430
2022-02-23 20:23,72997529,"14,178.8210","14,173.9210",05.00 AED,5.00,4.9000,0.1000,565838811,1605348,Success,United Arab Emirates,DU UAE,Transguard Group LLC,API User,E6AEAE17361
2022-02-23 20:24,72997600,"14,173.9210","14,164.1210",10.00 AED,10.00,9.8000,0.2000,565839048,1605351,Success,United Arab Emirates,DU UAE,Transguard Group LLC,API User,E6AEAE22430
2022-02-23 20:26,72997746,"14,164.1210","14,154.3210",10.00 AED,10.00,9.8000,0.2000,565839480,1605358,Success,United Arab Emirates,DU UAE,Transguard Group LLC,API User,E6AEAE22430
2022-02-23 20:34,72998238,"14,154.3210","14,104.8210",13.35 USD,50.00,49.5000,0.5000,565840979,1605373,Success,United Arab Emirates,Amazon UAE,Transguard Group LLC,API User,2AAEAE98637
2022-02-23 20:34,72998245,"14,104.8210","14,095.0210",10.00 AED,10.00,9.8000,0.2000,565841003,1605374,Success,United Arab Emirates,DU UAE,Transguard Group LLC,API User,E6AEAE22430
2022-02-23 20:35,72998308,"14,095.0210","14,085.2210",10.00 AED,10.00,9.8000,0.2000,565841200,1605379,Success,United Arab Emirates,DU UAE,Transguard Group LLC,API User,E6AEAE22430
2022-02-23 20:39,72998588,"14,085.2210","14,075.4210",10.00 AED,10.00,9.8000,0.2000,565842073,1605386,Success,United Arab Emirates,DU UAE,Transguard Group LLC,API User,E6AEAE22430
2022-02-23 20:41,72998686,"14,075.4210","14,070.5210",05.00 AED,5.00,4.9000,0.1000,565842462,1605392,Success,United Arab Emirates,DU UAE,Transguard Group LLC,API User,E6AEAE17361
2022-02-23 20:43,72998832,"14,070.5210","14,065.6210",05.00 AED,5.00,4.9000,0.1000,565842889,1605396,Success,United Arab Emirates,DU UAE,Transguard Group LLC,API User,E6AEAE17361
2022-02-23 20:44,72998907,"14,065.6210","14,046.0210",20.00 AED,20.00,19.6000,0.4000,565843083,1605400,Success,United Arab Emirates,DU UAE,Transguard Group LLC,API User,E6AEAE12938
2022-02-23 20:46,72999059,"14,046.0210","14,041.1210",05.00 AED,5.00,4.9000,0.1000,565843544,1605411,Success,United Arab Emirates,DU UAE,Transguard Group LLC,API User,E6AEAE17361
2022-02-23 20:47,72999102,"14,041.1210","14,036.2210",05.00 AED,5.00,4.9000,0.1000,565843672,1605417,Success,United Arab Emirates,DU UAE,Transguard Group LLC,API User,E6AEAE17361
2022-02-23 20:50,72999289,"14,036.2210","14,026.4210",10.00 AED,10.00,9.8000,0.2000,565844190,1605425,Success,United Arab Emirates,DU UAE,Transguard Group LLC,API User,E6AEAE22430
2022-02-23 20:51,72999379,"14,026.4210","14,021.5210",05.00 AED,5.00,4.9000,0.1000,565844495,1605435,Success,United Arab Emirates,DU UAE,Transguard Group LLC,API User,E6AEAE17361
2022-02-23 20:51,72999390,"14,021.5210","14,016.6210",05.00 AED,5.00,4.9000,0.1000,565844524,1605436,Success,United Arab Emirates,DU UAE,Transguard Group LLC,API User,E6AEAE17361
2022-02-23 20:53,72999557,"14,016.6210","13,997.0210",20.00 AED,20.00,19.6000,0.4000,565844983,1605447,Success,United Arab Emirates,DU UAE,Transguard Group LLC,API User,E6AEAE12938
2022-02-23 20:53,72999563,"13,997.0210","13,987.2210",10.00 AED,10.00,9.8000,0.2000,565844999,1605448,Success,United Arab Emirates,DU UAE,Transguard Group LLC,API User,E6AEAE22430
2022-02-23 20:54,72999589,"13,987.2210","13,982.3210",05.00 AED,5.00,4.9000,0.1000,565845089,1605450,Success,United Arab Emirates,DU UAE,Transguard Group LLC,API User,E6AEAE17361
2022-02-23 20:55,72999685,"13,982.3210","13,977.4210",05.00 AED,5.00,4.9000,0.1000,565845349,1605455,Failure,United Arab Emirates,DU UAE,Transguard Group LLC,API User,E6AEAE17361
2022-02-23 20:55,72999685,"13,977.4210","13,972.5210",05.00 AED,5.00,4.9000,0.1000,565845349,1605455,Failure,United Arab Emirates,DU UAE,Transguard Group LLC,API User,E6AEAE17361
2022-02-23 20:58,72999879,"13,982.3210","13,972.5210",10.00 AED,10.00,9.8000,0.2000,565845918,1605462,Success,United Arab Emirates,DU UAE,Transguard Group LLC,API User,E6AEAE22430
2022-02-23 21:02,73000147,"13,972.5210","13,962.7210",10.00 AED,10.00,9.8000,0.2000,565846719,1605467,Success,United Arab Emirates,DU UAE,Transguard Group LLC,API User,E6AEAE22430
2022-02-23 21:03,73000188,"13,962.7210","13,952.9210",10.00 AED,10.00,9.8000,0.2000,565846828,1605471,Success,United Arab Emirates,DU UAE,Transguard Group LLC,API User,E6AEAE22430
2022-02-23 21:13,73000856,"13,952.9210","13,948.0210",05.00 AED,5.00,4.9000,0.1000,565848810,1605491,Success,United Arab Emirates,DU UAE,Transguard Group LLC,API User,E6AEAE17361
2022-02-23 21:14,73000925,"13,948.0210","13,933.3210",15.00 AED,15.00,14.7000,0.3000,565848980,1605497,Success,United Arab Emirates,DU UAE,Transguard Group LLC,API User,E6AEAE8527
2022-02-23 21:16,73001055,"13,933.3210","13,899.0210",35.00 AED,35.00,34.3000,0.7000,565849382,1605503,Success,United Arab Emirates,DU UAE,Transguard Group LLC,API User,E6AEAE73954
2022-02-23 21:17,73001100,"13,899.0210","13,894.1210",05.00 AED,5.00,4.9000,0.1000,565849494,1605506,Success,United Arab Emirates,DU UAE,Transguard Group LLC,API User,E6AEAE17361
2022-02-23 21:19,73001237,"13,894.1210","13,884.3210",10.00 AED,10.00,9.8000,0.2000,565849929,1605514,Success,United Arab Emirates,DU UAE,Transguard Group LLC,API User,E6AEAE22430
2022-02-23 21:23,73001481,"13,884.3210","13,879.4210",05.00 AED,5.00,4.9000,0.1000,565850755,1605526,Success,United Arab Emirates,DU UAE,Transguard Group LLC,API User,E6AEAE17361
2022-02-23 21:26,73001604,"13,879.4210","13,869.6210",10.00 AED,10.00,9.8000,0.2000,565851168,1605529,Success,United Arab Emirates,DU UAE,Transguard Group LLC,API User,E6AEAE22430
2022-02-23 21:29,73001792,"13,869.6210","13,864.7210",05.00 AED,5.00,4.9000,0.1000,565851733,1605532,Success,United Arab Emirates,DU UAE,Transguard Group LLC,API User,E6AEAE17361
2022-02-23 21:33,73002067,"13,864.7210","13,854.9210",10.00 AED,10.00,9.8000,0.2000,565852518,1605535,Success,United Arab Emirates,DU UAE,Transguard Group LLC,API User,E6AEAE22430
2022-02-23 21:33,73002101,"13,854.9210","13,850.0210",05.00 AED,5.00,4.9000,0.1000,565852652,1605538,Success,United Arab Emirates,DU UAE,Transguard Group LLC,API User,E6AEAE17361
2022-02-23 21:39,73002463,"13,850.0210","13,845.1210",05.00 AED,5.00,4.9000,0.1000,565853735,1605545,Success,United Arab Emirates,DU UAE,Transguard Group LLC,API User,E6AEAE17361
2022-02-23 21:44,73002720,"13,845.1210","13,835.3210",10.00 AED,10.00,9.8000,0.2000,565854628,1605551,Success,United Arab Emirates,DU UAE,Transguard Group LLC,API User,E6AEAE22430
2022-02-23 21:47,73002929,"13,835.3210","13,830.4210",05.00 AED,5.00,4.9000,0.1000,565855318,1605560,Success,United Arab Emirates,DU UAE,Transguard Group LLC,API User,E6AEAE17361
2022-02-23 21:49,73003058,"13,830.4210","13,825.5210",05.00 AED,5.00,4.9000,0.1000,565855708,1605563,Success,United Arab Emirates,DU UAE,Transguard Group LLC,API User,E6AEAE17361
2022-02-23 21:51,73003159,"13,825.5210","13,815.7210",10.00 AED,10.00,9.8000,0.2000,565856077,1605566,Success,United Arab Emirates,DU UAE,Transguard Group LLC,API User,E6AEAE22430
2022-02-23 21:55,73003368,"13,815.7210","13,776.5210",40.00 AED,40.00,39.2000,0.8000,565856774,1605573,Success,United Arab Emirates,DU UAE,Transguard Group LLC,API User,E6AEAE64011
2022-02-23 21:57,73003451,"13,776.5210","13,766.7210",10.00 AED,10.00,9.8000,0.2000,565857038,1605578,Success,United Arab Emirates,DU UAE,Transguard Group LLC,API User,E6AEAE22430
2022-02-23 21:59,73003564,"13,766.7210","13,761.8210",05.00 AED,5.00,4.9000,0.1000,565857419,1605581,Success,United Arab Emirates,DU UAE,Transguard Group LLC,API User,E6AEAE17361
2022-02-23 21:59,73003586,"13,761.8210","13,756.9210",05.00 AED,5.00,4.9000,0.1000,565857501,1605586,Success,United Arab Emirates,DU UAE,Transguard Group LLC,API User,E6AEAE17361
2022-02-23 22:00,73003596,"13,756.9210","13,752.0210",05.00 AED,5.00,4.9000,0.1000,565857536,1605588,Success,United Arab Emirates,DU UAE,Transguard Group LLC,API User,E6AEAE17361
2022-02-23 22:01,73003651,"13,752.0210","13,732.4210",20.00 AED,20.00,19.6000,0.4000,565857719,1605592,Success,United Arab Emirates,DU UAE,Transguard Group LLC,API User,E6AEAE12938
2022-02-23 22:01,73003686,"13,732.4210","13,727.5210",05.00 AED,5.00,4.9000,0.1000,565857800,1605596,Success,United Arab Emirates,DU UAE,Transguard Group LLC,API User,E6AEAE17361
2022-02-23 22:02,73003750,"13,727.5210","13,717.7210",10.00 AED,10.00,9.8000,0.2000,565857973,1605600,Success,United Arab Emirates,DU UAE,Transguard Group LLC,API User,E6AEAE22430
2022-02-23 22:05,73003884,"13,717.7210","13,712.8210",05.00 AED,5.00,4.9000,0.1000,565858398,1605607,Success,United Arab Emirates,DU UAE,Transguard Group LLC,API User,E6AEAE17361
2022-02-23 22:05,73003915,"13,712.8210","13,703.0210",10.00 AED,10.00,9.8000,0.2000,565858487,1605612,Success,United Arab Emirates,DU UAE,Transguard Group LLC,API User,E6AEAE22430
2022-02-23 22:09,73004088,"13,703.0210","13,693.2210",10.00 AED,10.00,9.8000,0.2000,565859096,1605616,Success,United Arab Emirates,DU UAE,Transguard Group LLC,API User,E6AEAE22430
2022-02-23 22:10,73004141,"13,693.2210","13,683.4210",10.00 AED,10.00,9.8000,0.2000,565859325,1605625,Success,United Arab Emirates,DU UAE,Transguard Group LLC,API User,E6AEAE22430
2022-02-23 22:10,73004142,"13,683.4210","13,675.0610",160.00 BDT,9.50,8.3600,1.1400,565859338,1605626,Success,Bangladesh,Robi Bangladesh,Transguard Group LLC,API User,RLBDBD49797
2022-02-23 22:10,73004148,"13,675.0610","13,670.1610",05.00 AED,5.00,4.9000,0.1000,565859354,1605627,Success,United Arab Emirates,DU UAE,Transguard Group LLC,API User,E6AEAE17361
2022-02-23 22:18,73004528,"13,670.1610","13,660.3610",10.00 AED,10.00,9.8000,0.2000,565860592,1605640,Success,United Arab Emirates,DU UAE,Transguard Group LLC,API User,E6AEAE22430
2022-02-23 22:18,73004534,"13,660.3610","13,655.4610",05.00 AED,5.00,4.9000,0.1000,565860610,1605641,Success,United Arab Emirates,DU UAE,Transguard Group LLC,API User,E6AEAE17361
2022-02-23 22:19,73004580,"13,655.4610","13,650.5610",05.00 AED,5.00,4.9000,0.1000,565860810,1605650,Success,United Arab Emirates,DU UAE,Transguard Group LLC,API User,E6AEAE17361
2022-02-23 22:20,73004630,"13,650.5610","13,645.6610",05.00 AED,5.00,4.9000,0.1000,565861006,1605653,Success,United Arab Emirates,DU UAE,Transguard Group LLC,API User,E6AEAE17361
2022-02-23 22:21,73004688,"13,645.6610","13,640.7610",05.00 AED,5.00,4.9000,0.1000,565861211,1605659,Success,United Arab Emirates,DU UAE,Transguard Group LLC,API User,E6AEAE17361
2022-02-23 22:22,73004695,"13,640.7610","13,630.9610",10.00 AED,10.00,9.8000,0.2000,565861229,1605660,Success,United Arab Emirates,DU UAE,Transguard Group LLC,API User,E6AEAE22430
2022-02-23 22:22,73004705,"13,630.9610","13,623.7010",200.00 NPR,8.25,7.2600,0.9900,565861262,1605662,Success,Nepal,Nepal Telecom Nepal,Transguard Group LLC,API User,NP_NE_TopUp_200.00
2022-02-23 22:23,73004756,"13,623.7010","13,613.9010",10.00 AED,10.00,9.8000,0.2000,565861401,1605665,Success,United Arab Emirates,DU UAE,Transguard Group LLC,API User,E6AEAE22430
2022-02-23 22:25,73004873,"13,613.9010","13,609.0010",05.00 AED,5.00,4.9000,0.1000,565861803,1605670,Success,United Arab Emirates,DU UAE,Transguard Group LLC,API User,E6AEAE17361
2022-02-23 22:27,73004926,"13,609.0010","13,604.1010",05.00 AED,5.00,4.9000,0.1000,565862023,1605675,Success,United Arab Emirates,DU UAE,Transguard Group LLC,API User,E6AEAE17361
2022-02-23 22:32,73005147,"13,604.1010","13,599.2010",05.00 AED,5.00,4.9000,0.1000,565862807,1605682,Success,United Arab Emirates,DU UAE,Transguard Group LLC,API User,E6AEAE17361
2022-02-23 23:01,73006491,"13,599.2010","13,586.4410",250.00 BDT,14.50,12.7600,1.7400,565867286,1605712,Success,Bangladesh,Grameenphone Bangladesh,Transguard Group LLC,API User,GEBDBD26956
2022-02-23 23:06,73006734,"13,586.4410","13,581.5410",05.00 AED,5.00,4.9000,0.1000,565868061,1605719,Success,United Arab Emirates,DU UAE,Transguard Group LLC,API User,E6AEAE17361
2022-02-23 23:20,73007252,"13,581.5410","13,576.6410",05.00 AED,5.00,4.9000,0.1000,565870000,1605728,Success,United Arab Emirates,DU UAE,Transguard Group LLC,API User,E6AEAE17361
2022-02-23 23:20,73007258,"13,576.6410","13,571.7410",05.00 AED,5.00,4.9000,0.1000,565870024,1605730,Success,United Arab Emirates,DU UAE,Transguard Group LLC,API User,E6AEAE17361
2022-02-23 23:20,73007269,"13,571.7410","13,561.9410",10.00 AED,10.00,9.8000,0.2000,565870057,1605732,Success,United Arab Emirates,DU UAE,Transguard Group LLC,API User,E6AEAE22430
2022-02-23 23:50,73008268,"13,561.9410","13,552.1410",10.00 AED,10.00,9.8000,0.2000,565873944,1605752,Success,United Arab Emirates,DU UAE,Transguard Group LLC,API User,E6AEAE22430
2022-02-24 00:05,73008740,"13,552.1410","13,532.5410",20.00 AED,20.00,19.6000,0.4000,565875794,1605755,Success,United Arab Emirates,DU UAE,Transguard Group LLC,API User,E6AEAE12938
2022-02-24 00:08,73008828,"13,532.5410","13,527.6410",05.00 AED,5.00,4.9000,0.1000,565876197,1605758,Success,United Arab Emirates,DU UAE,Transguard Group LLC,API User,E6AEAE17361
2022-02-24 00:30,73009404,"13,527.6410","13,508.0410",20.00 AED,20.00,19.6000,0.4000,565878701,1605769,Success,United Arab Emirates,DU UAE,Transguard Group LLC,API User,E6AEAE12938
2022-02-24 00:32,73009471,"13,508.0410","13,493.5210",399.00 NPR,16.50,14.5200,1.9800,565878946,1605773,Success,Nepal,Ncell Nepal,Transguard Group LLC,API User,NCNPNP63507
2022-02-24 00:33,73009493,"13,493.5210","13,488.6210",05.00 AED,5.00,4.9000,0.1000,565879011,1605778,Success,United Arab Emirates,DU UAE,Transguard Group LLC,API User,E6AEAE17361
2022-02-24 00:34,73009522,"13,488.6210","13,444.5210",45.00 AED,45.00,44.1000,0.9000,565879107,1605780,Success,United Arab Emirates,DU UAE,Transguard Group LLC,API User,E6AEAE35243
2022-02-24 00:34,73009541,"13,444.5210","13,439.6210",05.00 AED,5.00,4.9000,0.1000,565879194,1605783,Success,United Arab Emirates,DU UAE,Transguard Group LLC,API User,E6AEAE17361
2022-02-24 01:31,73011100,"13,439.6210","13,434.7210",05.00 AED,5.00,4.9000,0.1000,565885518,1605796,Success,United Arab Emirates,DU UAE,Transguard Group LLC,API User,E6AEAE17361
2022-02-24 01:32,73011122,"13,434.7210","13,429.8210",05.00 AED,5.00,4.9000,0.1000,565885583,1605799,Success,United Arab Emirates,DU UAE,Transguard Group LLC,API User,E6AEAE17361
2022-02-24 01:33,73011163,"13,429.8210","13,420.0210",10.00 AED,10.00,9.8000,0.2000,565885750,1605802,Success,United Arab Emirates,DU UAE,Transguard Group LLC,API User,E6AEAE22430
2022-02-24 01:37,73011290,"13,420.0210","13,415.1210",05.00 AED,5.00,4.9000,0.1000,565886218,1605805,Success,United Arab Emirates,DU UAE,Transguard Group LLC,API User,E6AEAE17361
2022-02-24 02:03,73012238,"13,415.1210","13,405.3210",10.00 AED,10.00,9.8000,0.2000,565889351,1605808,Success,United Arab Emirates,DU UAE,Transguard Group LLC,API User,E6AEAE22430
2022-02-24 02:51,73013727,"13,405.3210","13,400.4210",05.00 AED,5.00,4.9000,0.1000,565895123,1605811,Success,United Arab Emirates,DU UAE,Transguard Group LLC,API User,E6AEAE17361
2022-02-24 02:52,73013771,"13,400.4210","13,390.6210",10.00 AED,10.00,9.8000,0.2000,565895268,1605816,Failure,United Arab Emirates,DU UAE,Transguard Group LLC,API User,E6AEAE22430
2022-02-24 02:52,73013771,"13,390.6210","13,380.8210",10.00 AED,10.00,9.8000,0.2000,565895268,1605816,Failure,United Arab Emirates,DU UAE,Transguard Group LLC,API User,E6AEAE22430
2022-02-24 02:56,73013863,"13,400.4210","13,395.5210",05.00 AED,5.00,4.9000,0.1000,565895623,1605819,Success,United Arab Emirates,DU UAE,Transguard Group LLC,API User,E6AEAE17361
2022-02-24 03:51,73015485,"13,395.5210","13,390.6210",05.00 AED,5.00,4.9000,0.1000,565902187,1605826,Success,United Arab Emirates,DU UAE,Transguard Group LLC,API User,E6AEAE17361
2022-02-24 04:07,73015955,"13,390.6210","13,380.8210",10.00 AED,10.00,9.8000,0.2000,565904057,1605833,Success,United Arab Emirates,DU UAE,Transguard Group LLC,API User,E6AEAE22430
2022-02-24 04:12,73016114,"13,380.8210","13,371.0210",10.00 AED,10.00,9.8000,0.2000,565904616,1605840,Success,United Arab Emirates,DU UAE,Transguard Group LLC,API User,E6AEAE22430
2022-02-24 04:13,73016133,"13,371.0210","13,366.1210",05.00 AED,5.00,4.9000,0.1000,565904675,1605843,Success,United Arab Emirates,DU UAE,Transguard Group LLC,API User,E6AEAE17361
2022-02-24 04:36,73016839,"13,366.1210","13,361.2210",05.00 AED,5.00,4.9000,0.1000,565907245,1605854,Success,United Arab Emirates,DU UAE,Transguard Group LLC,API User,E6AEAE17361
2022-02-24 04:47,73017199,"13,361.2210","13,356.3210",05.00 AED,5.00,4.9000,0.1000,565908492,1605862,Success,United Arab Emirates,DU UAE,Transguard Group LLC,API User,E6AEAE17361
2022-02-24 04:50,73017299,"13,356.3210","13,346.5210",10.00 AED,10.00,9.8000,0.2000,565908837,1605866,Success,United Arab Emirates,DU UAE,Transguard Group LLC,API User,E6AEAE22430
2022-02-24 05:05,73017772,"13,346.5210","13,341.6210",05.00 AED,5.00,4.9000,0.1000,565910414,1605878,Success,United Arab Emirates,DU UAE,Transguard Group LLC,API User,E6AEAE17361
2022-02-24 05:05,73017778,"13,341.6210","13,333.7010",220.00 NPR,9.00,7.9200,1.0800,565910426,1605879,Success,Nepal,Ncell Nepal,Transguard Group LLC,API User,NCNPNP79518
2022-02-24 05:09,73017916,"13,333.7010","13,323.9010",10.00 AED,10.00,9.8000,0.2000,565910865,1605884,Success,United Arab Emirates,DU UAE,Transguard Group LLC,API User,E6AEAE22430
2022-02-24 05:14,73018039,"13,323.9010","13,320.1610",98.00 NPR,4.25,3.7400,0.5100,565911295,1605887,Success,Nepal,Ncell Nepal,Transguard Group LLC,API User,NCNPNP3715
2022-02-24 05:17,73018140,"13,320.1610","13,300.5610",20.00 AED,20.00,19.6000,0.4000,565911614,1605890,Success,United Arab Emirates,DU UAE,Transguard Group LLC,API User,E6AEAE12938
2022-02-24 05:17,73018169,"13,300.5610","13,285.8610",15.00 AED,15.00,14.7000,0.3000,565911689,1605894,Success,United Arab Emirates,DU UAE,Transguard Group LLC,API User,E6AEAE8527
2022-02-24 05:18,73018179,"13,285.8610","13,280.9610",05.00 AED,5.00,4.9000,0.1000,565911718,1605896,Success,United Arab Emirates,DU UAE,Transguard Group LLC,API User,E6AEAE17361
2022-02-24 05:19,73018232,"13,280.9610","13,276.0610",05.00 AED,5.00,4.9000,0.1000,565911887,1605901,Success,United Arab Emirates,DU UAE,Transguard Group LLC,API User,E6AEAE17361
2022-02-24 05:35,73018726,"13,276.0610","13,271.6610",50.00 PHP,5.00,4.4000,0.6000,565913439,1605915,Success,Philippines,BS_Globe Philippines,Transguard Group LLC,API User,PH_GB_TopUp_50.00
2022-02-24 05:43,73019005,"13,271.6610","13,256.9610",15.00 AED,15.00,14.7000,0.3000,565914309,1605918,Success,United Arab Emirates,DU UAE,Transguard Group LLC,API User,E6AEAE8527
2022-02-24 05:59,73019597,"13,256.9610","13,247.1610",10.00 AED,10.00,9.8000,0.2000,565915951,1605927,Success,United Arab Emirates,DU UAE,Transguard Group LLC,API User,E6AEAE22430
2022-02-24 06:09,73019924,"13,247.1610","13,242.2610",05.00 AED,5.00,4.9000,0.1000,565916860,1605936,Success,United Arab Emirates,DU UAE,Transguard Group LLC,API User,E6AEAE17361
2022-02-24 06:32,73020751,"13,242.2610","13,237.3610",05.00 AED,5.00,4.9000,0.1000,565919122,1605950,Success,United Arab Emirates,DU UAE,Transguard Group LLC,API User,E6AEAE17361
2022-02-24 06:36,73020886,"13,237.3610","13,232.4610",05.00 AED,5.00,4.9000,0.1000,565919504,1605953,Success,United Arab Emirates,DU UAE,Transguard Group LLC,API User,E6AEAE17361
2022-02-24 06:44,73021171,"13,232.4610","13,227.5610",05.00 AED,5.00,4.9000,0.1000,565920261,1605959,Success,United Arab Emirates,DU UAE,Transguard Group LLC,API User,E6AEAE17361
2022-02-24 06:46,73021263,"13,227.5610","13,223.8210",100.00 NPR,4.25,3.7400,0.5100,565920494,1605962,Success,Nepal,Nepal Telecom Nepal,Transguard Group LLC,API User,NP_NE_TopUp_100.00
2022-02-24 06:49,73021342,"13,223.8210","13,220.0810",100.00 NPR,4.25,3.7400,0.5100,565920708,1605969,Success,Nepal,Nepal Telecom Nepal,Transguard Group LLC,API User,NP_NE_TopUp_100.00
2022-02-24 07:00,73021736,"13,220.0810","13,200.4810",20.00 AED,20.00,19.6000,0.4000,565921767,1605986,Success,United Arab Emirates,DU UAE,Transguard Group LLC,API User,E6AEAE12938
2022-02-24 07:08,73021998,"13,200.4810","13,192.1210",100.00 PHP,9.50,8.3600,1.1400,565922445,1605994,Success,Philippines,Smart (SunCellular) Philippines,Transguard Group LLC,API User,PH_SM_TopUp_100.00
2022-02-24 07:08,73022017,"13,192.1210","13,187.2210",05.00 AED,5.00,4.9000,0.1000,565922486,1605996,Success,United Arab Emirates,DU UAE,Transguard Group LLC,API User,E6AEAE17361
2022-02-24 07:11,73022106,"13,187.2210","13,177.4210",10.00 AED,10.00,9.8000,0.2000,565922732,1605999,Success,United Arab Emirates,DU UAE,Transguard Group LLC,API User,E6AEAE22430
2022-02-24 07:21,73022415,"13,177.4210","13,172.5210",05.00 AED,5.00,4.9000,0.1000,565923671,1606007,Success,United Arab Emirates,DU UAE,Transguard Group LLC,API User,E6AEAE17361
2022-02-24 07:25,73022519,"13,172.5210","13,167.6210",05.00 AED,5.00,4.9000,0.1000,565923982,1606018,Success,United Arab Emirates,DU UAE,Transguard Group LLC,API User,E6AEAE17361
2022-02-24 07:26,73022562,"13,167.6210","13,159.7010",220.00 NPR,9.00,7.9200,1.0800,565924105,1606022,Success,Nepal,Ncell Nepal,Transguard Group LLC,API User,NCNPNP79518
2022-02-24 07:30,73022687,"13,159.7010","13,154.8010",05.00 AED,5.00,4.9000,0.1000,565924474,1606031,Success,United Arab Emirates,DU UAE,Transguard Group LLC,API User,E6AEAE17361
2022-02-24 07:41,73022999,"13,154.8010","13,149.9010",05.00 AED,5.00,4.9000,0.1000,565925325,1606043,Success,United Arab Emirates,DU UAE,Transguard Group LLC,API User,E6AEAE17361
2022-02-24 07:51,73023320,"13,149.9010","13,145.0010",05.00 AED,5.00,4.9000,0.1000,565926188,1606053,Success,United Arab Emirates,DU UAE,Transguard Group LLC,API User,E6AEAE17361
2022-02-24 07:58,73023501,"13,145.0010","13,140.1010",05.00 AED,5.00,4.9000,0.1000,565926762,1606058,Success,United Arab Emirates,DU UAE,Transguard Group LLC,API User,E6AEAE17361
2022-02-24 08:06,73023737,"13,140.1010","13,135.2010",05.00 AED,5.00,4.9000,0.1000,565927431,1606068,Success,United Arab Emirates,DU UAE,Transguard Group LLC,API User,E6AEAE17361
2022-02-24 08:09,73023852,"13,135.2010","13,125.4010",10.00 AED,10.00,9.8000,0.2000,565927713,1606075,Success,United Arab Emirates,DU UAE,Transguard Group LLC,API User,E6AEAE22430
2022-02-24 08:17,73024101,"13,125.4010","13,120.5010",05.00 AED,5.00,4.9000,0.1000,565928423,1606084,Success,United Arab Emirates,DU UAE,Transguard Group LLC,API User,E6AEAE17361
2022-02-24 08:21,73024230,"13,120.5010","13,115.6010",05.00 AED,5.00,4.9000,0.1000,565928792,1606090,Success,United Arab Emirates,DU UAE,Transguard Group LLC,API User,E6AEAE17361
2022-02-24 08:27,73024400,"13,115.6010","13,110.7010",05.00 AED,5.00,4.9000,0.1000,565929231,1606099,Success,United Arab Emirates,DU UAE,Transguard Group LLC,API User,E6AEAE17361
2022-02-24 08:27,73024419,"13,110.7010","13,100.9010",10.00 AED,10.00,9.8000,0.2000,565929270,1606103,Success,United Arab Emirates,DU UAE,Transguard Group LLC,API User,E6AEAE22430
2022-02-24 08:27,73024432,"13,100.9010","13,096.0010",05.00 AED,5.00,4.9000,0.1000,565929300,1606105,Success,United Arab Emirates,DU UAE,Transguard Group LLC,API User,E6AEAE17361
2022-02-24 08:29,73024491,"13,096.0010","13,086.2010",10.00 AED,10.00,9.8000,0.2000,565929462,1606116,Success,United Arab Emirates,DU UAE,Transguard Group LLC,API User,E6AEAE22430
2022-02-24 08:29,73024493,"13,086.2010","13,076.4010",10.00 AED,10.00,9.8000,0.2000,565929471,1606117,Success,United Arab Emirates,DU UAE,Transguard Group LLC,API User,E6AEAE22430
2022-02-24 08:30,73024531,"13,076.4010","13,066.6010",10.00 AED,10.00,9.8000,0.2000,565929592,1606121,Success,United Arab Emirates,DU UAE,Transguard Group LLC,API User,E6AEAE22430
2022-02-24 08:33,73024619,"13,066.6010","13,061.7010",05.00 AED,5.00,4.9000,0.1000,565929877,1606131,Success,United Arab Emirates,DU UAE,Transguard Group LLC,API User,E6AEAE17361
2022-02-24 08:38,73024829,"13,061.7010","13,051.9010",10.00 AED,10.00,9.8000,0.2000,565930408,1606145,Success,United Arab Emirates,DU UAE,Transguard Group LLC,API User,E6AEAE22430
2022-02-24 08:39,73024845,"13,051.9010","13,041.3410",179.00 INR,12.00,10.5600,1.4400,565930463,1606147,Success,India,Airtel India,Transguard Group LLC,API User,AIININ72188
2022-02-24 08:40,73024865,"13,041.3410","13,036.4410",05.00 AED,5.00,4.9000,0.1000,565930526,1606151,Success,United Arab Emirates,DU UAE,Transguard Group LLC,API User,E6AEAE17361
2022-02-24 08:46,73025053,"13,036.4410","13,031.5410",05.00 AED,5.00,4.9000,0.1000,565931056,1606158,Success,United Arab Emirates,DU UAE,Transguard Group LLC,API User,E6AEAE17361
2022-02-24 08:48,73025115,"13,031.5410","13,026.6410",05.00 AED,5.00,4.9000,0.1000,565931205,1606161,Success,United Arab Emirates,DU UAE,Transguard Group LLC,API User,E6AEAE17361
2022-02-24 08:48,73025141,"13,026.6410","13,021.7410",05.00 AED,5.00,4.9000,0.1000,565931264,1606166,Success,United Arab Emirates,DU UAE,Transguard Group LLC,API User,E6AEAE17361
2022-02-24 08:48,73025144,"13,021.7410","13,011.9410",10.00 AED,10.00,9.8000,0.2000,565931275,1606167,Success,United Arab Emirates,DU UAE,Transguard Group LLC,API User,E6AEAE22430
2022-02-24 08:52,73025268,"13,011.9410","13,002.1410",10.00 AED,10.00,9.8000,0.2000,565931615,1606175,Success,United Arab Emirates,DU UAE,Transguard Group LLC,API User,E6AEAE22430
2022-02-24 08:52,73025279,"13,002.1410","12,992.3410",10.00 AED,10.00,9.8000,0.2000,565931636,1606178,Success,United Arab Emirates,DU UAE,Transguard Group LLC,API User,E6AEAE22430
2022-02-24 08:54,73025332,"12,992.3410","12,987.4410",05.00 AED,5.00,4.9000,0.1000,565931778,1606182,Success,United Arab Emirates,DU UAE,Transguard Group LLC,API User,E6AEAE17361
2022-02-24 08:55,73025350,"12,987.4410","12,977.6410",10.00 AED,10.00,9.8000,0.2000,565931844,1606185,Success,United Arab Emirates,DU UAE,Transguard Group LLC,API User,E6AEAE22430
2022-02-24 08:56,73025392,"12,977.6410","12,972.7410",05.00 AED,5.00,4.9000,0.1000,565931960,1606188,Success,United Arab Emirates,DU UAE,Transguard Group LLC,API User,E6AEAE17361
2022-02-24 09:00,73025511,"12,972.7410","12,967.8410",05.00 AED,5.00,4.9000,0.1000,565932273,1606193,Success,United Arab Emirates,DU UAE,Transguard Group LLC,API User,E6AEAE17361
2022-02-24 09:01,73025542,"12,967.8410","12,958.0410",10.00 AED,10.00,9.8000,0.2000,565932374,1606198,Success,United Arab Emirates,DU UAE,Transguard Group LLC,API User,E6AEAE22430
2022-02-24 09:04,73025599,"12,958.0410","12,953.1410",05.00 AED,5.00,4.9000,0.1000,565932532,1606201,Success,United Arab Emirates,DU UAE,Transguard Group LLC,API User,E6AEAE17361
2022-02-24 09:04,73025614,"12,953.1410","12,948.2410",05.00 AED,5.00,4.9000,0.1000,565932572,1606204,Success,United Arab Emirates,DU UAE,Transguard Group LLC,API User,E6AEAE17361
2022-02-24 09:06,73025644,"12,948.2410","12,943.3410",05.00 AED,5.00,4.9000,0.1000,565932669,1606211,Success,United Arab Emirates,DU UAE,Transguard Group LLC,API User,E6AEAE17361
2022-02-24 09:06,73025650,"12,943.3410","12,933.5410",10.00 AED,10.00,9.8000,0.2000,565932687,1606216,Success,United Arab Emirates,DU UAE,Transguard Group LLC,API User,E6AEAE22430
2022-02-24 09:06,73025651,"12,933.5410","12,928.6410",05.00 AED,5.00,4.9000,0.1000,565932694,1606217,Success,United Arab Emirates,DU UAE,Transguard Group LLC,API User,E6AEAE17361
2022-02-24 09:07,73025671,"12,928.6410","12,923.7410",05.00 AED,5.00,4.9000,0.1000,565932739,1606222,Success,United Arab Emirates,DU UAE,Transguard Group LLC,API User,E6AEAE17361
2022-02-24 09:07,73025689,"12,923.7410","12,918.8410",05.00 AED,5.00,4.9000,0.1000,565932784,1606226,Success,United Arab Emirates,DU UAE,Transguard Group LLC,API User,E6AEAE17361
2022-02-24 09:18,73025942,"12,918.8410","12,909.0410",10.00 AED,10.00,9.8000,0.2000,565933589,1606237,Success,United Arab Emirates,DU UAE,Transguard Group LLC,API User,E6AEAE22430
2022-02-24 09:19,73025963,"12,909.0410","12,904.1410",05.00 AED,5.00,4.9000,0.1000,565933658,1606240,Success,United Arab Emirates,DU UAE,Transguard Group LLC,API User,E6AEAE17361
2022-02-24 09:26,73026163,"12,904.1410","12,879.6410",25.00 AED,25.00,24.5000,0.5000,565934238,1606252,Success,United Arab Emirates,DU UAE,Transguard Group LLC,API User,E6AEAE25659
2022-02-24 09:32,73026340,"12,879.6410","12,874.7410",05.00 AED,5.00,4.9000,0.1000,565934751,1606263,Success,United Arab Emirates,DU UAE,Transguard Group LLC,API User,E6AEAE17361
2022-02-24 09:35,73026406,"12,874.7410","12,864.9410",10.00 AED,10.00,9.8000,0.2000,565934913,1606266,Success,United Arab Emirates,DU UAE,Transguard Group LLC,API User,E6AEAE22430
2022-02-24 09:37,73026472,"12,864.9410","12,855.1410",10.00 AED,10.00,9.8000,0.2000,565935096,1606272,Success,United Arab Emirates,DU UAE,Transguard Group LLC,API User,E6AEAE22430
2022-02-24 09:38,73026502,"12,855.1410","12,850.2410",05.00 AED,5.00,4.9000,0.1000,565935172,1606275,Success,United Arab Emirates,DU UAE,Transguard Group LLC,API User,E6AEAE17361
2022-02-24 09:42,73026629,"12,850.2410","12,840.4410",10.00 AED,10.00,9.8000,0.2000,565935529,1606280,Success,United Arab Emirates,DU UAE,Transguard Group LLC,API User,E6AEAE22430
2022-02-24 09:46,73026735,"12,840.4410","12,835.5410",05.00 AED,5.00,4.9000,0.1000,565935837,1606287,Success,United Arab Emirates,DU UAE,Transguard Group LLC,API User,E6AEAE17361
2022-02-24 09:47,73026764,"12,835.5410","12,830.6410",05.00 AED,5.00,4.9000,0.1000,565935925,1606290,Success,United Arab Emirates,DU UAE,Transguard Group LLC,API User,E6AEAE17361
2022-02-24 10:02,73027125,"12,830.6410","12,820.8410",10.00 AED,10.00,9.8000,0.2000,565937007,1606306,Success,United Arab Emirates,DU UAE,Transguard Group LLC,API User,E6AEAE22430
2022-02-24 10:02,73027143,"12,820.8410","12,815.9410",05.00 AED,5.00,4.9000,0.1000,565937052,1606309,Success,United Arab Emirates,DU UAE,Transguard Group LLC,API User,E6AEAE17361
2022-02-24 10:08,73027289,"12,815.9410","12,811.0410",05.00 AED,5.00,4.9000,0.1000,565937509,1606313,Success,United Arab Emirates,DU UAE,Transguard Group LLC,API User,E6AEAE17361
2022-02-24 10:10,73027328,"12,811.0410","12,801.2410",10.00 AED,10.00,9.8000,0.2000,565937633,1606319,Success,United Arab Emirates,DU UAE,Transguard Group LLC,API User,E6AEAE22430
2022-02-24 10:13,73027421,"12,801.2410","12,781.6410",20.00 AED,20.00,19.6000,0.4000,565937899,1606325,Success,United Arab Emirates,DU UAE,Transguard Group LLC,API User,E6AEAE12938
2022-02-24 10:18,73027553,"12,781.6410","12,776.7410",05.00 AED,5.00,4.9000,0.1000,565938307,1606330,Success,United Arab Emirates,DU UAE,Transguard Group LLC,API User,E6AEAE17361
2022-02-24 10:19,73027590,"12,776.7410","12,771.8410",05.00 AED,5.00,4.9000,0.1000,565938411,1606335,Success,United Arab Emirates,DU UAE,Transguard Group LLC,API User,E6AEAE17361
2022-02-24 10:20,73027614,"12,771.8410","12,754.2410",26.41 GHS,20.00,17.6000,2.4000,565938477,1606338,Success,Ghana,MTN Ghana,Transguard Group LLC,API User,GH_MT_TopUp
2022-02-24 10:29,73027899,"12,754.2410","12,749.3410",05.00 AED,5.00,4.9000,0.1000,565939250,1606347,Success,United Arab Emirates,DU UAE,Transguard Group LLC,API User,E6AEAE17361
2022-02-24 10:33,73028043,"12,749.3410","12,744.4410",05.00 AED,5.00,4.9000,0.1000,565939641,1606358,Success,United Arab Emirates,DU UAE,Transguard Group LLC,API User,E6AEAE17361
2022-02-24 10:34,73028049,"12,744.4410","12,739.5410",05.00 AED,5.00,4.9000,0.1000,565939651,1606359,Success,United Arab Emirates,DU UAE,Transguard Group LLC,API User,E6AEAE17361
2022-02-24 10:36,73028119,"12,739.5410","12,729.7410",10.00 AED,10.00,9.8000,0.2000,565939862,1606366,Success,United Arab Emirates,DU UAE,Transguard Group LLC,API User,E6AEAE22430
2022-02-24 10:38,73028173,"12,729.7410","12,721.8210",220.00 NPR,9.00,7.9200,1.0800,565940011,1606371,Success,Nepal,Ncell Nepal,Transguard Group LLC,API User,NCNPNP79518
2022-02-24 10:39,73028177,"12,721.8210","12,716.9210",05.00 AED,5.00,4.9000,0.1000,565940023,1606372,Success,United Arab Emirates,DU UAE,Transguard Group LLC,API User,E6AEAE17361
2022-02-24 10:44,73028310,"12,716.9210","12,663.0210",55.00 AED,55.00,53.9000,1.1000,565940413,1606377,Success,United Arab Emirates,DU UAE,Transguard Group LLC,API User,E6AEAE81767
2022-02-24 10:55,73028635,"12,663.0210","12,658.1210",05.00 AED,5.00,4.9000,0.1000,565941354,1606387,Success,United Arab Emirates,DU UAE,Transguard Group LLC,API User,E6AEAE17361
2022-02-24 10:56,73028652,"12,658.1210","12,653.2210",05.00 AED,5.00,4.9000,0.1000,565941411,1606394,Success,United Arab Emirates,DU UAE,Transguard Group LLC,API User,E6AEAE17361
2022-02-24 10:56,73028664,"12,653.2210","12,637.1610",575.00 PKR,18.25,16.0600,2.1900,565941424,1606395,Failure,Pakistan,Jazz Pakistan,Transguard Group LLC,API User,MBPKPK68304
2022-02-24 10:56,73028664,"12,637.1610","12,621.1010",575.00 PKR,18.25,16.0600,2.1900,565941424,1606395,Failure,Pakistan,Jazz Pakistan,Transguard Group LLC,API User,MBPKPK68304
2022-02-24 11:02,73028878,"12,653.2210","12,648.3210",05.00 AED,5.00,4.9000,0.1000,565941940,1606401,Success,United Arab Emirates,DU UAE,Transguard Group LLC,API User,E6AEAE17361
2022-02-24 11:05,73028964,"12,648.3210","12,638.5210",10.00 AED,10.00,9.8000,0.2000,565942174,1606404,Success,United Arab Emirates,DU UAE,Transguard Group LLC,API User,E6AEAE22430
2022-02-24 11:11,73029151,"12,638.5210","12,618.9210",20.00 AED,20.00,19.6000,0.4000,565942692,1606413,Success,United Arab Emirates,DU UAE,Transguard Group LLC,API User,E6AEAE12938
2022-02-24 11:12,73029190,"12,618.9210","12,609.1210",10.00 AED,10.00,9.8000,0.2000,565942783,1606417,Success,United Arab Emirates,DU UAE,Transguard Group LLC,API User,E6AEAE22430
2022-02-24 11:13,73029215,"12,609.1210","12,604.2210",05.00 AED,5.00,4.9000,0.1000,565942877,1606422,Success,United Arab Emirates,DU UAE,Transguard Group LLC,API User,E6AEAE17361
2022-02-24 11:14,73029251,"12,604.2210","12,599.3210",05.00 AED,5.00,4.9000,0.1000,565942967,1606425,Success,United Arab Emirates,DU UAE,Transguard Group LLC,API User,E6AEAE17361
2022-02-24 11:19,73029399,"12,599.3210","12,594.4210",05.00 AED,5.00,4.9000,0.1000,565943382,1606430,Success,United Arab Emirates,DU UAE,Transguard Group LLC,API User,E6AEAE17361
2022-02-24 11:24,73029562,"12,594.4210","12,589.5210",05.00 AED,5.00,4.9000,0.1000,565943791,1606441,Success,United Arab Emirates,DU UAE,Transguard Group LLC,API User,E6AEAE17361
2022-02-24 11:27,73029631,"12,589.5210","12,579.7210",10.00 AED,10.00,9.8000,0.2000,565944001,1606444,Success,United Arab Emirates,DU UAE,Transguard Group LLC,API User,E6AEAE22430
2022-02-24 11:32,73029796,"12,579.7210","12,560.1210",20.00 AED,20.00,19.6000,0.4000,565944427,1606455,Success,United Arab Emirates,DU UAE,Transguard Group LLC,API User,E6AEAE12938
2022-02-24 11:32,73029799,"12,560.1210","12,550.3210",10.00 AED,10.00,9.8000,0.2000,565944431,1606456,Success,United Arab Emirates,DU UAE,Transguard Group LLC,API User,E6AEAE22430
2022-02-24 11:37,73029966,"12,550.3210","12,540.5210",10.00 AED,10.00,9.8000,0.2000,565944843,1606464,Success,United Arab Emirates,DU UAE,Transguard Group LLC,API User,E6AEAE22430
2022-02-24 11:38,73030000,"12,540.5210","12,535.6210",05.00 AED,5.00,4.9000,0.1000,565944940,1606468,Success,United Arab Emirates,DU UAE,Transguard Group LLC,API User,E6AEAE17361
2022-02-24 11:41,73030072,"12,535.6210","12,530.7210",05.00 AED,5.00,4.9000,0.1000,565945138,1606471,Success,United Arab Emirates,DU UAE,Transguard Group LLC,API User,E6AEAE17361
2022-02-24 11:43,73030139,"12,530.7210","12,525.8210",05.00 AED,5.00,4.9000,0.1000,565945366,1606479,Success,United Arab Emirates,DU UAE,Transguard Group LLC,API User,E6AEAE17361
2022-02-24 11:49,73030284,"12,525.8210","12,520.9210",05.00 AED,5.00,4.9000,0.1000,565945773,1606484,Success,United Arab Emirates,DU UAE,Transguard Group LLC,API User,E6AEAE17361
2022-02-24 11:49,73030303,"12,520.9210","12,516.0210",05.00 AED,5.00,4.9000,0.1000,565945815,1606487,Success,United Arab Emirates,DU UAE,Transguard Group LLC,API User,E6AEAE17361
2022-02-24 11:52,73030376,"12,516.0210","12,506.2210",10.00 AED,10.00,9.8000,0.2000,565946032,1606490,Success,United Arab Emirates,DU UAE,Transguard Group LLC,API User,E6AEAE22430
2022-02-24 11:55,73030455,"12,506.2210","12,501.3210",05.00 AED,5.00,4.9000,0.1000,565946253,1606497,Success,United Arab Emirates,DU UAE,Transguard Group LLC,API User,E6AEAE17361
2022-02-24 12:04,73030746,"12,501.3210","12,491.5210",10.00 AED,10.00,9.8000,0.2000,565947055,1606516,Success,United Arab Emirates,DU UAE,Transguard Group LLC,API User,E6AEAE22430
2022-02-24 12:07,73030844,"12,491.5210","12,481.7210",10.00 AED,10.00,9.8000,0.2000,565947309,1606520,Success,United Arab Emirates,DU UAE,Transguard Group LLC,API User,E6AEAE22430
2022-02-24 12:08,73030863,"12,481.7210","12,471.9210",10.00 AED,10.00,9.8000,0.2000,565947369,1606524,Success,United Arab Emirates,DU UAE,Transguard Group LLC,API User,E6AEAE22430
2022-02-24 12:11,73030949,"12,471.9210","12,452.3210",20.00 AED,20.00,19.6000,0.4000,565947640,1606529,Success,United Arab Emirates,DU UAE,Transguard Group LLC,API User,E6AEAE12938
2022-02-24 12:19,73031208,"12,452.3210","12,447.4210",05.00 AED,5.00,4.9000,0.1000,565948336,1606538,Success,United Arab Emirates,DU UAE,Transguard Group LLC,API User,E6AEAE17361
2022-02-24 12:20,73031244,"12,447.4210","12,437.6210",10.00 AED,10.00,9.8000,0.2000,565948430,1606541,Success,United Arab Emirates,DU UAE,Transguard Group LLC,API User,E6AEAE22430
2022-02-24 12:22,73031306,"12,437.6210","12,432.7210",05.00 AED,5.00,4.9000,0.1000,565948586,1606544,Success,United Arab Emirates,DU UAE,Transguard Group LLC,API User,E6AEAE17361
2022-02-24 12:26,73031439,"12,432.7210","12,422.9210",10.00 AED,10.00,9.8000,0.2000,565948937,1606547,Success,United Arab Emirates,DU UAE,Transguard Group LLC,API User,E6AEAE22430
2022-02-24 12:44,73032012,"12,422.9210","12,418.0210",05.00 AED,5.00,4.9000,0.1000,565950464,1606566,Success,United Arab Emirates,DU UAE,Transguard Group LLC,API User,E6AEAE17361
2022-02-24 12:47,73032087,"12,418.0210","12,414.2810",100.00 NPR,4.25,3.7400,0.5100,565950685,1606571,Success,Nepal,Nepal Telecom Nepal,Transguard Group LLC,API User,NP_NE_TopUp_100.00
2022-02-24 12:49,73032146,"12,414.2810","12,410.1010",150.00 PKR,4.75,4.1800,0.5700,565950846,1606574,Success,Pakistan,Jazz Pakistan,Transguard Group LLC,API User,MBPKPK20699
2022-02-24 12:50,73032173,"12,410.1010","12,400.3010",10.00 AED,10.00,9.8000,0.2000,565950929,1606577,Success,United Arab Emirates,DU UAE,Transguard Group LLC,API User,E6AEAE22430
2022-02-24 12:52,73032254,"12,400.3010","12,396.1210",150.00 PKR,4.75,4.1800,0.5700,565951148,1606580,Success,Pakistan,Jazz Pakistan,Transguard Group LLC,API User,MBPKPK20699
2022-02-24 12:57,73032375,"12,396.1210","12,391.2210",05.00 AED,5.00,4.9000,0.1000,565951471,1606585,Success,United Arab Emirates,DU UAE,Transguard Group LLC,API User,E6AEAE17361
2022-02-24 12:57,73032391,"12,391.2210","12,381.4210",10.00 AED,10.00,9.8000,0.2000,565951523,1606590,Success,United Arab Emirates,DU UAE,Transguard Group LLC,API User,E6AEAE22430
2022-02-24 12:59,73032432,"12,381.4210","12,371.6210",10.00 AED,10.00,9.8000,0.2000,565951647,1606597,Success,United Arab Emirates,DU UAE,Transguard Group LLC,API User,E6AEAE22430
2022-02-24 13:02,73032577,"12,371.6210","12,366.7210",05.00 AED,5.00,4.9000,0.1000,565952002,1606603,Success,United Arab Emirates,DU UAE,Transguard Group LLC,API User,E6AEAE17361
2022-02-24 13:07,73032731,"12,366.7210","12,361.8210",05.00 AED,5.00,4.9000,0.1000,565952384,1606610,Success,United Arab Emirates,DU UAE,Transguard Group LLC,API User,E6AEAE17361
2022-02-24 13:12,73032886,"12,361.8210","12,356.9210",05.00 AED,5.00,4.9000,0.1000,565952807,1606617,Success,United Arab Emirates,DU UAE,Transguard Group LLC,API User,E6AEAE17361
2022-02-24 13:12,73032893,"12,356.9210","12,337.3210",20.00 AED,20.00,19.6000,0.4000,565952825,1606619,Success,United Arab Emirates,DU UAE,Transguard Group LLC,API User,E6AEAE12938
2022-02-24 13:15,73033003,"12,337.3210","12,332.4210",05.00 AED,5.00,4.9000,0.1000,565953076,1606622,Success,United Arab Emirates,DU UAE,Transguard Group LLC,API User,E6AEAE17361
2022-02-24 13:16,73033049,"12,332.4210","12,327.5210",05.00 AED,5.00,4.9000,0.1000,565953212,1606627,Success,United Arab Emirates,DU UAE,Transguard Group LLC,API User,E6AEAE17361
2022-02-24 13:20,73033161,"12,327.5210","12,317.7210",10.00 AED,10.00,9.8000,0.2000,565953579,1606630,Success,United Arab Emirates,DU UAE,Transguard Group LLC,API User,E6AEAE22430
2022-02-24 13:21,73033177,"12,317.7210","12,312.8210",05.00 AED,5.00,4.9000,0.1000,565953626,1606633,Success,United Arab Emirates,DU UAE,Transguard Group LLC,API User,E6AEAE17361
2022-02-24 13:25,73033329,"12,312.8210","12,303.0210",10.00 AED,10.00,9.8000,0.2000,565954017,1606637,Success,United Arab Emirates,DU UAE,Transguard Group LLC,API User,E6AEAE22430
2022-02-24 13:28,73033390,"12,303.0210","12,293.2210",10.00 AED,10.00,9.8000,0.2000,565954197,1606640,Success,United Arab Emirates,DU UAE,Transguard Group LLC,API User,E6AEAE22430
2022-02-24 13:30,73033492,"12,293.2210","12,288.3210",05.00 AED,5.00,4.9000,0.1000,565954462,1606643,Success,United Arab Emirates,DU UAE,Transguard Group LLC,API User,E6AEAE17361
2022-02-24 13:40,73033827,"12,288.3210","12,278.5210",10.00 AED,10.00,9.8000,0.2000,565955359,1606648,Success,United Arab Emirates,DU UAE,Transguard Group LLC,API User,E6AEAE22430
2022-02-24 13:50,73034136,"12,278.5210","12,268.7210",10.00 AED,10.00,9.8000,0.2000,565956214,1606655,Success,United Arab Emirates,DU UAE,Transguard Group LLC,API User,E6AEAE22430
2022-02-24 13:53,73034239,"12,268.7210","12,263.8210",05.00 AED,5.00,4.9000,0.1000,565956498,1606660,Success,United Arab Emirates,DU UAE,Transguard Group LLC,API User,E6AEAE17361
2022-02-24 14:00,73034449,"12,263.8210","12,258.9210",05.00 AED,5.00,4.9000,0.1000,565957154,1606665,Success,United Arab Emirates,DU UAE,Transguard Group LLC,API User,E6AEAE17361
2022-02-24 14:06,73034677,"12,258.9210","12,254.0210",05.00 AED,5.00,4.9000,0.1000,565957768,1606672,Success,United Arab Emirates,DU UAE,Transguard Group LLC,API User,E6AEAE17361
2022-02-24 14:12,73034862,"12,254.0210","12,249.1210",05.00 AED,5.00,4.9000,0.1000,565958322,1606683,Success,United Arab Emirates,DU UAE,Transguard Group LLC,API User,E6AEAE17361
2022-02-24 14:15,73034949,"12,249.1210","12,244.2210",05.00 AED,5.00,4.9000,0.1000,565958583,1606688,Success,United Arab Emirates,DU UAE,Transguard Group LLC,API User,E6AEAE17361
2022-02-24 14:21,73035110,"12,244.2210","12,239.3210",05.00 AED,5.00,4.9000,0.1000,565959086,73035110,Success,United Arab Emirates,DU UAE,Transguard Group LLC,mohammed.arafath@transguardgroup.com,E6AEAE17361
2022-02-24 14:21,73035137,"12,239.3210","12,214.8210",25.00 AED,25.00,24.5000,0.5000,565959166,73035137,Failure,United Arab Emirates,DU UAE,Transguard Group LLC,mohammed.arafath@transguardgroup.com,E6AEAE17343
2022-02-24 14:21,73035137,"12,214.8210","12,190.3210",25.00 AED,25.00,24.5000,0.5000,565959166,73035137,Failure,United Arab Emirates,DU UAE,Transguard Group LLC,mohammed.arafath@transguardgroup.com,E6AEAE17343
2022-02-24 14:31,73035426,"12,239.3210","12,229.5210",10.00 AED,10.00,9.8000,0.2000,565960005,1606700,Success,United Arab Emirates,DU UAE,Transguard Group LLC,API User,E6AEAE22430
2022-02-24 14:50,73036000,"12,229.5210","12,214.8210",15.00 AED,15.00,14.7000,0.3000,565961749,1606709,Success,United Arab Emirates,DU UAE,Transguard Group LLC,API User,E6AEAE8527
2022-02-24 14:54,73036115,"12,214.8210","12,209.9210",05.00 AED,5.00,4.9000,0.1000,565962129,1606713,Success,United Arab Emirates,DU UAE,Transguard Group LLC,API User,E6AEAE17361
2022-02-24 14:57,73036209,"12,209.9210","12,200.1210",10.00 AED,10.00,9.8000,0.2000,565962439,1606719,Success,United Arab Emirates,DU UAE,Transguard Group LLC,API User,E6AEAE22430
2022-02-24 15:06,73036449,"12,200.1210","12,195.2210",05.00 AED,5.00,4.9000,0.1000,565963266,1606724,Success,United Arab Emirates,DU UAE,Transguard Group LLC,API User,E6AEAE17361
2022-02-24 15:09,73036538,"12,195.2210","12,185.4210",10.00 AED,10.00,9.8000,0.2000,565963589,1606727,Success,United Arab Emirates,DU UAE,Transguard Group LLC,API User,E6AEAE22430
2022-02-24 15:10,73036597,"12,185.4210","12,156.0210",30.00 AED,30.00,29.4000,0.6000,565963749,1606730,Success,United Arab Emirates,DU UAE,Transguard Group LLC,API User,E6AEAE46146
2022-02-24 15:23,73037036,"12,156.0210","12,151.1210",05.00 AED,5.00,4.9000,0.1000,565964993,1606742,Success,United Arab Emirates,DU UAE,Transguard Group LLC,API User,E6AEAE17361
2022-02-24 15:43,73037654,"12,151.1210","12,141.3210",10.00 AED,10.00,9.8000,0.2000,565966994,1606754,Success,United Arab Emirates,DU UAE,Transguard Group LLC,API User,E6AEAE22430
2022-02-24 15:48,73037820,"12,141.3210","12,136.4210",05.00 AED,5.00,4.9000,0.1000,565967528,1606763,Success,United Arab Emirates,DU UAE,Transguard Group LLC,API User,E6AEAE17361
2022-02-24 15:48,73037831,"12,136.4210","12,126.6210",10.00 AED,10.00,9.8000,0.2000,565967553,1606764,Success,United Arab Emirates,DU UAE,Transguard Group LLC,API User,E6AEAE22430
2022-02-24 15:50,73037884,"12,126.6210","12,116.8210",10.00 AED,10.00,9.8000,0.2000,565967736,1606770,Success,United Arab Emirates,DU UAE,Transguard Group LLC,API User,E6AEAE22430
2022-02-24 15:56,73038087,"12,116.8210","12,111.9210",05.00 AED,5.00,4.9000,0.1000,565968405,1606786,Success,United Arab Emirates,DU UAE,Transguard Group LLC,API User,E6AEAE17361
2022-02-24 15:57,73038096,"12,111.9210","12,102.1210",10.00 AED,10.00,9.8000,0.2000,565968446,1606789,Success,United Arab Emirates,DU UAE,Transguard Group LLC,API User,E6AEAE22430
2022-02-24 15:58,73038130,"12,102.1210","12,077.6210",25.00 AED,25.00,24.5000,0.5000,565968550,1606790,Success,United Arab Emirates,DU UAE,Transguard Group LLC,API User,E6AEAE17343
2022-02-24 16:02,73038258,"12,077.6210","12,067.8210",10.00 AED,10.00,9.8000,0.2000,565969048,1606797,Success,United Arab Emirates,DU UAE,Transguard Group LLC,API User,E6AEAE22430
2022-02-24 16:06,73038381,"12,067.8210","12,058.0210",10.00 AED,10.00,9.8000,0.2000,565969446,1606804,Success,United Arab Emirates,DU UAE,Transguard Group LLC,API User,E6AEAE22430
2022-02-24 16:11,73038597,"12,058.0210","12,053.1210",05.00 AED,5.00,4.9000,0.1000,565970127,1606814,Success,United Arab Emirates,DU UAE,Transguard Group LLC,API User,E6AEAE17361
2022-02-24 16:19,73038874,"12,053.1210","12,048.2210",05.00 AED,5.00,4.9000,0.1000,565971049,1606826,Success,United Arab Emirates,DU UAE,Transguard Group LLC,API User,E6AEAE17361
2022-02-24 16:23,73038996,"12,048.2210","12,038.4210",10.00 AED,10.00,9.8000,0.2000,565971429,1606834,Success,United Arab Emirates,DU UAE,Transguard Group LLC,API User,E6AEAE22430
2022-02-24 16:23,73039003,"12,038.4210","12,028.6210",10.00 AED,10.00,9.8000,0.2000,565971455,1606835,Success,United Arab Emirates,DU UAE,Transguard Group LLC,API User,E6AEAE22430
2022-02-24 16:26,73039140,"12,028.6210","12,018.8210",10.00 AED,10.00,9.8000,0.2000,565971871,1606839,Success,United Arab Emirates,DU UAE,Transguard Group LLC,API User,E6AEAE22430
2022-02-24 16:34,73039431,"12,018.8210","12,013.9210",05.00 AED,5.00,4.9000,0.1000,565972794,1606856,Success,United Arab Emirates,DU UAE,Transguard Group LLC,API User,E6AEAE17361
2022-02-24 16:40,73039629,"12,013.9210","12,009.0210",05.00 AED,5.00,4.9000,0.1000,565973540,1606866,Success,United Arab Emirates,DU UAE,Transguard Group LLC,API User,E6AEAE17361
2022-02-24 16:41,73039660,"12,009.0210","12,004.1210",05.00 AED,5.00,4.9000,0.1000,565973650,1606871,Success,United Arab Emirates,DU UAE,Transguard Group LLC,API User,E6AEAE17361
2022-02-24 16:45,73039816,"12,004.1210","11,994.3210",10.00 AED,10.00,9.8000,0.2000,565974193,1606881,Success,United Arab Emirates,DU UAE,Transguard Group LLC,API User,E6AEAE22430
2022-02-24 16:52,73040054,"11,994.3210","11,989.4210",05.00 AED,5.00,4.9000,0.1000,565975028,1606888,Success,United Arab Emirates,DU UAE,Transguard Group LLC,API User,E6AEAE17361
2022-02-24 16:55,73040139,"11,989.4210","11,979.6210",10.00 AED,10.00,9.8000,0.2000,565975317,1606891,Success,United Arab Emirates,DU UAE,Transguard Group LLC,API User,E6AEAE22430
2022-02-24 16:55,73040160,"11,979.6210","11,974.7210",05.00 AED,5.00,4.9000,0.1000,565975380,1606894,Success,United Arab Emirates,DU UAE,Transguard Group LLC,API User,E6AEAE17361
2022-02-24 16:58,73040260,"11,974.7210","11,969.8210",05.00 AED,5.00,4.9000,0.1000,565975745,1606899,Success,United Arab Emirates,DU UAE,Transguard Group LLC,API User,E6AEAE17361
2022-02-24 17:00,73040359,"11,969.8210","11,964.9210",05.00 AED,5.00,4.9000,0.1000,565976077,1606905,Success,United Arab Emirates,DU UAE,Transguard Group LLC,API User,E6AEAE17361
2022-02-24 17:01,73040367,"11,964.9210","11,960.0210",05.00 AED,5.00,4.9000,0.1000,565976105,1606907,Success,United Arab Emirates,DU UAE,Transguard Group LLC,API User,E6AEAE17361
2022-02-24 17:02,73040403,"11,960.0210","11,950.2210",10.00 AED,10.00,9.8000,0.2000,565976216,1606912,Success,United Arab Emirates,DU UAE,Transguard Group LLC,API User,E6AEAE22430
2022-02-24 17:05,73040531,"11,950.2210","11,945.3210",05.00 AED,5.00,4.9000,0.1000,565976717,1606917,Success,United Arab Emirates,DU UAE,Transguard Group LLC,API User,E6AEAE17361
2022-02-24 17:06,73040575,"11,945.3210","11,935.5210",10.00 AED,10.00,9.8000,0.2000,565976868,1606920,Success,United Arab Emirates,DU UAE,Transguard Group LLC,API User,E6AEAE22430
2022-02-24 17:09,73040698,"11,935.5210","11,930.6210",05.00 AED,5.00,4.9000,0.1000,565977257,1606925,Success,United Arab Emirates,DU UAE,Transguard Group LLC,API User,E6AEAE17361
2022-02-24 17:09,73040700,"11,930.6210","11,911.0210",20.00 AED,20.00,19.6000,0.4000,565977265,1606926,Success,United Arab Emirates,DU UAE,Transguard Group LLC,API User,E6AEAE12938
2022-02-24 17:13,73040841,"11,911.0210","11,906.1210",05.00 AED,5.00,4.9000,0.1000,565977750,1606934,Success,United Arab Emirates,DU UAE,Transguard Group LLC,API User,E6AEAE17361
2022-02-24 17:19,73041088,"11,906.1210","11,896.3210",10.00 AED,10.00,9.8000,0.2000,565978510,1606944,Success,United Arab Emirates,DU UAE,Transguard Group LLC,API User,E6AEAE22430
2022-02-24 17:20,73041116,"11,896.3210","11,891.4210",05.00 AED,5.00,4.9000,0.1000,565978624,1606947,Success,United Arab Emirates,DU UAE,Transguard Group LLC,API User,E6AEAE17361
2022-02-24 17:20,73041137,"11,891.4210","11,881.6210",10.00 AED,10.00,9.8000,0.2000,565978686,1606951,Success,United Arab Emirates,DU UAE,Transguard Group LLC,API User,E6AEAE22430
2022-02-24 17:22,73041239,"11,881.6210","11,876.7210",05.00 AED,5.00,4.9000,0.1000,565978975,1606959,Success,United Arab Emirates,DU UAE,Transguard Group LLC,API User,E6AEAE17361
2022-02-24 17:24,73041291,"11,876.7210","11,871.8210",05.00 AED,5.00,4.9000,0.1000,565979153,1606964,Success,United Arab Emirates,DU UAE,Transguard Group LLC,API User,E6AEAE17361
2022-02-24 17:25,73041350,"11,871.8210","11,866.9210",05.00 AED,5.00,4.9000,0.1000,565979394,1606970,Success,United Arab Emirates,DU UAE,Transguard Group LLC,API User,E6AEAE17361
2022-02-24 17:25,73041354,"11,866.9210","11,862.0210",05.00 AED,5.00,4.9000,0.1000,565979416,1606972,Success,United Arab Emirates,DU UAE,Transguard Group LLC,API User,E6AEAE17361
2022-02-24 17:29,73041463,"11,862.0210","11,857.1210",05.00 AED,5.00,4.9000,0.1000,565979819,1606979,Success,United Arab Emirates,DU UAE,Transguard Group LLC,API User,E6AEAE17361
2022-02-24 17:32,73041590,"11,857.1210","11,847.3210",10.00 AED,10.00,9.8000,0.2000,565980260,1606982,Success,United Arab Emirates,DU UAE,Transguard Group LLC,API User,E6AEAE22430
2022-02-24 17:33,73041640,"11,847.3210","11,832.6210",15.00 AED,15.00,14.7000,0.3000,565980451,1606985,Success,United Arab Emirates,DU UAE,Transguard Group LLC,API User,E6AEAE8527
2022-02-24 17:38,73041852,"11,832.6210","11,822.8210",10.00 AED,10.00,9.8000,0.2000,565981100,1606988,Success,United Arab Emirates,DU UAE,Transguard Group LLC,API User,E6AEAE22430
2022-02-24 17:39,73041873,"11,822.8210","11,817.9210",05.00 AED,5.00,4.9000,0.1000,565981176,1606991,Success,United Arab Emirates,DU UAE,Transguard Group LLC,API User,E6AEAE17361
2022-02-24 17:44,73042124,"11,817.9210","11,813.0210",05.00 AED,5.00,4.9000,0.1000,565981966,1607004,Success,United Arab Emirates,DU UAE,Transguard Group LLC,API User,E6AEAE17361
2022-02-24 17:45,73042197,"11,813.0210","11,808.1210",05.00 AED,5.00,4.9000,0.1000,565982180,1607007,Success,United Arab Emirates,DU UAE,Transguard Group LLC,API User,E6AEAE17361
2022-02-24 17:48,73042293,"11,808.1210","11,803.2210",05.00 AED,5.00,4.9000,0.1000,565982568,1607016,Success,United Arab Emirates,DU UAE,Transguard Group LLC,API User,E6AEAE17361
2022-02-24 17:49,73042335,"11,803.2210","11,778.7210",25.00 AED,25.00,24.5000,0.5000,565982689,1607017,Success,United Arab Emirates,DU UAE,Transguard Group LLC,API User,E6AEAE25659
2022-02-24 17:50,73042361,"11,778.7210","11,768.9210",10.00 AED,10.00,9.8000,0.2000,565982807,1607021,Success,United Arab Emirates,DU UAE,Transguard Group LLC,API User,E6AEAE22430
2022-02-24 17:51,73042427,"11,768.9210","11,754.2210",15.00 AED,15.00,14.7000,0.3000,565983042,1607027,Success,United Arab Emirates,DU UAE,Transguard Group LLC,API User,E6AEAE8527
2022-02-24 17:55,73042625,"11,754.2210","11,749.3210",05.00 AED,5.00,4.9000,0.1000,565983709,1607037,Success,United Arab Emirates,DU UAE,Transguard Group LLC,API User,E6AEAE17361
2022-02-24 17:57,73042713,"11,749.3210","11,734.3610",298.00 INR,17.00,14.9600,2.0400,565984006,1607042,Success,India,Vi India,Transguard Group LLC,API User,VFININ34570
2022-02-24 17:59,73042807,"11,734.3610","11,729.4610",05.00 AED,5.00,4.9000,0.1000,565984290,1607045,Success,United Arab Emirates,DU UAE,Transguard Group LLC,API User,E6AEAE17361
2022-02-24 18:00,73042829,"11,729.4610","11,719.6610",10.00 AED,10.00,9.8000,0.2000,565984364,1607048,Success,United Arab Emirates,DU UAE,Transguard Group LLC,API User,E6AEAE22430
2022-02-24 18:00,73042850,"11,719.6610","11,714.7610",05.00 AED,5.00,4.9000,0.1000,565984440,1607051,Success,United Arab Emirates,DU UAE,Transguard Group LLC,API User,E6AEAE17361
2022-02-24 18:03,73042990,"11,714.7610","11,709.8610",05.00 AED,5.00,4.9000,0.1000,565984911,1607054,Success,United Arab Emirates,DU UAE,Transguard Group LLC,API User,E6AEAE17361
2022-02-24 18:04,73043021,"11,709.8610","11,705.6810",150.00 PKR,4.75,4.1800,0.5700,565985004,1607058,Success,Pakistan,Jazz Pakistan,Transguard Group LLC,API User,MBPKPK20699
2022-02-24 18:04,73043024,"11,705.6810","11,700.7810",05.00 AED,5.00,4.9000,0.1000,565985040,1607060,Success,United Arab Emirates,DU UAE,Transguard Group LLC,API User,E6AEAE17361
2022-02-24 18:06,73043141,"11,700.7810","11,695.8810",05.00 AED,5.00,4.9000,0.1000,565985403,1607066,Success,United Arab Emirates,DU UAE,Transguard Group LLC,API User,E6AEAE17361
2022-02-24 18:07,73043162,"11,695.8810","11,690.9810",05.00 AED,5.00,4.9000,0.1000,565985457,1607070,Success,United Arab Emirates,DU UAE,Transguard Group LLC,API User,E6AEAE17361
2022-02-24 18:07,73043181,"11,690.9810","11,686.0810",05.00 AED,5.00,4.9000,0.1000,565985513,1607072,Success,United Arab Emirates,DU UAE,Transguard Group LLC,API User,E6AEAE17361
2022-02-24 18:10,73043352,"11,686.0810","11,676.2810",10.00 AED,10.00,9.8000,0.2000,565985995,1607075,Success,United Arab Emirates,DU UAE,Transguard Group LLC,API User,E6AEAE22430
2022-02-24 18:14,73043549,"11,676.2810","11,666.4810",10.00 AED,10.00,9.8000,0.2000,565986580,1607083,Success,United Arab Emirates,DU UAE,Transguard Group LLC,API User,E6AEAE22430
2022-02-24 18:14,73043587,"11,666.4810","11,646.8810",20.00 AED,20.00,19.6000,0.4000,565986694,1607087,Success,United Arab Emirates,DU UAE,Transguard Group LLC,API User,E6AEAE12938
2022-02-24 18:17,73043751,"11,646.8810","11,637.0810",10.00 AED,10.00,9.8000,0.2000,565987146,1607091,Success,United Arab Emirates,DU UAE,Transguard Group LLC,API User,E6AEAE22430
2022-02-24 18:18,73043760,"11,637.0810","11,632.1810",05.00 AED,5.00,4.9000,0.1000,565987181,1607093,Success,United Arab Emirates,DU UAE,Transguard Group LLC,API User,E6AEAE17361
2022-02-24 18:24,73044127,"11,632.1810","11,628.4410",100.00 NPR,4.25,3.7400,0.5100,565988329,1607100,Success,Nepal,Ncell Nepal,Transguard Group LLC,API User,NP_NC_TopUp_100.00
2022-02-24 18:27,73044227,"11,628.4410","11,618.6410",10.00 AED,10.00,9.8000,0.2000,565988625,1607105,Success,United Arab Emirates,DU UAE,Transguard Group LLC,API User,E6AEAE22430
2022-02-24 18:29,73044353,"11,618.6410","11,613.7410",05.00 AED,5.00,4.9000,0.1000,565988975,1607108,Success,United Arab Emirates,DU UAE,Transguard Group LLC,API User,E6AEAE17361
2022-02-24 18:35,73044667,"11,613.7410","11,603.9410",10.00 AED,10.00,9.8000,0.2000,565990075,1607117,Success,United Arab Emirates,DU UAE,Transguard Group LLC,API User,E6AEAE22430
2022-02-24 18:36,73044697,"11,603.9410","11,598.0010",100.00 INR,6.75,5.9400,0.8100,565990227,1607121,Success,India,Airtel India,Transguard Group LLC,API User,AIININ36410
2022-02-24 18:36,73044704,"11,598.0010","11,578.4010",20.00 AED,20.00,19.6000,0.4000,565990236,1607122,Success,United Arab Emirates,DU UAE,Transguard Group LLC,API User,E6AEAE12938
2022-02-24 18:40,73044858,"11,578.4010","11,568.6010",10.00 AED,10.00,9.8000,0.2000,565990728,1607127,Success,United Arab Emirates,DU UAE,Transguard Group LLC,API User,E6AEAE22430
2022-02-24 18:42,73044969,"11,568.6010","11,563.7010",05.00 AED,5.00,4.9000,0.1000,565991114,1607135,Success,United Arab Emirates,DU UAE,Transguard Group LLC,API User,E6AEAE17361
2022-02-24 18:43,73045008,"11,563.7010","11,558.8010",05.00 AED,5.00,4.9000,0.1000,565991263,1607140,Success,United Arab Emirates,DU UAE,Transguard Group LLC,API User,E6AEAE17361
2022-02-24 18:43,73045022,"11,558.8010","11,549.0010",10.00 AED,10.00,9.8000,0.2000,565991304,1607143,Success,United Arab Emirates,DU UAE,Transguard Group LLC,API User,E6AEAE22430
2022-02-24 18:44,73045046,"11,549.0010","11,544.1010",05.00 AED,5.00,4.9000,0.1000,565991398,1607147,Success,United Arab Emirates,DU UAE,Transguard Group LLC,API User,E6AEAE17361
2022-02-24 18:48,73045223,"11,544.1010","11,539.2010",05.00 AED,5.00,4.9000,0.1000,565992041,1607153,Success,United Arab Emirates,DU UAE,Transguard Group LLC,API User,E6AEAE17361
2022-02-24 18:48,73045247,"11,539.2010","11,534.3010",05.00 AED,5.00,4.9000,0.1000,565992100,1607155,Success,United Arab Emirates,DU UAE,Transguard Group LLC,API User,E6AEAE17361
2022-02-24 18:49,73045265,"11,534.3010","11,529.4010",05.00 AED,5.00,4.9000,0.1000,565992168,1607158,Success,United Arab Emirates,DU UAE,Transguard Group LLC,API User,E6AEAE17361
2022-02-24 18:52,73045416,"11,529.4010","11,524.5010",05.00 AED,5.00,4.9000,0.1000,565992731,1607171,Success,United Arab Emirates,DU UAE,Transguard Group LLC,API User,E6AEAE17361
2022-02-24 18:55,73045568,"11,524.5010","11,519.6010",05.00 AED,5.00,4.9000,0.1000,565993293,1607178,Success,United Arab Emirates,DU UAE,Transguard Group LLC,API User,E6AEAE17361
2022-02-24 18:57,73045632,"11,519.6010","11,509.8010",10.00 AED,10.00,9.8000,0.2000,565993519,1607186,Success,United Arab Emirates,DU UAE,Transguard Group LLC,API User,E6AEAE22430
2022-02-24 18:58,73045697,"11,509.8010","11,504.9010",05.00 AED,5.00,4.9000,0.1000,565993728,1607193,Success,United Arab Emirates,DU UAE,Transguard Group LLC,API User,E6AEAE17361
2022-02-24 19:08,73046381,"11,504.9010","11,495.1010",10.00 AED,10.00,9.8000,0.2000,565995655,1607216,Success,United Arab Emirates,DU UAE,Transguard Group LLC,API User,E6AEAE22430
2022-02-24 19:08,73046398,"11,495.1010","11,485.3010",10.00 AED,10.00,9.8000,0.2000,565995717,1607220,Success,United Arab Emirates,DU UAE,Transguard Group LLC,API User,E6AEAE22430
2022-02-24 19:11,73046569,"11,485.3010","11,481.5610",151.00 PKR,4.25,3.7400,0.5100,565996248,1607233,Success,Pakistan,Telenor Pakistan,Transguard Group LLC,API User,TPPKPK94108
2022-02-24 19:17,73046956,"11,481.5610","11,471.7610",10.00 AED,10.00,9.8000,0.2000,565997327,1607240,Success,United Arab Emirates,DU UAE,Transguard Group LLC,API User,E6AEAE22430
2022-02-24 19:20,73047140,"11,471.7610","11,466.8610",05.00 AED,5.00,4.9000,0.1000,565997911,1607243,Success,United Arab Emirates,DU UAE,Transguard Group LLC,API User,E6AEAE17361
2022-02-24 19:21,73047218,"11,466.8610","11,457.0610",10.00 AED,10.00,9.8000,0.2000,565998102,1607246,Success,United Arab Emirates,DU UAE,Transguard Group LLC,API User,E6AEAE22430
2022-02-24 19:21,73047241,"11,457.0610","11,452.1610",05.00 AED,5.00,4.9000,0.1000,565998164,1607249,Success,United Arab Emirates,DU UAE,Transguard Group LLC,API User,E6AEAE17361
2022-02-24 19:22,73047329,"11,452.1610","11,447.2610",05.00 AED,5.00,4.9000,0.1000,565998370,1607253,Success,United Arab Emirates,DU UAE,Transguard Group LLC,API User,E6AEAE17361
2022-02-24 19:22,73047371,"11,447.2610","11,437.4610",10.00 AED,10.00,9.8000,0.2000,565998492,1607257,Success,United Arab Emirates,DU UAE,Transguard Group LLC,API User,E6AEAE22430
2022-02-24 19:23,73047398,"11,437.4610","11,427.6610",10.00 AED,10.00,9.8000,0.2000,565998585,1607260,Success,United Arab Emirates,DU UAE,Transguard Group LLC,API User,E6AEAE22430
2022-02-24 19:25,73047538,"11,427.6610","11,422.7610",05.00 AED,5.00,4.9000,0.1000,565999020,1607265,Success,United Arab Emirates,DU UAE,Transguard Group LLC,API User,E6AEAE17361
2022-02-24 19:25,73047545,"11,422.7610","11,412.9610",10.00 AED,10.00,9.8000,0.2000,565999045,1607266,Success,United Arab Emirates,DU UAE,Transguard Group LLC,API User,E6AEAE22430
2022-02-24 19:26,73047574,"11,412.9610","11,408.0610",05.00 AED,5.00,4.9000,0.1000,565999114,1607269,Success,United Arab Emirates,DU UAE,Transguard Group LLC,API User,E6AEAE17361
2022-02-24 19:26,73047619,"11,408.0610","11,403.1610",05.00 AED,5.00,4.9000,0.1000,565999227,1607272,Success,United Arab Emirates,DU UAE,Transguard Group LLC,API User,E6AEAE17361
2022-02-24 19:28,73047735,"11,403.1610","11,398.2610",05.00 AED,5.00,4.9000,0.1000,565999596,1607277,Success,United Arab Emirates,DU UAE,Transguard Group LLC,API User,E6AEAE17361
2022-02-24 19:31,73047869,"11,398.2610","11,394.5210",100.00 NPR,4.25,3.7400,0.5100,566000035,1607284,Success,Nepal,Ncell Nepal,Transguard Group LLC,API User,NP_NC_TopUp_100.00
2022-02-24 19:32,73047956,"11,394.5210","11,389.6210",05.00 AED,5.00,4.9000,0.1000,566000299,1607292,Success,United Arab Emirates,DU UAE,Transguard Group LLC,API User,E6AEAE17361
2022-02-24 19:34,73048079,"11,389.6210","11,384.7210",05.00 AED,5.00,4.9000,0.1000,566000675,1607298,Success,United Arab Emirates,DU UAE,Transguard Group LLC,API User,E6AEAE17361
2022-02-24 19:35,73048149,"11,384.7210","11,379.8210",05.00 AED,5.00,4.9000,0.1000,566000882,1607304,Success,United Arab Emirates,DU UAE,Transguard Group LLC,API User,E6AEAE17361
2022-02-24 19:37,73048275,"11,379.8210","11,370.0210",10.00 AED,10.00,9.8000,0.2000,566001256,1607311,Success,United Arab Emirates,DU UAE,Transguard Group LLC,API User,E6AEAE22430
2022-02-24 19:39,73048388,"11,370.0210","11,365.1210",05.00 AED,5.00,4.9000,0.1000,566001588,1607318,Success,United Arab Emirates,DU UAE,Transguard Group LLC,API User,E6AEAE17361
2022-02-24 19:41,73048476,"11,365.1210","11,360.2210",05.00 AED,5.00,4.9000,0.1000,566001950,1607321,Success,United Arab Emirates,DU UAE,Transguard Group LLC,API User,E6AEAE17361
2022-02-24 19:43,73048592,"11,360.2210","11,355.3210",05.00 AED,5.00,4.9000,0.1000,566002289,1607325,Success,United Arab Emirates,DU UAE,Transguard Group LLC,API User,E6AEAE17361
2022-02-24 19:44,73048648,"11,355.3210","11,335.7210",20.00 AED,20.00,19.6000,0.4000,566002472,1607328,Success,United Arab Emirates,DU UAE,Transguard Group LLC,API User,E6AEAE12938
2022-02-24 19:47,73048889,"11,335.7210","11,330.8210",05.00 AED,5.00,4.9000,0.1000,566003166,1607336,Success,United Arab Emirates,DU UAE,Transguard Group LLC,API User,E6AEAE17361
2022-02-24 19:53,73049199,"11,330.8210","11,325.9210",05.00 AED,5.00,4.9000,0.1000,566004233,1607342,Success,United Arab Emirates,DU UAE,Transguard Group LLC,API User,E6AEAE17361
2022-02-24 19:54,73049261,"11,325.9210","11,321.0210",05.00 AED,5.00,4.9000,0.1000,566004418,1607348,Success,United Arab Emirates,DU UAE,Transguard Group LLC,API User,E6AEAE17361
2022-02-24 20:02,73049756,"11,321.0210","11,306.5010",400.00 NPR,16.50,14.5200,1.9800,566005917,1607362,Success,Nepal,Nepal Telecom Nepal,Transguard Group LLC,API User,NENPNP18292
2022-02-24 20:04,73049845,"11,306.5010","11,296.7010",10.00 AED,10.00,9.8000,0.2000,566006172,1607369,Success,United Arab Emirates,DU UAE,Transguard Group LLC,API User,E6AEAE22430
2022-02-24 20:04,73049890,"11,296.7010","11,291.8010",05.00 AED,5.00,4.9000,0.1000,566006303,1607372,Success,United Arab Emirates,DU UAE,Transguard Group LLC,API User,E6AEAE17361
2022-02-24 20:10,73050208,"11,291.8010","11,282.0010",10.00 AED,10.00,9.8000,0.2000,566007308,1607388,Success,United Arab Emirates,DU UAE,Transguard Group LLC,API User,E6AEAE22430
2022-02-24 20:10,73050212,"11,282.0010","11,277.1010",05.00 AED,5.00,4.9000,0.1000,566007340,1607390,Success,United Arab Emirates,DU UAE,Transguard Group LLC,API User,E6AEAE17361
2022-02-24 20:10,73050246,"11,277.1010","11,272.2010",05.00 AED,5.00,4.9000,0.1000,566007441,1607394,Success,United Arab Emirates,DU UAE,Transguard Group LLC,API User,E6AEAE17361
2022-02-24 20:22,73050970,"11,272.2010","11,269.1210",50.00 INR,3.50,3.0800,0.4200,566009787,1607429,Success,India,Jio India,Transguard Group LLC,API User,RJININ80851
2022-02-24 20:22,73050976,"11,269.1210","11,244.6210",25.00 AED,25.00,24.5000,0.5000,566009798,1607430,Success,United Arab Emirates,DU UAE,Transguard Group LLC,API User,E6AEAE17343
2022-02-24 20:27,73051276,"11,244.6210","11,234.8210",10.00 AED,10.00,9.8000,0.2000,566010681,1607438,Success,United Arab Emirates,DU UAE,Transguard Group LLC,API User,E6AEAE22430
2022-02-24 20:29,73051433,"11,234.8210","11,205.4210",30.00 AED,30.00,29.4000,0.6000,566011151,1607444,Success,United Arab Emirates,DU UAE,Transguard Group LLC,API User,E6AEAE46146
2022-02-24 20:31,73051569,"11,205.4210","11,200.5210",05.00 AED,5.00,4.9000,0.1000,566011643,1607453,Success,United Arab Emirates,DU UAE,Transguard Group LLC,API User,E6AEAE17361
2022-02-24 20:33,73051659,"11,200.5210","11,195.6210",05.00 AED,5.00,4.9000,0.1000,566011945,1607459,Success,United Arab Emirates,DU UAE,Transguard Group LLC,API User,E6AEAE17361
2022-02-24 20:35,73051778,"11,195.6210","11,190.7210",05.00 AED,5.00,4.9000,0.1000,566012372,1607469,Success,United Arab Emirates,DU UAE,Transguard Group LLC,API User,E6AEAE17361
2022-02-24 20:35,73051789,"11,190.7210","11,185.8210",05.00 AED,5.00,4.9000,0.1000,566012412,1607471,Success,United Arab Emirates,DU UAE,Transguard Group LLC,API User,E6AEAE17361
2022-02-24 20:36,73051830,"11,185.8210","11,176.0210",10.00 AED,10.00,9.8000,0.2000,566012521,1607474,Success,United Arab Emirates,DU UAE,Transguard Group LLC,API User,E6AEAE22430
2022-02-24 20:37,73051858,"11,176.0210","11,166.2210",10.00 AED,10.00,9.8000,0.2000,566012621,1607477,Success,United Arab Emirates,DU UAE,Transguard Group LLC,API User,E6AEAE22430
2022-02-24 20:39,73051996,"11,166.2210","11,161.3210",05.00 AED,5.00,4.9000,0.1000,566013057,1607485,Success,United Arab Emirates,DU UAE,Transguard Group LLC,API User,E6AEAE17361
2022-02-24 20:39,73051997,"11,161.3210","11,156.4210",05.00 AED,5.00,4.9000,0.1000,566013062,1607486,Success,United Arab Emirates,DU UAE,Transguard Group LLC,API User,E6AEAE17361
2022-02-24 20:42,73052145,"11,156.4210","11,136.8210",20.00 AED,20.00,19.6000,0.4000,566013606,1607493,Success,United Arab Emirates,DU UAE,Transguard Group LLC,API User,E6AEAE12938
2022-02-24 20:47,73052412,"11,136.8210","11,117.2210",20.00 AED,20.00,19.6000,0.4000,566014451,1607498,Success,United Arab Emirates,DU UAE,Transguard Group LLC,API User,E6AEAE12938
2022-02-24 20:48,73052473,"11,117.2210","11,112.3210",05.00 AED,5.00,4.9000,0.1000,566014630,1607503,Success,United Arab Emirates,DU UAE,Transguard Group LLC,API User,E6AEAE17361
2022-02-24 21:00,73053066,"11,112.3210","11,107.4210",05.00 AED,5.00,4.9000,0.1000,566016697,1607518,Success,United Arab Emirates,DU UAE,Transguard Group LLC,API User,E6AEAE17361
2022-02-24 21:03,73053202,"11,107.4210","11,097.6210",10.00 AED,10.00,9.8000,0.2000,566017171,1607523,Success,United Arab Emirates,DU UAE,Transguard Group LLC,API User,E6AEAE22430
2022-02-24 21:03,73053226,"11,097.6210","11,087.8210",10.00 AED,10.00,9.8000,0.2000,566017224,1607526,Success,United Arab Emirates,DU UAE,Transguard Group LLC,API User,E6AEAE22430
2022-02-24 21:04,73053315,"11,087.8210","11,082.9210",05.00 AED,5.00,4.9000,0.1000,566017499,1607531,Success,United Arab Emirates,DU UAE,Transguard Group LLC,API User,E6AEAE17361
2022-02-24 21:08,73053535,"11,082.9210","11,073.1210",10.00 AED,10.00,9.8000,0.2000,566018283,1607536,Success,United Arab Emirates,DU UAE,Transguard Group LLC,API User,E6AEAE22430
2022-02-24 21:10,73053587,"11,073.1210","11,064.3210",13.20 GHS,10.00,8.8000,1.2000,566018462,1607541,Success,Ghana,MTN Ghana,Transguard Group LLC,API User,GH_MT_TopUp
2022-02-24 21:11,73053655,"11,064.3210","11,055.5210",13.20 GHS,10.00,8.8000,1.2000,566018670,1607546,Success,Ghana,MTN Ghana,Transguard Group LLC,API User,GH_MT_TopUp
2022-02-24 21:19,73054097,"11,055.5210","11,045.7210",10.00 AED,10.00,9.8000,0.2000,566020056,1607553,Success,United Arab Emirates,DU UAE,Transguard Group LLC,API User,E6AEAE22430
2022-02-24 21:24,73054396,"11,045.7210","11,026.1210",20.00 AED,20.00,19.6000,0.4000,566021046,1607562,Success,United Arab Emirates,DU UAE,Transguard Group LLC,API User,E6AEAE12938
2022-02-24 21:24,73054407,"11,026.1210","11,021.2210",05.00 AED,5.00,4.9000,0.1000,566021068,1607563,Success,United Arab Emirates,DU UAE,Transguard Group LLC,API User,E6AEAE17361
2022-02-24 21:25,73054447,"11,021.2210","11,016.3210",05.00 AED,5.00,4.9000,0.1000,566021211,1607571,Success,United Arab Emirates,DU UAE,Transguard Group LLC,API User,E6AEAE17361
2022-02-24 21:26,73054469,"11,016.3210","11,006.5210",10.00 AED,10.00,9.8000,0.2000,566021271,1607574,Success,United Arab Emirates,DU UAE,Transguard Group LLC,API User,E6AEAE22430
2022-02-24 21:26,73054506,"11,006.5210","10,972.2210",35.00 AED,35.00,34.3000,0.7000,566021393,1607578,Success,United Arab Emirates,DU UAE,Transguard Group LLC,API User,E6AEAE73954
2022-02-24 21:30,73054735,"10,972.2210","10,967.3210",05.00 AED,5.00,4.9000,0.1000,566022087,1607588,Success,United Arab Emirates,DU UAE,Transguard Group LLC,API User,E6AEAE17361
2022-02-24 21:34,73054925,"10,967.3210","10,957.5210",10.00 AED,10.00,9.8000,0.2000,566022771,1607593,Success,United Arab Emirates,DU UAE,Transguard Group LLC,API User,E6AEAE22430
2022-02-24 21:42,73055305,"10,957.5210","10,947.7210",10.00 AED,10.00,9.8000,0.2000,566024164,1607599,Success,United Arab Emirates,DU UAE,Transguard Group LLC,API User,E6AEAE22430
2022-02-24 21:45,73055454,"10,947.7210","10,937.9210",10.00 AED,10.00,9.8000,0.2000,566024644,1607604,Success,United Arab Emirates,DU UAE,Transguard Group LLC,API User,E6AEAE22430
2022-02-24 21:45,73055455,"10,937.9210","10,903.6210",35.00 AED,35.00,34.3000,0.7000,566024645,1607605,Success,United Arab Emirates,DU UAE,Transguard Group LLC,API User,E6AEAE73954
2022-02-24 21:49,73055641,"10,903.6210","10,898.7210",05.00 AED,5.00,4.9000,0.1000,566025373,1607610,Success,United Arab Emirates,DU UAE,Transguard Group LLC,API User,E6AEAE17361
2022-02-24 21:49,73055657,"10,898.7210","10,893.8210",05.00 AED,5.00,4.9000,0.1000,566025418,1607613,Success,United Arab Emirates,DU UAE,Transguard Group LLC,API User,E6AEAE17361
2022-02-24 21:50,73055699,"10,893.8210","10,888.9210",05.00 AED,5.00,4.9000,0.1000,566025547,1607616,Success,United Arab Emirates,DU UAE,Transguard Group LLC,API User,E6AEAE17361
2022-02-24 21:52,73055772,"10,888.9210","10,879.1210",10.00 AED,10.00,9.8000,0.2000,566025798,1607621,Success,United Arab Emirates,DU UAE,Transguard Group LLC,API User,E6AEAE22430
2022-02-24 21:53,73055816,"10,879.1210","10,874.2210",05.00 AED,5.00,4.9000,0.1000,566025934,1607626,Success,United Arab Emirates,DU UAE,Transguard Group LLC,API User,E6AEAE17361
2022-02-24 21:53,73055839,"10,874.2210","10,864.4210",10.00 AED,10.00,9.8000,0.2000,566026007,1607629,Success,United Arab Emirates,DU UAE,Transguard Group LLC,API User,E6AEAE22430
2022-02-24 21:56,73055965,"10,864.4210","10,851.2210",19.81 GHS,15.00,13.2000,1.8000,566026486,1607634,Success,Ghana,MTN Ghana,Transguard Group LLC,API User,GH_MT_TopUp
2022-02-24 21:59,73056136,"10,851.2210","10,831.6210",20.00 AED,20.00,19.6000,0.4000,566027048,1607641,Success,United Arab Emirates,DU UAE,Transguard Group LLC,API User,E6AEAE12938
2022-02-24 22:01,73056211,"10,831.6210","10,821.8210",10.00 AED,10.00,9.8000,0.2000,566027334,1607646,Success,United Arab Emirates,DU UAE,Transguard Group LLC,API User,E6AEAE22430
2022-02-24 22:02,73056254,"10,821.8210","10,812.0210",10.00 AED,10.00,9.8000,0.2000,566027458,1607649,Success,United Arab Emirates,DU UAE,Transguard Group LLC,API User,E6AEAE22430
2022-02-24 22:03,73056288,"10,812.0210","10,807.1210",05.00 AED,5.00,4.9000,0.1000,566027581,1607653,Success,United Arab Emirates,DU UAE,Transguard Group LLC,API User,E6AEAE17361
2022-02-24 22:07,73056474,"10,807.1210","10,802.2210",05.00 AED,5.00,4.9000,0.1000,566028176,1607661,Success,United Arab Emirates,DU UAE,Transguard Group LLC,API User,E6AEAE17361
2022-02-24 22:12,73056693,"10,802.2210","10,792.4210",10.00 AED,10.00,9.8000,0.2000,566028934,1607673,Success,United Arab Emirates,DU UAE,Transguard Group LLC,API User,E6AEAE22430
2022-02-24 22:13,73056718,"10,792.4210","10,782.6210",10.00 AED,10.00,9.8000,0.2000,566029056,1607678,Success,United Arab Emirates,DU UAE,Transguard Group LLC,API User,E6AEAE22430
2022-02-24 22:30,73057416,"10,782.6210","10,772.8210",10.00 AED,10.00,9.8000,0.2000,566031652,1607699,Success,United Arab Emirates,DU UAE,Transguard Group LLC,API User,E6AEAE22430
2022-02-24 22:30,73057420,"10,772.8210","10,767.9210",05.00 AED,5.00,4.9000,0.1000,566031657,1607700,Success,United Arab Emirates,DU UAE,Transguard Group LLC,API User,E6AEAE17361
2022-02-24 22:35,73057650,"10,767.9210","10,763.0210",05.00 AED,5.00,4.9000,0.1000,566032518,1607704,Success,United Arab Emirates,DU UAE,Transguard Group LLC,API User,E6AEAE17361
2022-02-24 22:37,73057710,"10,763.0210","10,753.2210",10.00 AED,10.00,9.8000,0.2000,566032750,1607709,Success,United Arab Emirates,DU UAE,Transguard Group LLC,API User,E6AEAE22430
2022-02-24 22:41,73057889,"10,753.2210","10,743.4210",10.00 AED,10.00,9.8000,0.2000,566033417,1607715,Success,United Arab Emirates,DU UAE,Transguard Group LLC,API User,E6AEAE22430
2022-02-24 22:53,73058335,"10,743.4210","10,738.5210",05.00 AED,5.00,4.9000,0.1000,566035085,1607720,Success,United Arab Emirates,DU UAE,Transguard Group LLC,API User,E6AEAE17361
2022-02-24 22:54,73058364,"10,738.5210","10,718.9210",20.00 AED,20.00,19.6000,0.4000,566035233,1607723,Success,United Arab Emirates,DU UAE,Transguard Group LLC,API User,E6AEAE12938
2022-02-24 23:02,73058619,"10,718.9210","10,710.7810",300.00 PKR,9.25,8.1400,1.1100,566036339,1607727,Success,Pakistan,Zong Pakistan,Transguard Group LLC,API User,ZNPKPK70504
2022-02-24 23:03,73058639,"10,710.7810","10,705.8810",05.00 AED,5.00,4.9000,0.1000,566036413,1607729,Success,United Arab Emirates,DU UAE,Transguard Group LLC,API User,E6AEAE17361
2022-02-24 23:03,73058645,"10,705.8810","10,686.2810",20.00 AED,20.00,19.6000,0.4000,566036452,1607732,Success,United Arab Emirates,DU UAE,Transguard Group LLC,API User,E6AEAE12938
2022-02-24 23:04,73058679,"10,686.2810","10,681.3810",05.00 AED,5.00,4.9000,0.1000,566036590,1607735,Success,United Arab Emirates,DU UAE,Transguard Group LLC,API User,E6AEAE17361
2022-02-24 23:06,73058728,"10,681.3810","10,676.4810",05.00 AED,5.00,4.9000,0.1000,566036794,1607738,Success,United Arab Emirates,DU UAE,Transguard Group LLC,API User,E6AEAE17361
2022-02-24 23:23,73059253,"10,676.4810","10,671.5810",05.00 AED,5.00,4.9000,0.1000,566038934,1607746,Success,United Arab Emirates,DU UAE,Transguard Group LLC,API User,E6AEAE17361
2022-02-24 23:25,73059303,"10,671.5810","10,651.9810",20.00 AED,20.00,19.6000,0.4000,566039163,1607747,Success,United Arab Emirates,DU UAE,Transguard Group LLC,API User,E6AEAE12938
2022-02-24 23:37,73059635,"10,651.9810","10,642.1810",10.00 AED,10.00,9.8000,0.2000,566040683,1607753,Success,United Arab Emirates,DU UAE,Transguard Group LLC,API User,E6AEAE22430
2022-02-24 23:44,73059804,"10,642.1810","10,637.2810",05.00 AED,5.00,4.9000,0.1000,566041507,1607756,Success,United Arab Emirates,DU UAE,Transguard Group LLC,API User,E6AEAE17361
2022-02-25 00:22,73060721,"10,637.2810","10,632.3810",05.00 AED,5.00,4.9000,0.1000,566045621,1607763,Success,United Arab Emirates,DU UAE,Transguard Group LLC,API User,E6AEAE17361
2022-02-25 00:27,73060808,"10,632.3810","10,627.4810",05.00 AED,5.00,4.9000,0.1000,566046109,1607768,Success,United Arab Emirates,DU UAE,Transguard Group LLC,API User,E6AEAE17361
2022-02-25 00:29,73060851,"10,627.4810","10,607.8810",20.00 AED,20.00,19.6000,0.4000,566046304,1607771,Success,United Arab Emirates,DU UAE,Transguard Group LLC,API User,E6AEAE12938
2022-02-25 00:41,73061102,"10,607.8810","10,602.9810",05.00 AED,5.00,4.9000,0.1000,566047501,1607780,Success,United Arab Emirates,DU UAE,Transguard Group LLC,API User,E6AEAE17361
2022-02-25 00:54,73061396,"10,602.9810","10,598.0810",05.00 AED,5.00,4.9000,0.1000,566048792,1607785,Success,United Arab Emirates,DU UAE,Transguard Group LLC,API User,E6AEAE17361
2022-02-25 01:19,73061884,"10,598.0810","10,581.1410",470.00 NPR,19.25,16.9400,2.3100,566051343,1607788,Success,Nepal,Ncell Nepal,Transguard Group LLC,API User,NCNPNP37643
2022-02-25 01:20,73061906,"10,581.1410","10,571.3410",10.00 AED,10.00,9.8000,0.2000,566051451,1607791,Success,United Arab Emirates,DU UAE,Transguard Group LLC,API User,E6AEAE22430
2022-02-25 01:21,73061930,"10,571.3410","10,566.4410",05.00 AED,5.00,4.9000,0.1000,566051580,1607794,Success,United Arab Emirates,DU UAE,Transguard Group LLC,API User,E6AEAE17361
2022-02-25 01:30,73062102,"10,566.4410","10,561.5410",05.00 AED,5.00,4.9000,0.1000,566052496,1607803,Success,United Arab Emirates,DU UAE,Transguard Group LLC,API User,E6AEAE17361
2022-02-25 01:39,73062261,"10,561.5410","10,556.6410",05.00 AED,5.00,4.9000,0.1000,566053358,1607806,Success,United Arab Emirates,DU UAE,Transguard Group LLC,API User,E6AEAE17361
2022-02-25 01:50,73062436,"10,556.6410","10,532.1410",25.00 AED,25.00,24.5000,0.5000,566054368,1607813,Success,United Arab Emirates,DU UAE,Transguard Group LLC,API User,E6AEAE25659
2022-02-25 02:25,73063079,"10,532.1410","10,523.3410","7,335.00 UGX",10.00,8.8000,1.2000,566057783,1607816,Success,Uganda,Airtel Uganda,Transguard Group LLC,API User,UG_WA_TopUp
2022-02-25 03:19,73064064,"10,523.3410","10,518.4410",05.00 AED,5.00,4.9000,0.1000,566063046,1607832,Success,United Arab Emirates,DU UAE,Transguard Group LLC,API User,E6AEAE17361
2022-02-25 03:20,73064086,"10,518.4410","10,513.5410",05.00 AED,5.00,4.9000,0.1000,566063145,1607835,Success,United Arab Emirates,DU UAE,Transguard Group LLC,API User,E6AEAE17361
2022-02-25 03:37,73064397,"10,513.5410","10,508.6410",05.00 AED,5.00,4.9000,0.1000,566064902,1607844,Success,United Arab Emirates,DU UAE,Transguard Group LLC,API User,E6AEAE17361
2022-02-25 03:40,73064464,"10,508.6410","10,503.7410",05.00 AED,5.00,4.9000,0.1000,566065217,1607851,Success,United Arab Emirates,DU UAE,Transguard Group LLC,API User,E6AEAE17361
2022-02-25 04:29,73065290,"10,503.7410","10,493.9410",10.00 AED,10.00,9.8000,0.2000,566069690,1607857,Success,United Arab Emirates,DU UAE,Transguard Group LLC,API User,E6AEAE22430
2022-02-25 04:31,73065341,"10,493.9410","10,484.1410",10.00 AED,10.00,9.8000,0.2000,566069942,1607860,Success,United Arab Emirates,DU UAE,Transguard Group LLC,API User,E6AEAE22430
2022-02-25 04:44,73065552,"10,484.1410","10,476.0010",300.00 PKR,9.25,8.1400,1.1100,566071179,1607869,Success,Pakistan,Zong Pakistan,Transguard Group LLC,API User,ZNPKPK70504
2022-02-25 04:53,73065685,"10,476.0010","10,466.2010",10.00 AED,10.00,9.8000,0.2000,566071890,1607872,Success,United Arab Emirates,DU UAE,Transguard Group LLC,API User,E6AEAE22430
2022-02-25 05:06,73065901,"10,466.2010","10,456.4010",10.00 AED,10.00,9.8000,0.2000,566072981,1607879,Success,United Arab Emirates,DU UAE,Transguard Group LLC,API User,E6AEAE22430
2022-02-25 05:09,73065956,"10,456.4010","10,446.6010",10.00 AED,10.00,9.8000,0.2000,566073228,1607882,Success,United Arab Emirates,DU UAE,Transguard Group LLC,API User,E6AEAE22430
2022-02-25 05:11,73065996,"10,446.6010","10,441.7010",05.00 AED,5.00,4.9000,0.1000,566073393,1607887,Success,United Arab Emirates,DU UAE,Transguard Group LLC,API User,E6AEAE17361
2022-02-25 05:13,73066033,"10,441.7010","10,436.8010",05.00 AED,5.00,4.9000,0.1000,566073614,1607892,Success,United Arab Emirates,DU UAE,Transguard Group LLC,API User,E6AEAE17361
2022-02-25 05:14,73066056,"10,436.8010","10,431.9010",05.00 AED,5.00,4.9000,0.1000,566073710,1607895,Success,United Arab Emirates,DU UAE,Transguard Group LLC,API User,E6AEAE17361
2022-02-25 05:23,73066197,"10,431.9010","10,422.1010",10.00 AED,10.00,9.8000,0.2000,566074394,1607904,Success,United Arab Emirates,DU UAE,Transguard Group LLC,API User,E6AEAE22430
2022-02-25 05:25,73066229,"10,422.1010","10,417.2010",05.00 AED,5.00,4.9000,0.1000,566074531,1607907,Success,United Arab Emirates,DU UAE,Transguard Group LLC,API User,E6AEAE17361
2022-02-25 05:37,73066438,"10,417.2010","10,407.4010",10.00 AED,10.00,9.8000,0.2000,566075490,1607916,Success,United Arab Emirates,DU UAE,Transguard Group LLC,API User,E6AEAE22430
2022-02-25 05:40,73066499,"10,407.4010","10,402.5010",05.00 AED,5.00,4.9000,0.1000,566075738,1607921,Success,United Arab Emirates,DU UAE,Transguard Group LLC,API User,E6AEAE17361
2022-02-25 05:48,73066628,"10,402.5010","10,394.3610",300.00 PKR,9.25,8.1400,1.1100,566076277,1607929,Success,Pakistan,Zong Pakistan,Transguard Group LLC,API User,ZNPKPK70504
2022-02-25 05:49,73066642,"10,394.3610","10,389.4610",05.00 AED,5.00,4.9000,0.1000,566076321,1607932,Success,United Arab Emirates,DU UAE,Transguard Group LLC,API User,E6AEAE17361
2022-02-25 05:54,73066735,"10,389.4610","10,385.2810",50.00 PHP,4.75,4.1800,0.5700,566076730,1607939,Success,Philippines,Smart (SunCellular) Philippines,Transguard Group LLC,API User,PH_SM_TopUp_50.00
2022-02-25 05:55,73066750,"10,385.2810","10,381.1010",50.00 PHP,4.75,4.1800,0.5700,566076792,1607942,Success,Philippines,Smart (SunCellular) Philippines,Transguard Group LLC,API User,PH_SM_TopUp_50.00
2022-02-25 05:56,73066759,"10,381.1010","10,376.2010",05.00 AED,5.00,4.9000,0.1000,566076831,1607945,Success,United Arab Emirates,DU UAE,Transguard Group LLC,API User,E6AEAE17361
2022-02-25 05:56,73066770,"10,376.2010","10,366.4010",10.00 AED,10.00,9.8000,0.2000,566076862,1607949,Success,United Arab Emirates,DU UAE,Transguard Group LLC,API User,E6AEAE22430
2022-02-25 05:57,73066789,"10,366.4010","10,361.5010",05.00 AED,5.00,4.9000,0.1000,566076918,1607955,Success,United Arab Emirates,DU UAE,Transguard Group LLC,API User,E6AEAE17361
2022-02-25 05:58,73066810,"10,361.5010","10,356.6010",05.00 AED,5.00,4.9000,0.1000,566077009,1607960,Success,United Arab Emirates,DU UAE,Transguard Group LLC,API User,E6AEAE17361
2022-02-25 06:09,73067022,"10,356.6010","10,351.7010",05.00 AED,5.00,4.9000,0.1000,566077867,1607973,Success,United Arab Emirates,DU UAE,Transguard Group LLC,API User,E6AEAE17361
2022-02-25 06:17,73067160,"10,351.7010","10,346.8010",05.00 AED,5.00,4.9000,0.1000,566078348,1607976,Success,United Arab Emirates,DU UAE,Transguard Group LLC,API User,E6AEAE17361
2022-02-25 06:24,73067287,"10,346.8010","10,337.0010",10.00 AED,10.00,9.8000,0.2000,566078885,1607985,Success,United Arab Emirates,DU UAE,Transguard Group LLC,API User,E6AEAE22430
2022-02-25 06:28,73067361,"10,337.0010","10,332.1010",05.00 AED,5.00,4.9000,0.1000,566079179,1607990,Success,United Arab Emirates,DU UAE,Transguard Group LLC,API User,E6AEAE17361
2022-02-25 06:33,73067459,"10,332.1010","10,312.5010",20.00 AED,20.00,19.6000,0.4000,566079521,1607995,Success,United Arab Emirates,DU UAE,Transguard Group LLC,API User,E6AEAE12938
2022-02-25 06:33,73067472,"10,312.5010","10,302.7010",10.00 AED,10.00,9.8000,0.2000,566079590,1607998,Success,United Arab Emirates,DU UAE,Transguard Group LLC,API User,E6AEAE22430
2022-02-25 06:44,73067685,"10,302.7010","10,248.8010",55.00 AED,55.00,53.9000,1.1000,566080362,1608003,Success,United Arab Emirates,DU UAE,Transguard Group LLC,API User,E6AEAE81767
2022-02-25 06:51,73067819,"10,248.8010","10,243.9010",05.00 AED,5.00,4.9000,0.1000,566080881,1608015,Success,United Arab Emirates,DU UAE,Transguard Group LLC,API User,E6AEAE17361
2022-02-25 06:54,73067857,"10,243.9010","10,239.0010",05.00 AED,5.00,4.9000,0.1000,566081019,1608020,Success,United Arab Emirates,DU UAE,Transguard Group LLC,API User,E6AEAE17361
2022-02-25 07:04,73068052,"10,239.0010","10,234.1010",05.00 AED,5.00,4.9000,0.1000,566081711,1608034,Success,United Arab Emirates,DU UAE,Transguard Group LLC,API User,E6AEAE17361
2022-02-25 07:12,73068202,"10,234.1010","10,224.3010",10.00 AED,10.00,9.8000,0.2000,566082240,1608039,Success,United Arab Emirates,DU UAE,Transguard Group LLC,API User,E6AEAE22430
2022-02-25 07:20,73068380,"10,224.3010","10,204.7010",20.00 AED,20.00,19.6000,0.4000,566082794,1608048,Success,United Arab Emirates,DU UAE,Transguard Group LLC,API User,E6AEAE12938
2022-02-25 07:21,73068394,"10,204.7010","10,194.9010",10.00 AED,10.00,9.8000,0.2000,566082869,1608051,Success,United Arab Emirates,DU UAE,Transguard Group LLC,API User,E6AEAE22430
2022-02-25 07:22,73068407,"10,194.9010","10,190.0010",05.00 AED,5.00,4.9000,0.1000,566082909,1608055,Failure,United Arab Emirates,DU UAE,Transguard Group LLC,API User,E6AEAE17361
2022-02-25 07:22,73068407,"10,190.0010","10,185.1010",05.00 AED,5.00,4.9000,0.1000,566082909,1608055,Failure,United Arab Emirates,DU UAE,Transguard Group LLC,API User,E6AEAE17361
2022-02-25 07:25,73068485,"10,194.9010","10,190.0010",05.00 AED,5.00,4.9000,0.1000,566083181,1608060,Success,United Arab Emirates,DU UAE,Transguard Group LLC,API User,E6AEAE17361
2022-02-25 07:43,73068845,"10,190.0010","10,186.2610",151.00 PKR,4.25,3.7400,0.5100,566084437,1608080,Success,Pakistan,Telenor Pakistan,Transguard Group LLC,API User,TPPKPK94108
2022-02-25 07:47,73068927,"10,186.2610","10,181.3610",05.00 AED,5.00,4.9000,0.1000,566084707,1608085,Success,United Arab Emirates,DU UAE,Transguard Group LLC,API User,E6AEAE17361
2022-02-25 07:48,73068942,"10,181.3610","10,176.4610",05.00 AED,5.00,4.9000,0.1000,566084762,1608088,Success,United Arab Emirates,DU UAE,Transguard Group LLC,API User,E6AEAE17361
2022-02-25 07:55,73069067,"10,176.4610","10,171.5610",05.00 AED,5.00,4.9000,0.1000,566085218,1608096,Success,United Arab Emirates,DU UAE,Transguard Group LLC,API User,E6AEAE17361
2022-02-25 07:55,73069073,"10,171.5610","10,167.3810",150.00 PKR,4.75,4.1800,0.5700,566085236,1608099,Success,Pakistan,Zong Pakistan,Transguard Group LLC,API User,ZNPKPK65621
2022-02-25 07:55,73069084,"10,167.3810","10,162.4810",05.00 AED,5.00,4.9000,0.1000,566085275,1608104,Success,United Arab Emirates,DU UAE,Transguard Group LLC,API User,E6AEAE17361
2022-02-25 07:56,73069091,"10,162.4810","10,158.3010",150.00 PKR,4.75,4.1800,0.5700,566085307,1608107,Success,Pakistan,Ufone Pakistan,Transguard Group LLC,API User,UFPKPK90336
2022-02-25 08:02,73069219,"10,158.3010","10,148.5010",10.00 AED,10.00,9.8000,0.2000,566085697,1608119,Success,United Arab Emirates,DU UAE,Transguard Group LLC,API User,E6AEAE22430
2022-02-25 08:03,73069244,"10,148.5010","10,138.7010",10.00 AED,10.00,9.8000,0.2000,566085777,1608122,Success,United Arab Emirates,DU UAE,Transguard Group LLC,API User,E6AEAE22430
2022-02-25 08:03,73069254,"10,138.7010","10,133.8010",05.00 AED,5.00,4.9000,0.1000,566085810,1608125,Success,United Arab Emirates,DU UAE,Transguard Group LLC,API User,E6AEAE17361
2022-02-25 08:06,73069318,"10,133.8010","10,114.2010",20.00 AED,20.00,19.6000,0.4000,566086019,1608132,Success,United Arab Emirates,DU UAE,Transguard Group LLC,API User,E6AEAE12938
2022-02-25 08:07,73069340,"10,114.2010","10,109.3010",05.00 AED,5.00,4.9000,0.1000,566086088,1608135,Success,United Arab Emirates,DU UAE,Transguard Group LLC,API User,E6AEAE17361
2022-02-25 08:13,73069453,"10,109.3010","10,104.4010",05.00 AED,5.00,4.9000,0.1000,566086481,1608140,Success,United Arab Emirates,DU UAE,Transguard Group LLC,API User,E6AEAE17361
2022-02-25 08:14,73069469,"10,104.4010","10,094.6010",10.00 AED,10.00,9.8000,0.2000,566086553,1608143,Success,United Arab Emirates,DU UAE,Transguard Group LLC,API User,E6AEAE22430
2022-02-25 08:16,73069523,"10,094.6010","10,089.7010",05.00 AED,5.00,4.9000,0.1000,566086735,1608153,Success,United Arab Emirates,DU UAE,Transguard Group LLC,API User,E6AEAE17361
2022-02-25 08:23,73069675,"10,089.7010","10,084.8010",05.00 AED,5.00,4.9000,0.1000,566087226,1608162,Success,United Arab Emirates,DU UAE,Transguard Group LLC,API User,E6AEAE17361
2022-02-25 08:28,73069778,"10,084.8010","10,079.9010",05.00 AED,5.00,4.9000,0.1000,566087578,1608165,Success,United Arab Emirates,DU UAE,Transguard Group LLC,API User,E6AEAE17361
2022-02-25 08:33,73069869,"10,079.9010","10,075.7210",50.00 PHP,4.75,4.1800,0.5700,566087904,73069869,Success,Philippines,Smart (SunCellular) Philippines,Transguard Group LLC,mohammed.arafath@transguardgroup.com,PH_SM_TopUp_50.00
2022-02-25 08:34,73069914,"10,075.7210","10,051.2210",25.00 AED,25.00,24.5000,0.5000,566088030,73069914,Success,United Arab Emirates,DU UAE,Transguard Group LLC,mohammed.arafath@transguardgroup.com,E6AEAE17343
2022-02-25 08:37,73069989,"10,051.2210","10,046.3210",05.00 AED,5.00,4.9000,0.1000,566088278,73069989,Success,United Arab Emirates,DU UAE,Transguard Group LLC,mohammed.arafath@transguardgroup.com,E6AEAE17361
2022-02-25 08:38,73070022,"10,046.3210","10,042.1410",150.00 PKR,4.75,4.1800,0.5700,566088395,73070022,Success,Pakistan,Zong Pakistan,Transguard Group LLC,mohammed.arafath@transguardgroup.com,ZNPKPK65621
2022-02-25 08:39,73070036,"10,042.1410","10,037.2410",05.00 AED,5.00,4.9000,0.1000,566088437,1608176,Success,United Arab Emirates,DU UAE,Transguard Group LLC,API User,E6AEAE17361
2022-02-25 08:40,73070052,"10,037.2410","10,032.3410",05.00 AED,5.00,4.9000,0.1000,566088483,73070052,Success,United Arab Emirates,DU UAE,Transguard Group LLC,mohammed.arafath@transguardgroup.com,E6AEAE17361
2022-02-25 08:40,73070071,"10,032.3410","10,027.4410",05.00 AED,5.00,4.9000,0.1000,566088527,73070071,Success,United Arab Emirates,DU UAE,Transguard Group LLC,mohammed.arafath@transguardgroup.com,E6AEAE17361
2022-02-25 08:42,73070098,"10,027.4410","10,011.3810",575.00 PKR,18.25,16.0600,2.1900,566088611,73070098,Success,Pakistan,Jazz Pakistan,Transguard Group LLC,mohammed.arafath@transguardgroup.com,MBPKPK68304
2022-02-25 08:42,73070115,"10,011.3810","10,001.5810",10.00 AED,10.00,9.8000,0.2000,566088660,1608182,Success,United Arab Emirates,DU UAE,Transguard Group LLC,API User,E6AEAE22430
2022-02-25 08:44,73070173,"10,001.5810","9,996.6810",05.00 AED,5.00,4.9000,0.1000,566088835,1608187,Success,United Arab Emirates,DU UAE,Transguard Group LLC,API User,E6AEAE17361
2022-02-25 08:45,73070199,"9,996.6810","9,986.8810",10.00 AED,10.00,9.8000,0.2000,566088908,1608190,Success,United Arab Emirates,DU UAE,Transguard Group LLC,API User,E6AEAE22430
2022-02-25 08:46,73070207,"9,986.8810","9,981.9810",05.00 AED,5.00,4.9000,0.1000,566088930,1608193,Success,United Arab Emirates,DU UAE,Transguard Group LLC,API User,E6AEAE17361
2022-02-25 08:47,73070235,"9,981.9810","9,977.8010",150.00 PKR,4.75,4.1800,0.5700,566089039,73070235,Success,Pakistan,Zong Pakistan,Transguard Group LLC,mohammed.arafath@transguardgroup.com,ZNPKPK65621
2022-02-25 08:48,73070262,"9,977.8010","9,968.0010",10.00 AED,10.00,9.8000,0.2000,566089129,73070262,Success,United Arab Emirates,DU UAE,Transguard Group LLC,mohammed.arafath@transguardgroup.com,E6AEAE22430
2022-02-25 08:53,73070376,"9,968.0010","9,963.1010",05.00 AED,5.00,4.9000,0.1000,566089465,1608212,Success,United Arab Emirates,DU UAE,Transguard Group LLC,API User,E6AEAE17361
2022-02-25 09:00,73070575,"9,963.1010","9,958.2010",05.00 AED,5.00,4.9000,0.1000,566090011,1608223,Success,United Arab Emirates,DU UAE,Transguard Group LLC,API User,E6AEAE17361
2022-02-25 09:02,73070629,"9,958.2010","9,953.3010",05.00 AED,5.00,4.9000,0.1000,566090132,1608227,Success,United Arab Emirates,DU UAE,Transguard Group LLC,API User,E6AEAE17361
2022-02-25 09:06,73070723,"9,953.3010","9,943.5010",10.00 AED,10.00,9.8000,0.2000,566090406,1608232,Success,United Arab Emirates,DU UAE,Transguard Group LLC,API User,E6AEAE22430
2022-02-25 09:10,73070840,"9,943.5010","9,938.6010",05.00 AED,5.00,4.9000,0.1000,566090776,1608245,Success,United Arab Emirates,DU UAE,Transguard Group LLC,API User,E6AEAE17361
2022-02-25 09:11,73070854,"9,938.6010","9,933.7010",05.00 AED,5.00,4.9000,0.1000,566090818,1608249,Success,United Arab Emirates,DU UAE,Transguard Group LLC,API User,E6AEAE17361
2022-02-25 09:14,73070937,"9,933.7010","9,928.8010",05.00 AED,5.00,4.9000,0.1000,566091026,1608253,Success,United Arab Emirates,DU UAE,Transguard Group LLC,API User,E6AEAE17361
2022-02-25 09:15,73070970,"9,928.8010","9,923.9010",05.00 AED,5.00,4.9000,0.1000,566091131,1608256,Success,United Arab Emirates,DU UAE,Transguard Group LLC,API User,E6AEAE17361
2022-02-25 09:16,73071001,"9,923.9010","9,919.0010",05.00 AED,5.00,4.9000,0.1000,566091228,73071001,Success,United Arab Emirates,DU UAE,Transguard Group LLC,mohammed.arafath@transguardgroup.com,E6AEAE17361
2022-02-25 09:25,73071248,"9,919.0010","9,914.1010",05.00 AED,5.00,4.9000,0.1000,566091925,1608269,Success,United Arab Emirates,DU UAE,Transguard Group LLC,API User,E6AEAE17361
2022-02-25 09:30,73071382,"9,914.1010","9,909.2010",05.00 AED,5.00,4.9000,0.1000,566092299,1608277,Success,United Arab Emirates,DU UAE,Transguard Group LLC,API User,E6AEAE17361
2022-02-25 09:32,73071445,"9,909.2010","9,905.0210",150.00 PKR,4.75,4.1800,0.5700,566092482,1608283,Success,Pakistan,Zong Pakistan,Transguard Group LLC,API User,ZNPKPK65621
2022-02-25 09:33,73071450,"9,905.0210","9,895.2210",10.00 AED,10.00,9.8000,0.2000,566092502,1608286,Success,United Arab Emirates,DU UAE,Transguard Group LLC,API User,E6AEAE22430
2022-02-25 09:34,73071474,"9,895.2210","9,885.4210",10.00 AED,10.00,9.8000,0.2000,566092575,1608289,Success,United Arab Emirates,DU UAE,Transguard Group LLC,API User,E6AEAE22430
2022-02-25 09:35,73071506,"9,885.4210","9,875.6210",10.00 AED,10.00,9.8000,0.2000,566092649,1608292,Success,United Arab Emirates,DU UAE,Transguard Group LLC,API User,E6AEAE22430
2022-02-25 09:36,73071555,"9,875.6210","9,867.2610",300.00 PKR,9.50,8.3600,1.1400,566092964,1608297,Success,Pakistan,Jazz Pakistan,Transguard Group LLC,API User,PK_MB_TopUp_300.00
2022-02-25 09:45,73071781,"9,867.2610","9,862.3610",05.00 AED,5.00,4.9000,0.1000,566093643,1608309,Success,United Arab Emirates,DU UAE,Transguard Group LLC,API User,E6AEAE17361
2022-02-25 09:48,73071879,"9,862.3610","9,857.4610",05.00 AED,5.00,4.9000,0.1000,566093898,1608318,Success,United Arab Emirates,DU UAE,Transguard Group LLC,API User,E6AEAE17361
2022-02-25 09:48,73071893,"9,857.4610","9,852.5610",05.00 AED,5.00,4.9000,0.1000,566093926,1608321,Success,United Arab Emirates,DU UAE,Transguard Group LLC,API User,E6AEAE17361
2022-02-25 09:49,73071919,"9,852.5610","9,847.6610",05.00 AED,5.00,4.9000,0.1000,566093986,1608326,Success,United Arab Emirates,DU UAE,Transguard Group LLC,API User,E6AEAE17361
2022-02-25 09:52,73071999,"9,847.6610","9,830.7210",470.00 NPR,19.25,16.9400,2.3100,566094221,1608331,Success,Nepal,Ncell Nepal,Transguard Group LLC,API User,NCNPNP37643
2022-02-25 09:52,73072014,"9,830.7210","9,825.8210",05.00 AED,5.00,4.9000,0.1000,566094269,1608335,Success,United Arab Emirates,DU UAE,Transguard Group LLC,API User,E6AEAE17361
2022-02-25 09:53,73072021,"9,825.8210","9,816.0210",10.00 AED,10.00,9.8000,0.2000,566094300,1608338,Success,United Arab Emirates,DU UAE,Transguard Group LLC,API User,E6AEAE22430
2022-02-25 09:54,73072052,"9,816.0210","9,806.2210",10.00 AED,10.00,9.8000,0.2000,566094388,73072052,Success,United Arab Emirates,DU UAE,Transguard Group LLC,mohammed.arafath@transguardgroup.com,E6AEAE22430
2022-02-25 09:55,73072081,"9,806.2210","9,796.4210",10.00 AED,10.00,9.8000,0.2000,566094485,73072081,Success,United Arab Emirates,DU UAE,Transguard Group LLC,mohammed.arafath@transguardgroup.com,E6AEAE22430
2022-02-25 09:58,73072156,"9,796.4210","9,791.5210",05.00 AED,5.00,4.9000,0.1000,566094744,1608354,Success,United Arab Emirates,DU UAE,Transguard Group LLC,API User,E6AEAE17361
2022-02-25 10:02,73072264,"9,791.5210","9,786.6210",05.00 AED,5.00,4.9000,0.1000,566095069,1608361,Success,United Arab Emirates,DU UAE,Transguard Group LLC,API User,E6AEAE17361
2022-02-25 10:03,73072297,"9,786.6210","9,747.4210",40.00 AED,40.00,39.2000,0.8000,566095167,1608367,Success,United Arab Emirates,DU UAE,Transguard Group LLC,API User,E6AEAE64011
2022-02-25 10:06,73072391,"9,747.4210","9,739.2810",300.00 PKR,9.25,8.1400,1.1100,566095450,1608371,Success,Pakistan,Zong Pakistan,Transguard Group LLC,API User,ZNPKPK70504
2022-02-25 10:16,73072710,"9,739.2810","9,734.3810",05.00 AED,5.00,4.9000,0.1000,566096243,1608381,Success,United Arab Emirates,DU UAE,Transguard Group LLC,API User,E6AEAE17361
2022-02-25 10:18,73072759,"9,734.3810","9,729.4810",05.00 AED,5.00,4.9000,0.1000,566096412,1608384,Success,United Arab Emirates,DU UAE,Transguard Group LLC,API User,E6AEAE17361
2022-02-25 10:20,73072826,"9,729.4810","9,724.5810",05.00 AED,5.00,4.9000,0.1000,566096619,1608388,Success,United Arab Emirates,DU UAE,Transguard Group LLC,API User,E6AEAE17361
2022-02-25 10:21,73072842,"9,724.5810","9,714.7810",10.00 AED,10.00,9.8000,0.2000,566096663,1608393,Success,United Arab Emirates,DU UAE,Transguard Group LLC,API User,E6AEAE22430
2022-02-25 10:21,73072853,"9,714.7810","9,709.8810",05.00 AED,5.00,4.9000,0.1000,566096705,1608396,Success,United Arab Emirates,DU UAE,Transguard Group LLC,API User,E6AEAE17361
2022-02-25 10:22,73072900,"9,709.8810","9,704.9810",05.00 AED,5.00,4.9000,0.1000,566096789,1608400,Success,United Arab Emirates,DU UAE,Transguard Group LLC,API User,E6AEAE17361
2022-02-25 10:23,73072905,"9,704.9810","9,695.1810",10.00 AED,10.00,9.8000,0.2000,566096818,1608403,Success,United Arab Emirates,DU UAE,Transguard Group LLC,API User,E6AEAE22430
2022-02-25 10:31,73073144,"9,695.1810","9,690.2810",05.00 AED,5.00,4.9000,0.1000,566097536,1608412,Success,United Arab Emirates,DU UAE,Transguard Group LLC,API User,E6AEAE17361
2022-02-25 10:32,73073151,"9,690.2810","9,685.3810",05.00 AED,5.00,4.9000,0.1000,566097561,1608415,Success,United Arab Emirates,DU UAE,Transguard Group LLC,API User,E6AEAE17361
2022-02-25 10:32,73073171,"9,685.3810","9,680.4810",05.00 AED,5.00,4.9000,0.1000,566097619,1608419,Success,United Arab Emirates,DU UAE,Transguard Group LLC,API User,E6AEAE17361
2022-02-25 10:32,73073178,"9,680.4810","9,676.7410",100.00 NPR,4.25,3.7400,0.5100,566097637,1608420,Success,Nepal,Ncell Nepal,Transguard Group LLC,API User,NP_NC_TopUp_100.00
2022-02-25 10:41,73073417,"9,676.7410","9,666.9410",10.00 AED,10.00,9.8000,0.2000,566098405,1608431,Success,United Arab Emirates,DU UAE,Transguard Group LLC,API User,E6AEAE22430
2022-02-25 10:42,73073439,"9,666.9410","9,657.1410",10.00 AED,10.00,9.8000,0.2000,566098480,1608434,Success,United Arab Emirates,DU UAE,Transguard Group LLC,API User,E6AEAE22430
2022-02-25 10:43,73073461,"9,657.1410","9,647.3410",10.00 AED,10.00,9.8000,0.2000,566098534,1608439,Success,United Arab Emirates,DU UAE,Transguard Group LLC,API User,E6AEAE22430
2022-02-25 10:44,73073492,"9,647.3410","9,637.5410",10.00 AED,10.00,9.8000,0.2000,566098614,1608442,Success,United Arab Emirates,DU UAE,Transguard Group LLC,API User,E6AEAE22430
2022-02-25 10:46,73073570,"9,637.5410","9,627.7410",10.00 AED,10.00,9.8000,0.2000,566098801,1608445,Success,United Arab Emirates,DU UAE,Transguard Group LLC,API User,E6AEAE22430
2022-02-25 10:49,73073670,"9,627.7410","9,617.9410",10.00 AED,10.00,9.8000,0.2000,566099055,1608448,Success,United Arab Emirates,DU UAE,Transguard Group LLC,API User,E6AEAE22430
2022-02-25 10:53,73073773,"9,617.9410","9,613.0410",05.00 AED,5.00,4.9000,0.1000,566099365,1608454,Success,United Arab Emirates,DU UAE,Transguard Group LLC,API User,E6AEAE17361
2022-02-25 10:54,73073826,"9,613.0410","9,603.2410",10.00 AED,10.00,9.8000,0.2000,566099504,1608457,Success,United Arab Emirates,DU UAE,Transguard Group LLC,API User,E6AEAE22430
2022-02-25 10:58,73073926,"9,603.2410","9,598.3410",05.00 AED,5.00,4.9000,0.1000,566099828,1608464,Success,United Arab Emirates,DU UAE,Transguard Group LLC,API User,E6AEAE17361
2022-02-25 11:10,73074318,"9,598.3410","9,593.4410",05.00 AED,5.00,4.9000,0.1000,566100900,1608477,Success,United Arab Emirates,DU UAE,Transguard Group LLC,API User,E6AEAE17361
2022-02-25 11:20,73074588,"9,593.4410","9,583.6410",10.00 AED,10.00,9.8000,0.2000,566101734,1608484,Success,United Arab Emirates,DU UAE,Transguard Group LLC,API User,E6AEAE22430
2022-02-25 11:21,73074625,"9,583.6410","9,573.8410",10.00 AED,10.00,9.8000,0.2000,566101829,1608489,Success,United Arab Emirates,DU UAE,Transguard Group LLC,API User,E6AEAE22430
2022-02-25 11:21,73074650,"9,573.8410","9,564.0410",10.00 AED,10.00,9.8000,0.2000,566101888,1608492,Success,United Arab Emirates,DU UAE,Transguard Group LLC,API User,E6AEAE22430
2022-02-25 11:27,73074824,"9,564.0410","9,559.1410",05.00 AED,5.00,4.9000,0.1000,566102373,1608504,Success,United Arab Emirates,DU UAE,Transguard Group LLC,API User,E6AEAE17361
2022-02-25 11:33,73074998,"9,559.1410","9,554.2410",05.00 AED,5.00,4.9000,0.1000,566102839,1608514,Success,United Arab Emirates,DU UAE,Transguard Group LLC,API User,E6AEAE17361
2022-02-25 11:37,73075146,"9,554.2410","9,544.4410",10.00 AED,10.00,9.8000,0.2000,566103248,1608520,Success,United Arab Emirates,DU UAE,Transguard Group LLC,API User,E6AEAE22430
2022-02-25 11:37,73075156,"9,544.4410","9,539.5410",05.00 AED,5.00,4.9000,0.1000,566103282,1608522,Success,United Arab Emirates,DU UAE,Transguard Group LLC,API User,E6AEAE17361
2022-02-25 11:39,73075190,"9,539.5410","9,534.6410",05.00 AED,5.00,4.9000,0.1000,566103394,1608528,Success,United Arab Emirates,DU UAE,Transguard Group LLC,API User,E6AEAE17361
2022-02-25 11:46,73075390,"9,534.6410","9,529.7410",05.00 AED,5.00,4.9000,0.1000,566104007,1608537,Success,United Arab Emirates,DU UAE,Transguard Group LLC,API User,E6AEAE17361
2022-02-25 11:46,73075406,"9,529.7410","9,524.8410",05.00 AED,5.00,4.9000,0.1000,566104051,1608540,Success,United Arab Emirates,DU UAE,Transguard Group LLC,API User,E6AEAE17361
2022-02-25 11:48,73075453,"9,524.8410","9,515.0410",10.00 AED,10.00,9.8000,0.2000,566104168,1608544,Success,United Arab Emirates,DU UAE,Transguard Group LLC,API User,E6AEAE22430
2022-02-25 11:49,73075522,"9,515.0410","9,510.1410",05.00 AED,5.00,4.9000,0.1000,566104347,1608554,Success,United Arab Emirates,DU UAE,Transguard Group LLC,API User,E6AEAE17361
2022-02-25 11:50,73075524,"9,510.1410","9,505.2410",05.00 AED,5.00,4.9000,0.1000,566104355,1608557,Success,United Arab Emirates,DU UAE,Transguard Group LLC,API User,E6AEAE17361
2022-02-25 11:50,73075527,"9,505.2410","9,500.3410",05.00 AED,5.00,4.9000,0.1000,566104367,1608558,Success,United Arab Emirates,DU UAE,Transguard Group LLC,API User,E6AEAE17361
2022-02-25 11:53,73075613,"9,500.3410","9,490.5410",10.00 AED,10.00,9.8000,0.2000,566104653,1608561,Success,United Arab Emirates,DU UAE,Transguard Group LLC,API User,E6AEAE22430
2022-02-25 11:57,73075734,"9,490.5410","9,480.7410",10.00 AED,10.00,9.8000,0.2000,566104997,1608568,Success,United Arab Emirates,DU UAE,Transguard Group LLC,API User,E6AEAE22430
2022-02-25 11:59,73075802,"9,480.7410","9,475.8410",05.00 AED,5.00,4.9000,0.1000,566105187,1608571,Success,United Arab Emirates,DU UAE,Transguard Group LLC,API User,E6AEAE17361
2022-02-25 12:00,73075840,"9,475.8410","9,470.9410",05.00 AED,5.00,4.9000,0.1000,566105291,1608574,Success,United Arab Emirates,DU UAE,Transguard Group LLC,API User,E6AEAE17361
2022-02-25 12:07,73076040,"9,470.9410","9,466.0410",05.00 AED,5.00,4.9000,0.1000,566105906,1608583,Success,United Arab Emirates,DU UAE,Transguard Group LLC,API User,E6AEAE17361
2022-02-25 12:16,73076270,"9,466.0410","9,461.1410",05.00 AED,5.00,4.9000,0.1000,566106634,1608591,Success,United Arab Emirates,DU UAE,Transguard Group LLC,API User,E6AEAE17361
2022-02-25 12:18,73076325,"9,461.1410","9,436.6410",25.00 AED,25.00,24.5000,0.5000,566106789,1608593,Success,United Arab Emirates,DU UAE,Transguard Group LLC,API User,E6AEAE17343
2022-02-25 12:20,73076395,"9,436.6410","9,431.7410",05.00 AED,5.00,4.9000,0.1000,566107002,1608599,Success,United Arab Emirates,DU UAE,Transguard Group LLC,API User,E6AEAE17361
2022-02-25 12:21,73076408,"9,431.7410","9,426.8410",05.00 AED,5.00,4.9000,0.1000,566107030,1608603,Success,United Arab Emirates,DU UAE,Transguard Group LLC,API User,E6AEAE17361
2022-02-25 12:25,73076529,"9,426.8410","9,417.0410",10.00 AED,10.00,9.8000,0.2000,566107406,1608610,Success,United Arab Emirates,DU UAE,Transguard Group LLC,API User,E6AEAE22430
2022-02-25 12:27,73076579,"9,417.0410","9,412.1410",05.00 AED,5.00,4.9000,0.1000,566107559,1608614,Success,United Arab Emirates,DU UAE,Transguard Group LLC,API User,E6AEAE17361
2022-02-25 12:29,73076644,"9,412.1410","9,407.2410",05.00 AED,5.00,4.9000,0.1000,566107764,1608619,Success,United Arab Emirates,DU UAE,Transguard Group LLC,API User,E6AEAE17361
2022-02-25 12:40,73076931,"9,407.2410","9,397.4410",10.00 AED,10.00,9.8000,0.2000,566108665,1608626,Success,United Arab Emirates,DU UAE,Transguard Group LLC,API User,E6AEAE22430
2022-02-25 12:45,73077054,"9,397.4410","9,392.5410",05.00 AED,5.00,4.9000,0.1000,566109035,1608633,Success,United Arab Emirates,DU UAE,Transguard Group LLC,API User,E6AEAE17361
2022-02-25 12:46,73077090,"9,392.5410","9,387.6410",05.00 AED,5.00,4.9000,0.1000,566109146,1608640,Success,United Arab Emirates,DU UAE,Transguard Group LLC,API User,E6AEAE17361
2022-02-25 12:47,73077112,"9,387.6410","9,377.8410",10.00 AED,10.00,9.8000,0.2000,566109238,1608644,Success,United Arab Emirates,DU UAE,Transguard Group LLC,API User,E6AEAE22430
2022-02-25 12:48,73077131,"9,377.8410","9,368.0410",10.00 AED,10.00,9.8000,0.2000,566109295,1608648,Success,United Arab Emirates,DU UAE,Transguard Group LLC,API User,E6AEAE22430
2022-02-25 12:48,73077137,"9,368.0410","9,362.1010",100.00 INR,6.75,5.9400,0.8100,566109316,1608652,Success,India,Vi India,Transguard Group LLC,API User,VFININ43046
2022-02-25 12:48,73077142,"9,362.1010","9,327.8010",35.00 AED,35.00,34.3000,0.7000,566109329,1608653,Success,United Arab Emirates,DU UAE,Transguard Group LLC,API User,E6AEAE73954
2022-02-25 12:52,73077251,"9,327.8010","9,322.9010",05.00 AED,5.00,4.9000,0.1000,566109656,1608661,Success,United Arab Emirates,DU UAE,Transguard Group LLC,API User,E6AEAE17361
2022-02-25 12:53,73077279,"9,322.9010","9,318.0010",05.00 AED,5.00,4.9000,0.1000,566109732,1608667,Success,United Arab Emirates,DU UAE,Transguard Group LLC,API User,E6AEAE17361
2022-02-25 12:54,73077316,"9,318.0010","9,298.4010",20.00 AED,20.00,19.6000,0.4000,566109812,1608673,Success,United Arab Emirates,DU UAE,Transguard Group LLC,API User,E6AEAE12938
2022-02-25 12:55,73077344,"9,298.4010","9,278.8010",20.00 AED,20.00,19.6000,0.4000,566109896,1608677,Success,United Arab Emirates,DU UAE,Transguard Group LLC,API User,E6AEAE12938
2022-02-25 13:05,73077634,"9,278.8010","9,273.9010",05.00 AED,5.00,4.9000,0.1000,566110699,1608688,Success,United Arab Emirates,DU UAE,Transguard Group LLC,API User,E6AEAE17361
2022-02-25 13:15,73077885,"9,273.9010","9,269.0010",05.00 AED,5.00,4.9000,0.1000,566111459,1608695,Success,United Arab Emirates,DU UAE,Transguard Group LLC,API User,E6AEAE17361
2022-02-25 13:20,73078032,"9,269.0010","9,264.1010",05.00 AED,5.00,4.9000,0.1000,566111869,1608700,Success,United Arab Emirates,DU UAE,Transguard Group LLC,API User,E6AEAE17361
2022-02-25 13:21,73078058,"9,264.1010","9,259.2010",05.00 AED,5.00,4.9000,0.1000,566111931,1608706,Success,United Arab Emirates,DU UAE,Transguard Group LLC,API User,E6AEAE17361
2022-02-25 13:23,73078140,"9,259.2010","9,249.4010",10.00 AED,10.00,9.8000,0.2000,566112129,1608709,Success,United Arab Emirates,DU UAE,Transguard Group LLC,API User,E6AEAE22430
2022-02-25 13:38,73078576,"9,249.4010","9,244.5010",05.00 AED,5.00,4.9000,0.1000,566113329,1608728,Success,United Arab Emirates,DU UAE,Transguard Group LLC,API User,E6AEAE17361
2022-02-25 13:38,73078597,"9,244.5010","9,234.7010",10.00 AED,10.00,9.8000,0.2000,566113403,1608735,Success,United Arab Emirates,DU UAE,Transguard Group LLC,API User,E6AEAE22430
2022-02-25 13:39,73078624,"9,234.7010","9,229.8010",05.00 AED,5.00,4.9000,0.1000,566113467,1608738,Success,United Arab Emirates,DU UAE,Transguard Group LLC,API User,E6AEAE17361
2022-02-25 13:44,73078800,"9,229.8010","9,224.9010",05.00 AED,5.00,4.9000,0.1000,566113959,1608742,Success,United Arab Emirates,DU UAE,Transguard Group LLC,API User,E6AEAE17361
2022-02-25 13:57,73079380,"9,224.9010","9,220.0010",05.00 AED,5.00,4.9000,0.1000,566115446,1608751,Success,United Arab Emirates,DU UAE,Transguard Group LLC,API User,E6AEAE17361
2022-02-25 13:58,73079431,"9,220.0010","9,215.1010",05.00 AED,5.00,4.9000,0.1000,566115552,1608754,Success,United Arab Emirates,DU UAE,Transguard Group LLC,API User,E6AEAE17361
2022-02-25 14:05,73079670,"9,215.1010","9,210.2010",05.00 AED,5.00,4.9000,0.1000,566116295,1608770,Success,United Arab Emirates,DU UAE,Transguard Group LLC,API User,E6AEAE17361
2022-02-25 14:05,73079689,"9,210.2010","9,200.4010",10.00 AED,10.00,9.8000,0.2000,566116357,1608773,Success,United Arab Emirates,DU UAE,Transguard Group LLC,API User,E6AEAE22430
2022-02-25 14:21,73080345,"9,200.4010","9,180.8010",20.00 AED,20.00,19.6000,0.4000,566118324,1608786,Success,United Arab Emirates,DU UAE,Transguard Group LLC,API User,E6AEAE12938
2022-02-25 14:25,73080511,"9,180.8010","9,141.6010",40.00 AED,40.00,39.2000,0.8000,566118828,1608790,Success,United Arab Emirates,DU UAE,Transguard Group LLC,API User,E6AEAE64011
2022-02-25 14:28,73080604,"9,141.6010","9,131.8010",10.00 AED,10.00,9.8000,0.2000,566119090,1608795,Success,United Arab Emirates,DU UAE,Transguard Group LLC,API User,E6AEAE22430
2022-02-25 14:29,73080663,"9,131.8010","9,126.9010",05.00 AED,5.00,4.9000,0.1000,566119287,1608798,Success,United Arab Emirates,DU UAE,Transguard Group LLC,API User,E6AEAE17361
2022-02-25 14:32,73080769,"9,126.9010","9,122.0010",05.00 AED,5.00,4.9000,0.1000,566119659,1608801,Success,United Arab Emirates,DU UAE,Transguard Group LLC,API User,E6AEAE17361
2022-02-25 14:35,73080879,"9,122.0010","9,077.9010",45.00 AED,45.00,44.1000,0.9000,566120011,1608804,Success,United Arab Emirates,DU UAE,Transguard Group LLC,API User,E6AEAE35243
2022-02-25 14:36,73080901,"9,077.9010","9,073.0010",05.00 AED,5.00,4.9000,0.1000,566120093,1608807,Success,United Arab Emirates,DU UAE,Transguard Group LLC,API User,E6AEAE17361
2022-02-25 14:37,73080933,"9,073.0010","9,068.1010",05.00 AED,5.00,4.9000,0.1000,566120200,1608810,Success,United Arab Emirates,DU UAE,Transguard Group LLC,API User,E6AEAE17361
2022-02-25 14:40,73081086,"9,068.1010","9,064.3610",100.00 NPR,4.25,3.7400,0.5100,566120646,1608819,Success,Nepal,Nepal Telecom Nepal,Transguard Group LLC,API User,NP_NE_TopUp_100.00
2022-02-25 14:43,73081160,"9,064.3610","9,059.4610",05.00 AED,5.00,4.9000,0.1000,566120911,1608823,Success,United Arab Emirates,DU UAE,Transguard Group LLC,API User,E6AEAE17361
2022-02-25 14:43,73081178,"9,059.4610","9,042.5210",470.00 NPR,19.25,16.9400,2.3100,566120974,1608825,Success,Nepal,Ncell Nepal,Transguard Group LLC,API User,NCNPNP37643
2022-02-25 14:45,73081250,"9,042.5210","9,022.9210",20.00 AED,20.00,19.6000,0.4000,566121200,1608837,Success,United Arab Emirates,DU UAE,Transguard Group LLC,API User,E6AEAE12938
2022-02-25 14:48,73081354,"9,022.9210","9,014.1210",315.00 PKR,10.00,8.8000,1.2000,566121564,1608843,Success,Pakistan,Telenor Pakistan,Transguard Group LLC,API User,TPPKPK75105
2022-02-25 14:53,73081546,"9,014.1210","9,004.3210",10.00 AED,10.00,9.8000,0.2000,566122155,1608850,Success,United Arab Emirates,DU UAE,Transguard Group LLC,API User,E6AEAE22430
2022-02-25 14:54,73081600,"9,004.3210","8,995.9610",100.00 PHP,9.50,8.3600,1.1400,566122323,1608855,Success,Philippines,Smart (SunCellular) Philippines,Transguard Group LLC,API User,PH_SM_TopUp_100.00
2022-02-25 14:55,73081604,"8,995.9610","8,991.0610",05.00 AED,5.00,4.9000,0.1000,566122346,1608856,Success,United Arab Emirates,DU UAE,Transguard Group LLC,API User,E6AEAE17361
2022-02-25 14:59,73081781,"8,991.0610","8,986.8810",50.00 PHP,4.75,4.1800,0.5700,566122849,1608859,Success,Philippines,Smart (SunCellular) Philippines,Transguard Group LLC,API User,PH_SM_TopUp_50.00
2022-02-25 15:04,73081998,"8,986.8810","8,981.9810",05.00 AED,5.00,4.9000,0.1000,566123520,1608864,Success,United Arab Emirates,DU UAE,Transguard Group LLC,API User,E6AEAE17361
2022-02-25 15:16,73082511,"38,432.4510","38,427.5510",05.00 AED,5.00,4.9000,0.1000,566125083,1608875,Success,United Arab Emirates,DU UAE,Transguard Group LLC,API User,E6AEAE17361
2022-02-25 15:18,73082590,"38,417.7510","38,409.6110",300.00 PKR,9.25,8.1400,1.1100,566125338,1608883,Success,Pakistan,Zong Pakistan,Transguard Group LLC,API User,ZNPKPK70504
2022-02-25 15:18,73082593,"38,427.5510","38,417.7510",10.00 AED,10.00,9.8000,0.2000,566125333,1608882,Success,United Arab Emirates,DU UAE,Transguard Group LLC,API User,E6AEAE22430
2022-02-25 15:19,73082645,"38,409.6110","38,401.4710",300.00 PKR,9.25,8.1400,1.1100,566125489,1608886,Success,Pakistan,Zong Pakistan,Transguard Group LLC,API User,ZNPKPK70504
2022-02-25 15:23,73082802,"38,401.4710","38,396.5710",05.00 AED,5.00,4.9000,0.1000,566125936,1608893,Success,United Arab Emirates,DU UAE,Transguard Group LLC,API User,E6AEAE17361
2022-02-25 15:24,73082840,"38,396.5710","38,391.6710",05.00 AED,5.00,4.9000,0.1000,566126066,1608896,Success,United Arab Emirates,DU UAE,Transguard Group LLC,API User,E6AEAE17361
2022-02-25 15:25,73082878,"38,391.6710","38,386.7710",05.00 AED,5.00,4.9000,0.1000,566126187,1608899,Success,United Arab Emirates,DU UAE,Transguard Group LLC,API User,E6AEAE17361
2022-02-25 15:43,73083646,"38,386.7710","38,376.9710",10.00 AED,10.00,9.8000,0.2000,566128622,1608908,Success,United Arab Emirates,DU UAE,Transguard Group LLC,API User,E6AEAE22430
2022-02-25 15:44,73083676,"38,376.9710","38,372.0710",05.00 AED,5.00,4.9000,0.1000,566128719,1608911,Success,United Arab Emirates,DU UAE,Transguard Group LLC,API User,E6AEAE17361
2022-02-25 15:45,73083720,"38,372.0710","38,368.3310",100.00 NPR,4.25,3.7400,0.5100,566128855,1608914,Success,Nepal,Nepal Telecom Nepal,Transguard Group LLC,API User,NP_NE_TopUp_100.00
2022-02-25 15:46,73083772,"38,368.3310","38,364.5910",100.00 NPR,4.25,3.7400,0.5100,566128989,1608917,Success,Nepal,Ncell Nepal,Transguard Group LLC,API User,NP_NC_TopUp_100.00
2022-02-25 15:47,73083812,"38,364.5910","38,360.8510",100.00 NPR,4.25,3.7400,0.5100,566129125,1608920,Success,Nepal,Nepal Telecom Nepal,Transguard Group LLC,API User,NP_NE_TopUp_100.00
2022-02-25 15:51,73083976,"38,360.8510","38,355.9510",05.00 AED,5.00,4.9000,0.1000,566129677,1608925,Success,United Arab Emirates,DU UAE,Transguard Group LLC,API User,E6AEAE17361
2022-02-25 15:53,73084031,"38,355.9510","38,351.0510",05.00 AED,5.00,4.9000,0.1000,566129849,1608928,Success,United Arab Emirates,DU UAE,Transguard Group LLC,API User,E6AEAE17361
2022-02-25 15:56,73084131,"38,351.0510","38,341.2510",10.00 AED,10.00,9.8000,0.2000,566130143,1608931,Success,United Arab Emirates,DU UAE,Transguard Group LLC,API User,E6AEAE22430
2022-02-25 16:13,73084824,"38,341.2510","38,336.3510",05.00 AED,5.00,4.9000,0.1000,566132456,1608955,Success,United Arab Emirates,DU UAE,Transguard Group LLC,API User,E6AEAE17361
2022-02-25 16:17,73084972,"38,336.3510","38,332.6110",100.00 NPR,4.25,3.7400,0.5100,566133042,1608962,Success,Nepal,Nepal Telecom Nepal,Transguard Group LLC,API User,NP_NE_TopUp_100.00
2022-02-25 16:26,73085340,"38,332.6110","38,327.7110",05.00 AED,5.00,4.9000,0.1000,566134216,1608967,Success,United Arab Emirates,DU UAE,Transguard Group LLC,API User,E6AEAE17361
2022-02-25 16:33,73085664,"38,327.7110","38,322.8110",05.00 AED,5.00,4.9000,0.1000,566135171,1608974,Success,United Arab Emirates,DU UAE,Transguard Group LLC,API User,E6AEAE17361
2022-02-25 16:38,73085887,"38,322.8110","38,317.9110",05.00 AED,5.00,4.9000,0.1000,566135891,1608984,Success,United Arab Emirates,DU UAE,Transguard Group LLC,API User,E6AEAE17361
2022-02-25 16:40,73085996,"38,317.9110","38,313.0110",05.00 AED,5.00,4.9000,0.1000,566136247,1608986,Success,United Arab Emirates,DU UAE,Transguard Group LLC,API User,E6AEAE17361
2022-02-25 16:44,73086182,"38,313.0110","38,308.1110",05.00 AED,5.00,4.9000,0.1000,566136838,1608991,Success,United Arab Emirates,DU UAE,Transguard Group LLC,API User,E6AEAE17361
2022-02-25 16:49,73086358,"38,308.1110","38,298.3110",10.00 AED,10.00,9.8000,0.2000,566137459,1608998,Success,United Arab Emirates,DU UAE,Transguard Group LLC,API User,E6AEAE22430
2022-02-25 16:51,73086516,"38,298.3110","38,293.4110",05.00 AED,5.00,4.9000,0.1000,566137868,1609007,Success,United Arab Emirates,DU UAE,Transguard Group LLC,API User,E6AEAE17361
2022-02-25 16:51,73086521,"38,293.4110","38,283.6110",10.00 AED,10.00,9.8000,0.2000,566137890,1609008,Success,United Arab Emirates,DU UAE,Transguard Group LLC,API User,E6AEAE22430
2022-02-25 16:53,73086606,"38,283.6110","38,278.7110",05.00 AED,5.00,4.9000,0.1000,566138159,1609011,Success,United Arab Emirates,DU UAE,Transguard Group LLC,API User,E6AEAE17361
2022-02-25 17:03,73087040,"38,278.7110","38,273.8110",05.00 AED,5.00,4.9000,0.1000,566139588,1609024,Success,United Arab Emirates,DU UAE,Transguard Group LLC,API User,E6AEAE17361
2022-02-25 17:03,73087048,"38,273.8110","38,254.2110",20.00 AED,20.00,19.6000,0.4000,566139619,1609025,Success,United Arab Emirates,DU UAE,Transguard Group LLC,API User,E6AEAE12938
2022-02-25 17:06,73087201,"38,254.2110","38,249.3110",05.00 AED,5.00,4.9000,0.1000,566140148,1609033,Success,United Arab Emirates,DU UAE,Transguard Group LLC,API User,E6AEAE17361
2022-02-25 17:08,73087285,"38,249.3110","38,239.5110",10.00 AED,10.00,9.8000,0.2000,566140409,1609037,Success,United Arab Emirates,DU UAE,Transguard Group LLC,API User,E6AEAE22430
2022-02-25 17:09,73087354,"38,239.5110","38,234.6110",05.00 AED,5.00,4.9000,0.1000,566140636,1609040,Success,United Arab Emirates,DU UAE,Transguard Group LLC,API User,E6AEAE17361
2022-02-25 17:15,73087606,"38,234.6110","38,229.7110",05.00 AED,5.00,4.9000,0.1000,566141514,1609045,Success,United Arab Emirates,DU UAE,Transguard Group LLC,API User,E6AEAE17361
2022-02-25 17:24,73088080,"38,229.7110","38,224.8110",05.00 AED,5.00,4.9000,0.1000,566143011,1609063,Success,United Arab Emirates,DU UAE,Transguard Group LLC,API User,E6AEAE17361
2022-02-25 17:25,73088085,"38,224.8110","38,215.0110",10.00 AED,10.00,9.8000,0.2000,566143024,1609064,Success,United Arab Emirates,DU UAE,Transguard Group LLC,API User,E6AEAE22430
2022-02-25 17:26,73088146,"38,215.0110","38,210.1110",05.00 AED,5.00,4.9000,0.1000,566143222,1609069,Success,United Arab Emirates,DU UAE,Transguard Group LLC,API User,E6AEAE17361
2022-02-25 17:26,73088163,"38,210.1110","38,205.2110",05.00 AED,5.00,4.9000,0.1000,566143284,1609073,Success,United Arab Emirates,DU UAE,Transguard Group LLC,API User,E6AEAE17361
2022-02-25 17:27,73088198,"38,205.2110","38,200.3110",05.00 AED,5.00,4.9000,0.1000,566143389,1609076,Success,United Arab Emirates,DU UAE,Transguard Group LLC,API User,E6AEAE17361
2022-02-25 17:31,73088399,"38,200.3110","38,190.5110",10.00 AED,10.00,9.8000,0.2000,566144036,1609086,Success,United Arab Emirates,DU UAE,Transguard Group LLC,API User,E6AEAE22430
2022-02-25 17:31,73088426,"38,190.5110","38,185.6110",05.00 AED,5.00,4.9000,0.1000,566144115,1609091,Success,United Arab Emirates,DU UAE,Transguard Group LLC,API User,E6AEAE17361
2022-02-25 17:33,73088574,"38,185.6110","38,180.7110",05.00 AED,5.00,4.9000,0.1000,566144560,1609102,Success,United Arab Emirates,DU UAE,Transguard Group LLC,API User,E6AEAE17361
2022-02-25 17:34,73088621,"38,180.7110","38,175.8110",05.00 AED,5.00,4.9000,0.1000,566144721,1609107,Success,United Arab Emirates,DU UAE,Transguard Group LLC,API User,E6AEAE17361
2022-02-25 17:38,73088825,"38,175.8110","38,166.0110",10.00 AED,10.00,9.8000,0.2000,566145406,1609118,Success,United Arab Emirates,DU UAE,Transguard Group LLC,API User,E6AEAE22430
2022-02-25 17:43,73089068,"38,166.0110","38,161.1110",05.00 AED,5.00,4.9000,0.1000,566146148,1609125,Success,United Arab Emirates,DU UAE,Transguard Group LLC,API User,E6AEAE17361
2022-02-25 17:46,73089224,"38,161.1110","38,151.3110",10.00 AED,10.00,9.8000,0.2000,566146570,1609130,Success,United Arab Emirates,DU UAE,Transguard Group LLC,API User,E6AEAE22430
2022-02-25 17:47,73089302,"38,151.3110","38,112.1110",40.00 AED,40.00,39.2000,0.8000,566146842,1609137,Success,United Arab Emirates,DU UAE,Transguard Group LLC,API User,E6AEAE64011
2022-02-25 17:47,73089328,"38,112.1110","38,103.5310",315.00 PKR,9.75,8.5800,1.1700,566146919,1609141,Success,Pakistan,Zong Pakistan,Transguard Group LLC,API User,ZNPKPK29953
2022-02-25 17:48,73089337,"38,103.5310","38,088.8310",15.00 AED,15.00,14.7000,0.3000,566146956,1609143,Success,United Arab Emirates,DU UAE,Transguard Group LLC,API User,E6AEAE8527
2022-02-25 17:50,73089444,"38,088.8310","38,074.1310",15.00 AED,15.00,14.7000,0.3000,566147355,1609150,Success,United Arab Emirates,DU UAE,Transguard Group LLC,API User,E6AEAE8527
2022-02-25 17:55,73089759,"38,074.1310","38,070.3910",100.00 NPR,4.25,3.7400,0.5100,566148244,1609155,Success,Nepal,Ncell Nepal,Transguard Group LLC,API User,NP_NC_TopUp_100.00
2022-02-25 17:56,73089836,"38,070.3910","38,065.4910",05.00 AED,5.00,4.9000,0.1000,566148461,1609158,Success,United Arab Emirates,DU UAE,Transguard Group LLC,API User,E6AEAE17361
2022-02-25 17:57,73089920,"38,065.4910","38,060.5910",05.00 AED,5.00,4.9000,0.1000,566148689,1609161,Success,United Arab Emirates,DU UAE,Transguard Group LLC,API User,E6AEAE17361
2022-02-25 17:58,73089992,"38,060.5910","38,050.7910",10.00 AED,10.00,9.8000,0.2000,566148884,1609164,Success,United Arab Emirates,DU UAE,Transguard Group LLC,API User,E6AEAE22430
2022-02-25 18:00,73090111,"38,050.7910","38,045.8910",05.00 AED,5.00,4.9000,0.1000,566149262,1609168,Success,United Arab Emirates,DU UAE,Transguard Group LLC,API User,E6AEAE17361
2022-02-25 18:04,73090341,"38,045.8910","38,040.9910",05.00 AED,5.00,4.9000,0.1000,566149970,1609179,Success,United Arab Emirates,DU UAE,Transguard Group LLC,API User,E6AEAE17361
2022-02-25 18:05,73090347,"38,040.9910","38,021.3910",20.00 AED,20.00,19.6000,0.4000,566149988,1609180,Success,United Arab Emirates,DU UAE,Transguard Group LLC,API User,E6AEAE12938
2022-02-25 18:06,73090456,"38,021.3910","38,011.5910",10.00 AED,10.00,9.8000,0.2000,566150314,1609185,Success,United Arab Emirates,DU UAE,Transguard Group LLC,API User,E6AEAE22430
2022-02-25 18:14,73090926,"38,011.5910","38,007.8510",100.00 NPR,4.25,3.7400,0.5100,566151791,1609198,Success,Nepal,Ncell Nepal,Transguard Group LLC,API User,NP_NC_TopUp_100.00
2022-02-25 18:17,73091085,"38,007.8510","37,998.0510",10.00 AED,10.00,9.8000,0.2000,566152268,1609208,Success,United Arab Emirates,DU UAE,Transguard Group LLC,API User,E6AEAE22430
2022-02-25 18:18,73091186,"37,998.0510","37,993.1510",05.00 AED,5.00,4.9000,0.1000,566152576,1609213,Success,United Arab Emirates,DU UAE,Transguard Group LLC,API User,E6AEAE17361
2022-02-25 18:20,73091275,"37,993.1510","37,983.3510",10.00 AED,10.00,9.8000,0.2000,566152912,1609219,Success,United Arab Emirates,DU UAE,Transguard Group LLC,API User,E6AEAE22430
2022-02-25 18:20,73091287,"37,983.3510","37,978.4510",05.00 AED,5.00,4.9000,0.1000,566152948,1609222,Success,United Arab Emirates,DU UAE,Transguard Group LLC,API User,E6AEAE17361
2022-02-25 18:21,73091318,"37,978.4510","37,973.5510",05.00 AED,5.00,4.9000,0.1000,566153061,1609225,Success,United Arab Emirates,DU UAE,Transguard Group LLC,API User,E6AEAE17361
2022-02-25 18:24,73091476,"37,973.5510","37,968.6510",05.00 AED,5.00,4.9000,0.1000,566153580,1609229,Success,United Arab Emirates,DU UAE,Transguard Group LLC,API User,E6AEAE17361
2022-02-25 18:25,73091534,"37,968.6510","37,963.7510",05.00 AED,5.00,4.9000,0.1000,566153772,1609232,Success,United Arab Emirates,DU UAE,Transguard Group LLC,API User,E6AEAE17361
2022-02-25 18:26,73091620,"37,963.7510","37,953.9510",10.00 AED,10.00,9.8000,0.2000,566154059,1609237,Success,United Arab Emirates,DU UAE,Transguard Group LLC,API User,E6AEAE22430
2022-02-25 18:26,73091639,"37,953.9510","37,944.1510",10.00 AED,10.00,9.8000,0.2000,566154118,1609239,Success,United Arab Emirates,DU UAE,Transguard Group LLC,API User,E6AEAE22430
2022-02-25 18:32,73092003,"37,944.1510","37,939.2510",05.00 AED,5.00,4.9000,0.1000,566155223,1609252,Success,United Arab Emirates,DU UAE,Transguard Group LLC,API User,E6AEAE17361
2022-02-25 18:33,73092076,"37,939.2510","37,931.3310",220.00 NPR,9.00,7.9200,1.0800,566155440,1609257,Success,Nepal,Ncell Nepal,Transguard Group LLC,API User,NCNPNP79518
2022-02-25 18:35,73092179,"37,931.3310","37,921.5310",10.00 AED,10.00,9.8000,0.2000,566155771,1609260,Success,United Arab Emirates,DU UAE,Transguard Group LLC,API User,E6AEAE22430
2022-02-25 18:39,73092420,"37,921.5310","37,916.6310",05.00 AED,5.00,4.9000,0.1000,566156511,1609269,Success,United Arab Emirates,DU UAE,Transguard Group LLC,API User,E6AEAE17361
2022-02-25 18:39,73092421,"37,916.6310","37,906.8310",10.00 AED,10.00,9.8000,0.2000,566156521,1609270,Success,United Arab Emirates,DU UAE,Transguard Group LLC,API User,E6AEAE22430
2022-02-25 18:40,73092470,"37,906.8310","37,901.9310",05.00 AED,5.00,4.9000,0.1000,566156646,1609275,Success,United Arab Emirates,DU UAE,Transguard Group LLC,API User,E6AEAE17361
2022-02-25 18:43,73092672,"37,901.9310","37,892.1310",10.00 AED,10.00,9.8000,0.2000,566157294,1609283,Success,United Arab Emirates,DU UAE,Transguard Group LLC,API User,E6AEAE22430
2022-02-25 18:46,73092861,"37,892.1310","37,872.5310",20.00 AED,20.00,19.6000,0.4000,566157910,1609286,Success,United Arab Emirates,DU UAE,Transguard Group LLC,API User,E6AEAE12938
2022-02-25 18:47,73092890,"37,872.5310","37,862.7310",10.00 AED,10.00,9.8000,0.2000,566158006,1609290,Success,United Arab Emirates,DU UAE,Transguard Group LLC,API User,E6AEAE22430
2022-02-25 18:49,73093062,"37,862.7310","37,843.1310",20.00 AED,20.00,19.6000,0.4000,566158557,1609295,Success,United Arab Emirates,DU UAE,Transguard Group LLC,API User,E6AEAE12938
2022-02-25 18:50,73093078,"37,843.1310","37,839.3910",102.00 NPR,4.25,3.7400,0.5100,566158612,1609297,Success,Nepal,Nepal Telecom Nepal,Transguard Group LLC,API User,NENPNP19715
2022-02-25 18:53,73093300,"37,839.3910","37,819.7910",20.00 AED,20.00,19.6000,0.4000,566159319,1609306,Success,United Arab Emirates,DU UAE,Transguard Group LLC,API User,E6AEAE12938
2022-02-25 19:00,73093801,"37,819.7910","37,814.8910",05.00 AED,5.00,4.9000,0.1000,566160786,1609320,Success,United Arab Emirates,DU UAE,Transguard Group LLC,API User,E6AEAE17361
2022-02-25 19:02,73093920,"37,814.8910","37,809.9910",05.00 AED,5.00,4.9000,0.1000,566161097,1609327,Success,United Arab Emirates,DU UAE,Transguard Group LLC,API User,E6AEAE17361
2022-02-25 19:06,73094209,"37,809.9910","37,805.0910",05.00 AED,5.00,4.9000,0.1000,566161962,1609337,Success,United Arab Emirates,DU UAE,Transguard Group LLC,API User,E6AEAE17361
2022-02-25 19:09,73094403,"37,805.0910","37,760.9910",45.00 AED,45.00,44.1000,0.9000,566162550,1609352,Success,United Arab Emirates,DU UAE,Transguard Group LLC,API User,E6AEAE35243
2022-02-25 19:10,73094421,"37,760.9910","37,751.1910",10.00 AED,10.00,9.8000,0.2000,566162638,1609357,Success,United Arab Emirates,DU UAE,Transguard Group LLC,API User,E6AEAE22430
2022-02-25 19:10,73094447,"37,751.1910","37,746.2910",05.00 AED,5.00,4.9000,0.1000,566162721,1609363,Success,United Arab Emirates,DU UAE,Transguard Group LLC,API User,E6AEAE17361
2022-02-25 19:10,73094455,"37,746.2910","37,726.6910",20.00 AED,20.00,19.6000,0.4000,566162743,1609364,Success,United Arab Emirates,DU UAE,Transguard Group LLC,API User,E6AEAE12938
2022-02-25 19:11,73094512,"37,726.6910","37,716.8910",10.00 AED,10.00,9.8000,0.2000,566162921,1609368,Success,United Arab Emirates,DU UAE,Transguard Group LLC,API User,E6AEAE22430
2022-02-25 19:13,73094640,"37,716.8910","37,697.2910",20.00 AED,20.00,19.6000,0.4000,566163320,1609376,Success,United Arab Emirates,DU UAE,Transguard Group LLC,API User,E6AEAE12938
2022-02-25 19:13,73094670,"37,697.2910","37,692.3910",05.00 AED,5.00,4.9000,0.1000,566163391,1609381,Success,United Arab Emirates,DU UAE,Transguard Group LLC,API User,E6AEAE17361
2022-02-25 19:14,73094752,"37,692.3910","37,687.4910",05.00 AED,5.00,4.9000,0.1000,566163644,1609388,Success,United Arab Emirates,DU UAE,Transguard Group LLC,API User,E6AEAE17361
2022-02-25 19:18,73094982,"37,687.4910","37,682.5910",05.00 AED,5.00,4.9000,0.1000,566164326,1609399,Success,United Arab Emirates,DU UAE,Transguard Group LLC,API User,E6AEAE17361
2022-02-25 19:21,73095199,"37,682.5910","37,672.7910",10.00 AED,10.00,9.8000,0.2000,566164916,1609404,Success,United Arab Emirates,DU UAE,Transguard Group LLC,API User,E6AEAE22430
2022-02-25 19:21,73095225,"37,672.7910","37,667.8910",05.00 AED,5.00,4.9000,0.1000,566164990,1609408,Success,United Arab Emirates,DU UAE,Transguard Group LLC,API User,E6AEAE17361
2022-02-25 19:22,73095304,"37,667.8910","37,662.9910",05.00 AED,5.00,4.9000,0.1000,566165250,1609418,Success,United Arab Emirates,DU UAE,Transguard Group LLC,API User,E6AEAE17361
2022-02-25 19:25,73095499,"37,662.9910","37,653.1910",10.00 AED,10.00,9.8000,0.2000,566165785,1609432,Success,United Arab Emirates,DU UAE,Transguard Group LLC,API User,E6AEAE22430
2022-02-25 19:26,73095577,"37,653.1910","37,643.3910",10.00 AED,10.00,9.8000,0.2000,566165991,1609436,Success,United Arab Emirates,DU UAE,Transguard Group LLC,API User,E6AEAE22430
2022-02-25 19:27,73095672,"37,643.3910","37,633.5910",10.00 AED,10.00,9.8000,0.2000,566166284,1609444,Success,United Arab Emirates,DU UAE,Transguard Group LLC,API User,E6AEAE22430
2022-02-25 19:30,73095890,"37,633.5910","37,628.6910",05.00 AED,5.00,4.9000,0.1000,566166975,1609451,Success,United Arab Emirates,DU UAE,Transguard Group LLC,API User,E6AEAE17361
2022-02-25 19:33,73096048,"37,628.6910","37,623.7910",05.00 AED,5.00,4.9000,0.1000,566167447,1609457,Success,United Arab Emirates,DU UAE,Transguard Group LLC,API User,E6AEAE17361
2022-02-25 19:34,73096166,"37,623.7910","37,613.9910",10.00 AED,10.00,9.8000,0.2000,566167852,1609464,Success,United Arab Emirates,DU UAE,Transguard Group LLC,API User,E6AEAE22430
2022-02-25 19:35,73096197,"37,613.9910","37,609.0910",05.00 AED,5.00,4.9000,0.1000,566167943,1609470,Success,United Arab Emirates,DU UAE,Transguard Group LLC,API User,E6AEAE17361
2022-02-25 19:35,73096206,"37,609.0910","37,599.2910",10.00 AED,10.00,9.8000,0.2000,566167973,1609471,Success,United Arab Emirates,DU UAE,Transguard Group LLC,API User,E6AEAE22430
2022-02-25 19:35,73096230,"37,599.2910","37,594.3910",05.00 AED,5.00,4.9000,0.1000,566168053,1609474,Success,United Arab Emirates,DU UAE,Transguard Group LLC,API User,E6AEAE17361
2022-02-25 19:37,73096321,"37,594.3910","37,589.4910",05.00 AED,5.00,4.9000,0.1000,566168373,1609481,Success,United Arab Emirates,DU UAE,Transguard Group LLC,API User,E6AEAE17361
2022-02-25 19:37,73096323,"37,589.4910","37,583.5510",100.00 INR,6.75,5.9400,0.8100,566168399,1609482,Success,India,Airtel India,Transguard Group LLC,API User,AIININ36410
2022-02-25 19:42,73096632,"37,583.5510","37,573.7510",10.00 AED,10.00,9.8000,0.2000,566169351,1609488,Success,United Arab Emirates,DU UAE,Transguard Group LLC,API User,E6AEAE22430
2022-02-25 19:43,73096734,"37,573.7510","37,559.2310",399.00 NPR,16.50,14.5200,1.9800,566169653,1609493,Success,Nepal,Ncell Nepal,Transguard Group LLC,API User,NCNPNP63507
2022-02-25 19:44,73096776,"37,559.2310","37,546.2510",219.00 INR,14.75,12.9800,1.7700,566169773,1609499,Success,India,Vi India,Transguard Group LLC,API User,VFININ40021
2022-02-25 19:47,73096980,"37,546.2510","37,541.3510",05.00 AED,5.00,4.9000,0.1000,566170397,1609513,Success,United Arab Emirates,DU UAE,Transguard Group LLC,API User,E6AEAE17361
2022-02-25 19:47,73096994,"37,541.3510","37,525.2910",575.00 PKR,18.25,16.0600,2.1900,566170445,1609516,Success,Pakistan,Telenor Pakistan,Transguard Group LLC,API User,TPPKPK7947
2022-02-25 19:50,73097194,"37,525.2910","37,520.3910",05.00 AED,5.00,4.9000,0.1000,566171090,1609529,Success,United Arab Emirates,DU UAE,Transguard Group LLC,API User,E6AEAE17361
2022-02-25 19:52,73097339,"37,520.3910","37,510.5910",10.00 AED,10.00,9.8000,0.2000,566171543,1609544,Success,United Arab Emirates,DU UAE,Transguard Group LLC,API User,E6AEAE22430
2022-02-25 19:52,73097344,"37,510.5910","37,505.6910",05.00 AED,5.00,4.9000,0.1000,566171552,1609545,Success,United Arab Emirates,DU UAE,Transguard Group LLC,API User,E6AEAE17361
2022-02-25 19:53,73097383,"37,505.6910","37,495.8910",10.00 AED,10.00,9.8000,0.2000,566171689,1609552,Success,United Arab Emirates,DU UAE,Transguard Group LLC,API User,E6AEAE22430
2022-02-25 19:53,73097385,"37,495.8910","37,490.9910",05.00 AED,5.00,4.9000,0.1000,566171709,1609553,Success,United Arab Emirates,DU UAE,Transguard Group LLC,API User,E6AEAE17361
2022-02-25 19:55,73097488,"37,490.9910","37,486.0910",05.00 AED,5.00,4.9000,0.1000,566172042,1609556,Success,United Arab Emirates,DU UAE,Transguard Group LLC,API User,E6AEAE17361
2022-02-25 19:56,73097564,"37,486.0910","37,476.2910",10.00 AED,10.00,9.8000,0.2000,566172274,1609559,Success,United Arab Emirates,DU UAE,Transguard Group LLC,API User,E6AEAE22430
2022-02-25 19:56,73097601,"37,476.2910","37,471.3910",05.00 AED,5.00,4.9000,0.1000,566172405,1609561,Success,United Arab Emirates,DU UAE,Transguard Group LLC,API User,E6AEAE17361
2022-02-25 19:57,73097648,"37,471.3910","37,466.4910",05.00 AED,5.00,4.9000,0.1000,566172514,1609564,Success,United Arab Emirates,DU UAE,Transguard Group LLC,API User,E6AEAE17361
2022-02-25 20:01,73097909,"37,466.4910","37,446.8910",20.00 AED,20.00,19.6000,0.4000,566173418,1609571,Success,United Arab Emirates,DU UAE,Transguard Group LLC,API User,E6AEAE12938
2022-02-25 20:04,73098069,"37,446.8910","37,437.0910",10.00 AED,10.00,9.8000,0.2000,566173919,1609580,Success,United Arab Emirates,DU UAE,Transguard Group LLC,API User,E6AEAE22430
2022-02-25 20:04,73098091,"37,437.0910","37,427.2910",10.00 AED,10.00,9.8000,0.2000,566173960,1609585,Success,United Arab Emirates,DU UAE,Transguard Group LLC,API User,E6AEAE22430
2022-02-25 20:04,73098111,"37,427.2910","37,422.3910",05.00 AED,5.00,4.9000,0.1000,566174024,1609588,Success,United Arab Emirates,DU UAE,Transguard Group LLC,API User,E6AEAE17361
2022-02-25 20:04,73098118,"37,422.3910","37,412.5910",10.00 AED,10.00,9.8000,0.2000,566174057,1609590,Success,United Arab Emirates,DU UAE,Transguard Group LLC,API User,E6AEAE22430
2022-02-25 20:05,73098130,"37,412.5910","37,397.8910",15.00 AED,15.00,14.7000,0.3000,566174078,1609591,Success,United Arab Emirates,DU UAE,Transguard Group LLC,API User,E6AEAE8527
2022-02-25 20:06,73098222,"37,397.8910","37,392.9910",05.00 AED,5.00,4.9000,0.1000,566174329,1609600,Success,United Arab Emirates,DU UAE,Transguard Group LLC,API User,E6AEAE17361
2022-02-25 20:06,73098242,"37,392.9910","37,388.0910",05.00 AED,5.00,4.9000,0.1000,566174386,1609603,Success,United Arab Emirates,DU UAE,Transguard Group LLC,API User,E6AEAE17361
2022-02-25 20:08,73098336,"37,388.0910","37,378.2910",10.00 AED,10.00,9.8000,0.2000,566174695,1609613,Success,United Arab Emirates,DU UAE,Transguard Group LLC,API User,E6AEAE22430
2022-02-25 20:10,73098451,"37,378.2910","37,368.4910",10.00 AED,10.00,9.8000,0.2000,566175108,1609619,Success,United Arab Emirates,DU UAE,Transguard Group LLC,API User,E6AEAE22430
2022-02-25 20:12,73098605,"37,368.4910","37,363.5910",05.00 AED,5.00,4.9000,0.1000,566175560,1609628,Success,United Arab Emirates,DU UAE,Transguard Group LLC,API User,E6AEAE17361
2022-02-25 20:12,73098618,"37,363.5910","37,358.6910",05.00 AED,5.00,4.9000,0.1000,566175605,1609630,Success,United Arab Emirates,DU UAE,Transguard Group LLC,API User,E6AEAE17361
2022-02-25 20:13,73098649,"37,358.6910","37,348.8910",10.00 AED,10.00,9.8000,0.2000,566175709,1609633,Success,United Arab Emirates,DU UAE,Transguard Group LLC,API User,E6AEAE22430
2022-02-25 20:15,73098756,"37,348.8910","37,339.0910",10.00 AED,10.00,9.8000,0.2000,566176111,1609640,Success,United Arab Emirates,DU UAE,Transguard Group LLC,API User,E6AEAE22430
2022-02-25 20:15,73098765,"37,339.0910","37,334.1910",05.00 AED,5.00,4.9000,0.1000,566176149,1609643,Success,United Arab Emirates,DU UAE,Transguard Group LLC,API User,E6AEAE17361
2022-02-25 20:16,73098851,"37,334.1910","37,329.2910",05.00 AED,5.00,4.9000,0.1000,566176450,1609651,Success,United Arab Emirates,DU UAE,Transguard Group LLC,API User,E6AEAE17361
2022-02-25 20:21,73099155,"37,329.2910","37,324.3910",05.00 AED,5.00,4.9000,0.1000,566177405,1609659,Success,United Arab Emirates,DU UAE,Transguard Group LLC,API User,E6AEAE17361
2022-02-25 20:25,73099436,"37,324.3910","37,319.4910",05.00 AED,5.00,4.9000,0.1000,566178330,1609669,Success,United Arab Emirates,DU UAE,Transguard Group LLC,API User,E6AEAE17361
2022-02-25 20:28,73099578,"37,319.4910","37,299.8910",20.00 AED,20.00,19.6000,0.4000,566178784,1609676,Success,United Arab Emirates,DU UAE,Transguard Group LLC,API User,E6AEAE12938
2022-02-25 20:29,73099634,"37,299.8910","37,294.9910",05.00 AED,5.00,4.9000,0.1000,566178994,1609681,Success,United Arab Emirates,DU UAE,Transguard Group LLC,API User,E6AEAE17361
2022-02-25 20:29,73099639,"37,294.9910","37,290.0910",05.00 AED,5.00,4.9000,0.1000,566179008,1609682,Success,United Arab Emirates,DU UAE,Transguard Group LLC,API User,E6AEAE17361
2022-02-25 20:30,73099735,"37,290.0910","37,280.2910",10.00 AED,10.00,9.8000,0.2000,566179353,1609687,Success,United Arab Emirates,DU UAE,Transguard Group LLC,API User,E6AEAE22430
2022-02-25 20:33,73099926,"37,280.2910","37,275.3910",05.00 AED,5.00,4.9000,0.1000,566179960,1609694,Success,United Arab Emirates,DU UAE,Transguard Group LLC,API User,E6AEAE17361
2022-02-25 20:36,73100109,"37,275.3910","37,270.4910",05.00 AED,5.00,4.9000,0.1000,566180530,1609702,Success,United Arab Emirates,DU UAE,Transguard Group LLC,API User,E6AEAE17361
2022-02-25 20:36,73100112,"37,270.4910","37,260.6910",10.00 AED,10.00,9.8000,0.2000,566180534,1609703,Success,United Arab Emirates,DU UAE,Transguard Group LLC,API User,E6AEAE22430
2022-02-25 20:43,73100542,"37,260.6910","37,255.7910",05.00 AED,5.00,4.9000,0.1000,566181829,1609709,Success,United Arab Emirates,DU UAE,Transguard Group LLC,API User,E6AEAE17361
2022-02-25 20:46,73100754,"37,255.7910","37,238.6310",03.50 EUR,19.50,17.1600,2.3400,566182501,1609718,Success,Senegal,Orange Senegal,Transguard Group LLC,API User,ORSNSN57485
2022-02-25 20:51,73101074,"37,238.6310","37,228.8310",10.00 AED,10.00,9.8000,0.2000,566183569,1609725,Success,United Arab Emirates,DU UAE,Transguard Group LLC,API User,E6AEAE22430
2022-02-25 20:52,73101162,"37,228.8310","37,209.2310",20.00 AED,20.00,19.6000,0.4000,566183789,1609728,Success,United Arab Emirates,DU UAE,Transguard Group LLC,API User,E6AEAE12938
2022-02-25 20:53,73101222,"37,209.2310","37,189.6310",20.00 AED,20.00,19.6000,0.4000,566183958,1609732,Success,United Arab Emirates,DU UAE,Transguard Group LLC,API User,E6AEAE12938
2022-02-25 20:53,73101234,"37,189.6310","37,170.0310",20.00 AED,20.00,19.6000,0.4000,566184004,1609735,Failure,United Arab Emirates,DU UAE,Transguard Group LLC,API User,E6AEAE12938
2022-02-25 20:53,73101234,"37,170.0310","37,150.4310",20.00 AED,20.00,19.6000,0.4000,566184004,1609735,Failure,United Arab Emirates,DU UAE,Transguard Group LLC,API User,E6AEAE12938
2022-02-25 20:54,73101287,"37,189.6310","37,184.7310",05.00 AED,5.00,4.9000,0.1000,566184151,1609745,Success,United Arab Emirates,DU UAE,Transguard Group LLC,API User,E6AEAE17361
2022-02-25 20:55,73101327,"37,184.7310","37,174.9310",10.00 AED,10.00,9.8000,0.2000,566184296,1609748,Success,United Arab Emirates,DU UAE,Transguard Group LLC,API User,E6AEAE22430
2022-02-25 20:56,73101359,"37,174.9310","37,170.0310",05.00 AED,5.00,4.9000,0.1000,566184433,1609752,Success,United Arab Emirates,DU UAE,Transguard Group LLC,API User,E6AEAE17361
2022-02-25 20:56,73101378,"37,170.0310","37,165.1310",05.00 AED,5.00,4.9000,0.1000,566184482,1609754,Success,United Arab Emirates,DU UAE,Transguard Group LLC,API User,E6AEAE17361
2022-02-25 21:00,73101617,"37,165.1310","37,155.3310",10.00 AED,10.00,9.8000,0.2000,566185271,1609770,Success,United Arab Emirates,DU UAE,Transguard Group LLC,API User,E6AEAE22430
2022-02-25 21:02,73101730,"37,155.3310","37,145.5310",10.00 AED,10.00,9.8000,0.2000,566185689,1609781,Success,United Arab Emirates,DU UAE,Transguard Group LLC,API User,E6AEAE22430
2022-02-25 21:03,73101794,"37,145.5310","37,136.7310",315.00 PKR,10.00,8.8000,1.2000,566185900,1609786,Success,Pakistan,Telenor Pakistan,Transguard Group LLC,API User,TPPKPK75105
2022-02-25 21:20,73102753,"37,136.7310","37,131.8310",05.00 AED,5.00,4.9000,0.1000,566189106,1609805,Failure,United Arab Emirates,DU UAE,Transguard Group LLC,API User,E6AEAE17361
2022-02-25 21:20,73102753,"37,131.8310","37,126.9310",05.00 AED,5.00,4.9000,0.1000,566189106,1609805,Failure,United Arab Emirates,DU UAE,Transguard Group LLC,API User,E6AEAE17361
2022-02-25 21:21,73102832,"37,136.7310","37,131.8310",05.00 AED,5.00,4.9000,0.1000,566189381,1609810,Success,United Arab Emirates,DU UAE,Transguard Group LLC,API User,E6AEAE17361
2022-02-25 21:23,73102886,"37,131.8310","37,126.9310",05.00 AED,5.00,4.9000,0.1000,566189657,1609816,Success,United Arab Emirates,DU UAE,Transguard Group LLC,API User,E6AEAE17361
2022-02-25 21:26,73103039,"37,126.9310","37,117.1310",10.00 AED,10.00,9.8000,0.2000,566190197,1609827,Success,United Arab Emirates,DU UAE,Transguard Group LLC,API User,E6AEAE22430
2022-02-25 21:26,73103049,"37,117.1310","37,112.2310",05.00 AED,5.00,4.9000,0.1000,566190250,1609828,Success,United Arab Emirates,DU UAE,Transguard Group LLC,API User,E6AEAE17361
2022-02-25 21:27,73103082,"37,112.2310","37,102.4310",10.00 AED,10.00,9.8000,0.2000,566190365,1609831,Success,United Arab Emirates,DU UAE,Transguard Group LLC,API User,E6AEAE22430
2022-02-25 21:31,73103326,"37,102.4310","37,077.9310",25.00 AED,25.00,24.5000,0.5000,566191191,1609842,Success,United Arab Emirates,DU UAE,Transguard Group LLC,API User,E6AEAE17343
2022-02-25 21:31,73103336,"37,077.9310","37,073.0310",05.00 AED,5.00,4.9000,0.1000,566191221,1609845,Success,United Arab Emirates,DU UAE,Transguard Group LLC,API User,E6AEAE17361
2022-02-25 21:41,73103905,"37,073.0310","37,068.1310",05.00 AED,5.00,4.9000,0.1000,566193016,1609854,Success,United Arab Emirates,DU UAE,Transguard Group LLC,API User,E6AEAE17361
2022-02-25 21:41,73103937,"37,068.1310","37,058.3310",10.00 AED,10.00,9.8000,0.2000,566193133,1609857,Success,United Arab Emirates,DU UAE,Transguard Group LLC,API User,E6AEAE22430
2022-02-25 21:42,73103987,"37,058.3310","37,048.5310",10.00 AED,10.00,9.8000,0.2000,566193280,1609860,Success,United Arab Emirates,DU UAE,Transguard Group LLC,API User,E6AEAE22430
2022-02-25 21:44,73104089,"37,048.5310","37,043.6310",05.00 AED,5.00,4.9000,0.1000,566193654,1609863,Success,United Arab Emirates,DU UAE,Transguard Group LLC,API User,E6AEAE17361
2022-02-25 21:45,73104135,"37,043.6310","37,033.8310",10.00 AED,10.00,9.8000,0.2000,566193835,1609866,Success,United Arab Emirates,DU UAE,Transguard Group LLC,API User,E6AEAE22430
2022-02-25 21:52,73104515,"37,033.8310","37,014.2310",20.00 AED,20.00,19.6000,0.4000,566195155,1609878,Success,United Arab Emirates,DU UAE,Transguard Group LLC,API User,E6AEAE12938
2022-02-25 21:58,73104799,"37,014.2310","37,009.3310",05.00 AED,5.00,4.9000,0.1000,566196142,1609885,Success,United Arab Emirates,DU UAE,Transguard Group LLC,API User,E6AEAE17361
2022-02-25 22:13,73105475,"37,009.3310","36,999.5310",10.00 AED,10.00,9.8000,0.2000,566198679,1609915,Success,United Arab Emirates,DU UAE,Transguard Group LLC,API User,E6AEAE22430
2022-02-25 22:18,73105668,"36,999.5310","36,994.6310",05.00 AED,5.00,4.9000,0.1000,566199416,1609919,Success,United Arab Emirates,DU UAE,Transguard Group LLC,API User,E6AEAE17361
2022-02-25 22:25,73105942,"36,994.6310","36,989.7310",05.00 AED,5.00,4.9000,0.1000,566200507,1609928,Success,United Arab Emirates,DU UAE,Transguard Group LLC,API User,E6AEAE17361
2022-02-25 22:27,73106025,"36,989.7310","36,979.9310",10.00 AED,10.00,9.8000,0.2000,566200855,1609931,Success,United Arab Emirates,DU UAE,Transguard Group LLC,API User,E6AEAE22430
2022-02-25 22:30,73106145,"36,979.9310","36,970.1310",10.00 AED,10.00,9.8000,0.2000,566201354,1609936,Success,United Arab Emirates,DU UAE,Transguard Group LLC,API User,E6AEAE22430
2022-02-25 22:32,73106247,"36,970.1310","36,965.2310",05.00 AED,5.00,4.9000,0.1000,566201774,1609939,Success,United Arab Emirates,DU UAE,Transguard Group LLC,API User,E6AEAE17361
2022-02-25 22:40,73106560,"36,965.2310","36,960.3310",05.00 AED,5.00,4.9000,0.1000,566202929,1609952,Success,United Arab Emirates,DU UAE,Transguard Group LLC,API User,E6AEAE17361
2022-02-25 22:40,73106600,"36,960.3310","36,950.5310",10.00 AED,10.00,9.8000,0.2000,566203084,1609955,Success,United Arab Emirates,DU UAE,Transguard Group LLC,API User,E6AEAE22430
2022-02-25 22:51,73107034,"36,950.5310","36,930.9310",20.00 AED,20.00,19.6000,0.4000,566204720,1609965,Success,United Arab Emirates,DU UAE,Transguard Group LLC,API User,E6AEAE12938
2022-02-25 22:57,73107229,"36,930.9310","36,926.0310",05.00 AED,5.00,4.9000,0.1000,566205540,1609977,Success,United Arab Emirates,DU UAE,Transguard Group LLC,API User,E6AEAE17361
2022-02-25 23:12,73107722,"36,926.0310","36,921.1310",05.00 AED,5.00,4.9000,0.1000,566207585,1609987,Success,United Arab Emirates,DU UAE,Transguard Group LLC,API User,E6AEAE17361
2022-02-25 23:15,73107824,"36,921.1310","36,911.3310",10.00 AED,10.00,9.8000,0.2000,566208053,1609996,Success,United Arab Emirates,DU UAE,Transguard Group LLC,API User,E6AEAE22430
2022-02-25 23:19,73107932,"36,911.3310","36,901.5310",10.00 AED,10.00,9.8000,0.2000,566208489,1610004,Success,United Arab Emirates,DU UAE,Transguard Group LLC,API User,E6AEAE22430
2022-02-25 23:21,73108011,"36,901.5310","36,896.6310",05.00 AED,5.00,4.9000,0.1000,566208783,1610007,Success,United Arab Emirates,DU UAE,Transguard Group LLC,API User,E6AEAE17361
2022-02-25 23:33,73108386,"36,896.6310","36,891.7310",05.00 AED,5.00,4.9000,0.1000,566210454,1610010,Success,United Arab Emirates,DU UAE,Transguard Group LLC,API User,E6AEAE17361
2022-02-25 23:42,73108629,"36,891.7310","36,881.9310",10.00 AED,10.00,9.8000,0.2000,566211563,1610017,Success,United Arab Emirates,DU UAE,Transguard Group LLC,API User,E6AEAE22430
2022-02-25 23:54,73108939,"36,881.9310","36,877.0310",05.00 AED,5.00,4.9000,0.1000,566213060,1610028,Success,United Arab Emirates,DU UAE,Transguard Group LLC,API User,E6AEAE17361
2022-02-25 23:54,73108942,"36,877.0310","36,867.2310",10.00 AED,10.00,9.8000,0.2000,566213074,1610031,Success,United Arab Emirates,DU UAE,Transguard Group LLC,API User,E6AEAE22430
2022-02-26 00:09,73109306,"36,867.2310","36,858.4310",239.41 ZWL,10.00,8.8000,1.2000,566214759,1610039,Success,Zimbabwe,Netone Zimbabwe,Transguard Group LLC,API User,Z0ZWZW59125
2022-02-26 00:09,73109333,"36,858.4310","36,853.5310",05.00 AED,5.00,4.9000,0.1000,566214867,1610042,Success,United Arab Emirates,DU UAE,Transguard Group LLC,API User,E6AEAE17361
2022-02-26 00:21,73109597,"36,853.5310","36,843.7310",10.00 AED,10.00,9.8000,0.2000,566216180,1610050,Success,United Arab Emirates,DU UAE,Transguard Group LLC,API User,E6AEAE22430
2022-02-26 00:22,73109614,"36,843.7310","36,824.1310",20.00 AED,20.00,19.6000,0.4000,566216327,1610053,Success,United Arab Emirates,DU UAE,Transguard Group LLC,API User,E6AEAE12938
2022-02-26 00:30,73109792,"36,824.1310","36,819.2310",05.00 AED,5.00,4.9000,0.1000,566217215,1610064,Success,United Arab Emirates,DU UAE,Transguard Group LLC,API User,E6AEAE17361
2022-02-26 00:58,73110507,"36,819.2310","36,814.3310",05.00 AED,5.00,4.9000,0.1000,566220305,1610073,Success,United Arab Emirates,DU UAE,Transguard Group LLC,API User,E6AEAE17361
2022-02-26 01:07,73110708,"36,814.3310","36,809.4310",05.00 AED,5.00,4.9000,0.1000,566221257,1610077,Success,United Arab Emirates,DU UAE,Transguard Group LLC,API User,E6AEAE17361
2022-02-26 01:09,73110740,"36,809.4310","36,804.5310",05.00 AED,5.00,4.9000,0.1000,566221419,1610084,Success,United Arab Emirates,DU UAE,Transguard Group LLC,API User,E6AEAE17361
2022-02-26 01:53,73111654,"36,804.5310","36,799.6310",05.00 AED,5.00,4.9000,0.1000,566226297,1610094,Success,United Arab Emirates,DU UAE,Transguard Group LLC,API User,E6AEAE17361
2022-02-26 01:55,73111716,"36,799.6310","36,789.8310",10.00 AED,10.00,9.8000,0.2000,566226598,1610097,Success,United Arab Emirates,DU UAE,Transguard Group LLC,API User,E6AEAE22430
2022-02-26 02:38,73112642,"36,789.8310","36,770.2310",20.00 AED,20.00,19.6000,0.4000,566231512,1610113,Success,United Arab Emirates,DU UAE,Transguard Group LLC,API User,E6AEAE12938
2022-02-26 03:05,73113197,"36,770.2310","36,760.4310",10.00 AED,10.00,9.8000,0.2000,566234546,1610116,Success,United Arab Emirates,DU UAE,Transguard Group LLC,API User,E6AEAE22430
2022-02-26 03:06,73113205,"36,760.4310","36,750.6310",10.00 AED,10.00,9.8000,0.2000,566234604,1610119,Success,United Arab Emirates,DU UAE,Transguard Group LLC,API User,E6AEAE22430
2022-02-26 03:15,73113394,"36,750.6310","36,746.4510",150.00 PKR,4.75,4.1800,0.5700,566235631,1610122,Success,Pakistan,Jazz Pakistan,Transguard Group LLC,API User,MBPKPK20699
2022-02-26 03:24,73113634,"36,746.4510","36,736.6510",10.00 AED,10.00,9.8000,0.2000,566236711,1610125,Success,United Arab Emirates,DU UAE,Transguard Group LLC,API User,E6AEAE22430
2022-02-26 03:27,73113698,"36,736.6510","36,726.8510",10.00 AED,10.00,9.8000,0.2000,566237102,1610131,Success,United Arab Emirates,DU UAE,Transguard Group LLC,API User,E6AEAE22430
2022-02-26 03:27,73113704,"36,726.8510","36,721.9510",05.00 AED,5.00,4.9000,0.1000,566237138,1610134,Success,United Arab Emirates,DU UAE,Transguard Group LLC,API User,E6AEAE17361
2022-02-26 05:02,73115527,"36,721.9510","36,712.1510",10.00 AED,10.00,9.8000,0.2000,566247317,1610162,Success,United Arab Emirates,DU UAE,Transguard Group LLC,API User,E6AEAE22430
2022-02-26 05:05,73115567,"36,712.1510","36,692.5510",20.00 AED,20.00,19.6000,0.4000,566247548,1610165,Success,United Arab Emirates,DU UAE,Transguard Group LLC,API User,E6AEAE12938
2022-02-26 05:25,73115935,"36,692.5510","36,682.7510",10.00 AED,10.00,9.8000,0.2000,566249351,1610177,Success,United Arab Emirates,DU UAE,Transguard Group LLC,API User,E6AEAE22430
2022-02-26 05:28,73116001,"36,682.7510","36,677.8510",05.00 AED,5.00,4.9000,0.1000,566249647,1610180,Success,United Arab Emirates,DU UAE,Transguard Group LLC,API User,E6AEAE17361
2022-02-26 05:29,73116030,"36,677.8510","36,672.9510",05.00 AED,5.00,4.9000,0.1000,566249752,1610183,Success,United Arab Emirates,DU UAE,Transguard Group LLC,API User,E6AEAE17361
2022-02-26 05:50,73116413,"36,672.9510","36,668.0510",05.00 AED,5.00,4.9000,0.1000,566251543,1610201,Success,United Arab Emirates,DU UAE,Transguard Group LLC,API User,E6AEAE17361
2022-02-26 06:02,73116619,"36,668.0510","36,663.1510",05.00 AED,5.00,4.9000,0.1000,566252508,1610214,Success,United Arab Emirates,DU UAE,Transguard Group LLC,API User,E6AEAE17361
2022-02-26 06:07,73116709,"36,663.1510","36,658.2510",05.00 AED,5.00,4.9000,0.1000,566252915,1610222,Success,United Arab Emirates,DU UAE,Transguard Group LLC,API User,E6AEAE17361
2022-02-26 06:09,73116726,"36,658.2510","36,653.3510",05.00 AED,5.00,4.9000,0.1000,566253042,1610229,Success,United Arab Emirates,DU UAE,Transguard Group LLC,API User,E6AEAE17361
2022-02-26 06:12,73116796,"36,653.3510","36,643.5510",10.00 AED,10.00,9.8000,0.2000,566253300,1610236,Success,United Arab Emirates,DU UAE,Transguard Group LLC,API User,E6AEAE22430
2022-02-26 06:12,73116800,"36,643.5510","36,633.7510",10.00 AED,10.00,9.8000,0.2000,566253312,1610237,Success,United Arab Emirates,DU UAE,Transguard Group LLC,API User,E6AEAE22430
2022-02-26 06:16,73116865,"36,633.7510","36,628.8510",05.00 AED,5.00,4.9000,0.1000,566253628,1610240,Success,United Arab Emirates,DU UAE,Transguard Group LLC,API User,E6AEAE17361
2022-02-26 06:18,73116907,"36,628.8510","36,623.9510",05.00 AED,5.00,4.9000,0.1000,566253784,1610247,Success,United Arab Emirates,DU UAE,Transguard Group LLC,API User,E6AEAE17361
2022-02-26 06:19,73116931,"36,623.9510","36,619.0510",05.00 AED,5.00,4.9000,0.1000,566253889,1610256,Success,United Arab Emirates,DU UAE,Transguard Group LLC,API User,E6AEAE17361
2022-02-26 06:20,73116943,"36,619.0510","36,609.2510",10.00 AED,10.00,9.8000,0.2000,566253940,1610259,Success,United Arab Emirates,DU UAE,Transguard Group LLC,API User,E6AEAE22430
2022-02-26 06:24,73117026,"36,609.2510","36,598.6910",179.00 INR,12.00,10.5600,1.4400,566254267,1610264,Success,India,Airtel India,Transguard Group LLC,API User,AIININ72188
2022-02-26 06:34,73117213,"36,598.6910","36,588.8910",10.00 AED,10.00,9.8000,0.2000,566255128,1610269,Success,United Arab Emirates,DU UAE,Transguard Group LLC,API User,E6AEAE22430
2022-02-26 06:36,73117250,"36,588.8910","36,569.2910",20.00 AED,20.00,19.6000,0.4000,566255250,1610272,Success,United Arab Emirates,DU UAE,Transguard Group LLC,API User,E6AEAE12938
2022-02-26 06:45,73117430,"36,569.2910","36,559.4910",10.00 AED,10.00,9.8000,0.2000,566256006,1610277,Success,United Arab Emirates,DU UAE,Transguard Group LLC,API User,E6AEAE22430
2022-02-26 06:47,73117464,"36,559.4910","36,545.6310",529.00 PKR,15.75,13.8600,1.8900,566256174,1610283,Success,Pakistan,Ufone Pakistan,Transguard Group LLC,API User,UFPKPK6556
2022-02-26 06:51,73117563,"36,545.6310","36,535.8310",10.00 AED,10.00,9.8000,0.2000,566256471,1610289,Success,United Arab Emirates,DU UAE,Transguard Group LLC,API User,E6AEAE22430
2022-02-26 06:55,73117651,"36,535.8310","36,530.9310",05.00 AED,5.00,4.9000,0.1000,566256802,1610293,Success,United Arab Emirates,DU UAE,Transguard Group LLC,API User,E6AEAE17361
2022-02-26 06:57,73117673,"36,530.9310","36,521.1310",10.00 AED,10.00,9.8000,0.2000,566256893,1610297,Success,United Arab Emirates,DU UAE,Transguard Group LLC,API User,E6AEAE22430
2022-02-26 07:04,73117883,"36,521.1310","36,513.2110",220.00 NPR,9.00,7.9200,1.0800,566257601,1610307,Success,Nepal,Ncell Nepal,Transguard Group LLC,API User,NCNPNP79518
2022-02-26 07:06,73117924,"36,513.2110","36,508.3110",05.00 AED,5.00,4.9000,0.1000,566257732,1610314,Success,United Arab Emirates,DU UAE,Transguard Group LLC,API User,E6AEAE17361
2022-02-26 07:07,73117933,"36,508.3110","36,488.7110",20.00 AED,20.00,19.6000,0.4000,566257772,1610318,Success,United Arab Emirates,DU UAE,Transguard Group LLC,API User,E6AEAE12938
2022-02-26 07:11,73117998,"36,488.7110","36,484.5310",150.00 PKR,4.75,4.1800,0.5700,566258099,1610327,Success,Pakistan,Zong Pakistan,Transguard Group LLC,API User,ZNPKPK65621
2022-02-26 07:16,73118107,"36,484.5310","36,479.6310",05.00 AED,5.00,4.9000,0.1000,566258561,1610336,Success,United Arab Emirates,DU UAE,Transguard Group LLC,API User,E6AEAE17361
2022-02-26 07:16,73118109,"36,479.6310","36,469.8310",10.00 AED,10.00,9.8000,0.2000,566258579,1610338,Success,United Arab Emirates,DU UAE,Transguard Group LLC,API User,E6AEAE22430
2022-02-26 07:19,73118155,"36,469.8310","36,464.9310",05.00 AED,5.00,4.9000,0.1000,566258739,1610347,Success,United Arab Emirates,DU UAE,Transguard Group LLC,API User,E6AEAE17361
2022-02-26 07:19,73118159,"36,464.9310","36,460.0310",05.00 AED,5.00,4.9000,0.1000,566258748,1610348,Success,United Arab Emirates,DU UAE,Transguard Group LLC,API User,E6AEAE17361
2022-02-26 07:21,73118228,"36,460.0310","36,455.1310",05.00 AED,5.00,4.9000,0.1000,566258977,1610351,Success,United Arab Emirates,DU UAE,Transguard Group LLC,API User,E6AEAE17361
2022-02-26 07:33,73118454,"36,455.1310","36,445.3310",10.00 AED,10.00,9.8000,0.2000,566259862,1610361,Success,United Arab Emirates,DU UAE,Transguard Group LLC,API User,E6AEAE22430
2022-02-26 07:40,73118598,"36,445.3310","36,435.5310",10.00 AED,10.00,9.8000,0.2000,566260437,1610368,Success,United Arab Emirates,DU UAE,Transguard Group LLC,API User,E6AEAE22430
2022-02-26 07:42,73118636,"36,435.5310","36,430.6310",05.00 AED,5.00,4.9000,0.1000,566260573,1610375,Success,United Arab Emirates,DU UAE,Transguard Group LLC,API User,E6AEAE17361
2022-02-26 07:43,73118674,"36,430.6310","36,420.8310",10.00 AED,10.00,9.8000,0.2000,566260697,1610380,Success,United Arab Emirates,DU UAE,Transguard Group LLC,API User,E6AEAE22430
2022-02-26 07:45,73118703,"36,420.8310","36,415.9310",05.00 AED,5.00,4.9000,0.1000,566260808,1610383,Success,United Arab Emirates,DU UAE,Transguard Group LLC,API User,E6AEAE17361
2022-02-26 07:46,73118724,"36,415.9310","36,411.0310",05.00 AED,5.00,4.9000,0.1000,566260880,1610388,Success,United Arab Emirates,DU UAE,Transguard Group LLC,API User,E6AEAE17361
2022-02-26 07:50,73118833,"36,411.0310","36,396.3310",15.00 AED,15.00,14.7000,0.3000,566261235,1610400,Success,United Arab Emirates,DU UAE,Transguard Group LLC,API User,E6AEAE8527
2022-02-26 07:55,73118939,"36,396.3310","36,391.4310",05.00 AED,5.00,4.9000,0.1000,566261625,1610412,Success,United Arab Emirates,DU UAE,Transguard Group LLC,API User,E6AEAE17361
2022-02-26 07:55,73118946,"36,391.4310","36,386.5310",05.00 AED,5.00,4.9000,0.1000,566261651,1610413,Success,United Arab Emirates,DU UAE,Transguard Group LLC,API User,E6AEAE17361
2022-02-26 08:01,73119063,"36,386.5310","36,381.6310",05.00 AED,5.00,4.9000,0.1000,566262075,1610424,Success,United Arab Emirates,DU UAE,Transguard Group LLC,API User,E6AEAE17361
2022-02-26 08:01,73119073,"36,381.6310","36,376.7310",05.00 AED,5.00,4.9000,0.1000,566262107,1610427,Success,United Arab Emirates,DU UAE,Transguard Group LLC,API User,E6AEAE17361
2022-02-26 08:11,73119307,"36,376.7310","36,371.8310",05.00 AED,5.00,4.9000,0.1000,566262913,1610438,Success,United Arab Emirates,DU UAE,Transguard Group LLC,API User,E6AEAE17361
2022-02-26 08:12,73119339,"36,371.8310","36,352.2310",20.00 AED,20.00,19.6000,0.4000,566263002,1610441,Success,United Arab Emirates,DU UAE,Transguard Group LLC,API User,E6AEAE12938
2022-02-26 08:14,73119392,"36,352.2310","36,347.3310",05.00 AED,5.00,4.9000,0.1000,566263165,1610444,Success,United Arab Emirates,DU UAE,Transguard Group LLC,API User,E6AEAE17361
2022-02-26 08:19,73119517,"36,347.3310","36,342.4310",05.00 AED,5.00,4.9000,0.1000,566263560,1610456,Success,United Arab Emirates,DU UAE,Transguard Group LLC,API User,E6AEAE17361
2022-02-26 08:19,73119530,"36,342.4310","36,337.5310",05.00 AED,5.00,4.9000,0.1000,566263596,1610461,Success,United Arab Emirates,DU UAE,Transguard Group LLC,API User,E6AEAE17361
2022-02-26 08:27,73119717,"36,337.5310","36,332.6310",05.00 AED,5.00,4.9000,0.1000,566264181,1610467,Success,United Arab Emirates,DU UAE,Transguard Group LLC,API User,E6AEAE17361
2022-02-26 08:31,73119788,"36,332.6310","36,327.7310",05.00 AED,5.00,4.9000,0.1000,566264431,1610473,Success,United Arab Emirates,DU UAE,Transguard Group LLC,API User,E6AEAE17361
2022-02-26 08:32,73119828,"36,327.7310","36,317.9310",10.00 AED,10.00,9.8000,0.2000,566264523,1610476,Success,United Arab Emirates,DU UAE,Transguard Group LLC,API User,E6AEAE22430
2022-02-26 08:33,73119843,"36,317.9310","36,298.3310",20.00 AED,20.00,19.6000,0.4000,566264587,73119843,Success,United Arab Emirates,DU UAE,Transguard Group LLC,mohammed.arafath@transguardgroup.com,E6AEAE12938
2022-02-26 08:33,73119854,"36,298.3310","36,288.5310",10.00 AED,10.00,9.8000,0.2000,566264610,1610481,Success,United Arab Emirates,DU UAE,Transguard Group LLC,API User,E6AEAE22430
2022-02-26 08:37,73119964,"36,288.5310","36,283.6310",05.00 AED,5.00,4.9000,0.1000,566264911,1610487,Success,United Arab Emirates,DU UAE,Transguard Group LLC,API User,E6AEAE17361
2022-02-26 08:41,73120073,"36,283.6310","36,278.7310",05.00 AED,5.00,4.9000,0.1000,566265281,1610495,Success,United Arab Emirates,DU UAE,Transguard Group LLC,API User,E6AEAE17361
2022-02-26 08:45,73120182,"36,278.7310","36,273.8310",05.00 AED,5.00,4.9000,0.1000,566265614,1610505,Success,United Arab Emirates,DU UAE,Transguard Group LLC,API User,E6AEAE17361
2022-02-26 08:52,73120398,"36,273.8310","36,268.9310",05.00 AED,5.00,4.9000,0.1000,566266241,1610523,Success,United Arab Emirates,DU UAE,Transguard Group LLC,API User,E6AEAE17361
2022-02-26 08:54,73120449,"36,268.9310","36,259.1310",10.00 AED,10.00,9.8000,0.2000,566266368,1610529,Success,United Arab Emirates,DU UAE,Transguard Group LLC,API User,E6AEAE22430
2022-02-26 08:54,73120457,"36,259.1310","36,254.2310",05.00 AED,5.00,4.9000,0.1000,566266385,1610530,Success,United Arab Emirates,DU UAE,Transguard Group LLC,API User,E6AEAE17361
2022-02-26 08:55,73120471,"36,254.2310","36,249.3310",05.00 AED,5.00,4.9000,0.1000,566266437,1610535,Success,United Arab Emirates,DU UAE,Transguard Group LLC,API User,E6AEAE17361
2022-02-26 08:56,73120481,"36,249.3310","36,244.4310",05.00 AED,5.00,4.9000,0.1000,566266475,1610538,Success,United Arab Emirates,DU UAE,Transguard Group LLC,API User,E6AEAE17361
2022-02-26 08:58,73120565,"36,244.4310","36,239.5310",05.00 AED,5.00,4.9000,0.1000,566266722,1610546,Success,United Arab Emirates,DU UAE,Transguard Group LLC,API User,E6AEAE17361
2022-02-26 08:59,73120579,"36,239.5310","36,234.6310",05.00 AED,5.00,4.9000,0.1000,566266784,1610551,Success,United Arab Emirates,DU UAE,Transguard Group LLC,API User,E6AEAE17361
2022-02-26 09:01,73120621,"36,234.6310","36,229.7310",05.00 AED,5.00,4.9000,0.1000,566266910,1610556,Success,United Arab Emirates,DU UAE,Transguard Group LLC,API User,E6AEAE17361
2022-02-26 09:02,73120658,"36,229.7310","36,219.9310",10.00 AED,10.00,9.8000,0.2000,566266994,1610563,Success,United Arab Emirates,DU UAE,Transguard Group LLC,API User,E6AEAE22430
2022-02-26 09:02,73120669,"36,219.9310","36,210.1310",10.00 AED,10.00,9.8000,0.2000,566267015,1610565,Success,United Arab Emirates,DU UAE,Transguard Group LLC,API User,E6AEAE22430
2022-02-26 09:07,73120817,"36,210.1310","36,205.2310",05.00 AED,5.00,4.9000,0.1000,566267428,1610578,Success,United Arab Emirates,DU UAE,Transguard Group LLC,API User,E6AEAE17361
2022-02-26 09:08,73120822,"36,205.2310","36,200.3310",05.00 AED,5.00,4.9000,0.1000,566267462,1610580,Success,United Arab Emirates,DU UAE,Transguard Group LLC,API User,E6AEAE17361
2022-02-26 09:09,73120848,"36,200.3310","36,190.5310",10.00 AED,10.00,9.8000,0.2000,566267547,1610586,Success,United Arab Emirates,DU UAE,Transguard Group LLC,API User,E6AEAE22430
2022-02-26 09:09,73120870,"36,190.5310","36,185.6310",05.00 AED,5.00,4.9000,0.1000,566267624,1610592,Success,United Arab Emirates,DU UAE,Transguard Group LLC,API User,E6AEAE17361
2022-02-26 09:11,73120916,"36,185.6310","36,175.8310",10.00 AED,10.00,9.8000,0.2000,566267792,1610598,Success,United Arab Emirates,DU UAE,Transguard Group LLC,API User,E6AEAE22430
2022-02-26 09:12,73120934,"36,175.8310","36,169.4510",110.00 INR,7.25,6.3800,0.8700,566267838,1610600,Success,India,BSNL India,Transguard Group LLC,API User,BLININ42833
2022-02-26 09:14,73120995,"36,169.4510","36,163.5110",100.00 INR,6.75,5.9400,0.8100,566268017,1610605,Success,India,Airtel India,Transguard Group LLC,API User,AIININ36410
2022-02-26 09:15,73121021,"36,163.5110","36,153.7110",10.00 AED,10.00,9.8000,0.2000,566268100,1610611,Success,United Arab Emirates,DU UAE,Transguard Group LLC,API User,E6AEAE22430
2022-02-26 09:16,73121043,"36,153.7110","36,147.3310",110.00 INR,7.25,6.3800,0.8700,566268161,1610615,Success,India,BSNL India,Transguard Group LLC,API User,BLININ42833
2022-02-26 09:16,73121044,"36,147.3310","36,137.5310",10.00 AED,10.00,9.8000,0.2000,566268162,1610616,Success,United Arab Emirates,DU UAE,Transguard Group LLC,API User,E6AEAE22430
2022-02-26 09:18,73121109,"36,137.5310","36,132.6310",05.00 AED,5.00,4.9000,0.1000,566268311,1610619,Success,United Arab Emirates,DU UAE,Transguard Group LLC,API User,E6AEAE17361
2022-02-26 09:23,73121266,"36,132.6310","36,127.7310",05.00 AED,5.00,4.9000,0.1000,566268730,1610625,Success,United Arab Emirates,DU UAE,Transguard Group LLC,API User,E6AEAE17361
2022-02-26 09:23,73121271,"36,127.7310","36,122.8310",05.00 AED,5.00,4.9000,0.1000,566268745,1610627,Success,United Arab Emirates,DU UAE,Transguard Group LLC,API User,E6AEAE17361
2022-02-26 09:31,73121460,"36,122.8310","36,113.0310",10.00 AED,10.00,9.8000,0.2000,566269348,1610644,Success,United Arab Emirates,DU UAE,Transguard Group LLC,API User,E6AEAE22430
2022-02-26 09:32,73121484,"36,113.0310","36,108.1310",05.00 AED,5.00,4.9000,0.1000,566269420,1610647,Success,United Arab Emirates,DU UAE,Transguard Group LLC,API User,E6AEAE17361
2022-02-26 09:32,73121505,"36,108.1310","36,100.2110",220.00 NPR,9.00,7.9200,1.0800,566269483,1610650,Success,Nepal,Ncell Nepal,Transguard Group LLC,API User,NCNPNP79518
2022-02-26 09:34,73121541,"36,100.2110","36,090.4110",10.00 AED,10.00,9.8000,0.2000,566269604,1610659,Success,United Arab Emirates,DU UAE,Transguard Group LLC,API User,E6AEAE22430
2022-02-26 09:36,73121595,"36,090.4110","36,085.5110",05.00 AED,5.00,4.9000,0.1000,566269756,1610664,Success,United Arab Emirates,DU UAE,Transguard Group LLC,API User,E6AEAE17361
2022-02-26 09:39,73121711,"36,085.5110","36,080.6110",05.00 AED,5.00,4.9000,0.1000,566270065,1610669,Success,United Arab Emirates,DU UAE,Transguard Group LLC,API User,E6AEAE17361
2022-02-26 09:42,73121776,"36,080.6110","36,075.7110",05.00 AED,5.00,4.9000,0.1000,566270274,1610676,Success,United Arab Emirates,DU UAE,Transguard Group LLC,API User,E6AEAE17361
2022-02-26 09:48,73121953,"36,075.7110","36,070.8110",05.00 AED,5.00,4.9000,0.1000,566270762,1610685,Success,United Arab Emirates,DU UAE,Transguard Group LLC,API User,E6AEAE17361
2022-02-26 09:51,73122044,"36,070.8110","36,065.9110",05.00 AED,5.00,4.9000,0.1000,566271018,1610691,Success,United Arab Emirates,DU UAE,Transguard Group LLC,API User,E6AEAE17361
2022-02-26 09:52,73122098,"36,065.9110","36,061.0110",05.00 AED,5.00,4.9000,0.1000,566271160,1610699,Success,United Arab Emirates,DU UAE,Transguard Group LLC,API User,E6AEAE17361
2022-02-26 09:52,73122099,"36,061.0110","36,051.2110",10.00 AED,10.00,9.8000,0.2000,566271164,1610700,Success,United Arab Emirates,DU UAE,Transguard Group LLC,API User,E6AEAE22430
2022-02-26 09:52,73122103,"36,051.2110","36,046.3110",05.00 AED,5.00,4.9000,0.1000,566271175,1610701,Success,United Arab Emirates,DU UAE,Transguard Group LLC,API User,E6AEAE17361
2022-02-26 09:54,73122152,"36,046.3110","36,036.5110",10.00 AED,10.00,9.8000,0.2000,566271303,1610709,Success,United Arab Emirates,DU UAE,Transguard Group LLC,API User,E6AEAE22430
2022-02-26 09:54,73122155,"36,036.5110","36,031.6110",05.00 AED,5.00,4.9000,0.1000,566271305,1610710,Success,United Arab Emirates,DU UAE,Transguard Group LLC,API User,E6AEAE17361
2022-02-26 09:54,73122157,"36,031.6110","36,026.7110",05.00 AED,5.00,4.9000,0.1000,566271310,1610711,Success,United Arab Emirates,DU UAE,Transguard Group LLC,API User,E6AEAE17361
2022-02-26 09:56,73122211,"36,026.7110","36,016.9110",10.00 AED,10.00,9.8000,0.2000,566271452,1610714,Success,United Arab Emirates,DU UAE,Transguard Group LLC,API User,E6AEAE22430
2022-02-26 10:05,73122545,"36,016.9110","36,012.0110",05.00 AED,5.00,4.9000,0.1000,566272288,1610737,Success,United Arab Emirates,DU UAE,Transguard Group LLC,API User,E6AEAE17361
2022-02-26 10:05,73122550,"36,012.0110","36,002.2110",10.00 AED,10.00,9.8000,0.2000,566272294,1610738,Success,United Arab Emirates,DU UAE,Transguard Group LLC,API User,E6AEAE22430
2022-02-26 10:10,73122691,"36,002.2110","35,992.4110",10.00 AED,10.00,9.8000,0.2000,566272690,1610755,Success,United Arab Emirates,DU UAE,Transguard Group LLC,API User,E6AEAE22430
2022-02-26 10:15,73122849,"35,992.4110","35,987.5110",05.00 AED,5.00,4.9000,0.1000,566273096,1610767,Success,United Arab Emirates,DU UAE,Transguard Group LLC,API User,E6AEAE17361
2022-02-26 10:16,73122884,"35,987.5110","35,982.6110",05.00 AED,5.00,4.9000,0.1000,566273199,73122884,Failure,United Arab Emirates,DU UAE,Transguard Group LLC,mohammed.arafath@transguardgroup.com,E6AEAE17361
2022-02-26 10:16,73122884,"35,982.6110","35,977.7110",05.00 AED,5.00,4.9000,0.1000,566273199,73122884,Failure,United Arab Emirates,DU UAE,Transguard Group LLC,mohammed.arafath@transguardgroup.com,E6AEAE17361
2022-02-26 10:17,73122930,"35,987.5110","35,977.7110",10.00 AED,10.00,9.8000,0.2000,566273311,1610770,Success,United Arab Emirates,DU UAE,Transguard Group LLC,API User,E6AEAE22430
2022-02-26 10:18,73122947,"35,977.7110","35,972.7860",05.00 AED,5.00,4.9250,0.0750,566273388,73122947,Success,United Arab Emirates,Etisalat UAE,Transguard Group LLC,mohammed.arafath@transguardgroup.com,ETAEAE54031
2022-02-26 10:20,73123010,"35,972.7860","35,956.7260",575.00 PKR,18.25,16.0600,2.1900,566273593,1610775,Success,Pakistan,Telenor Pakistan,Transguard Group LLC,API User,TPPKPK7947
2022-02-26 10:22,73123074,"35,956.7260","35,951.8260",05.00 AED,5.00,4.9000,0.1000,566273752,1610782,Success,United Arab Emirates,DU UAE,Transguard Group LLC,API User,E6AEAE17361
2022-02-26 10:26,73123212,"35,951.8260","35,946.9260",05.00 AED,5.00,4.9000,0.1000,566274085,1610787,Success,United Arab Emirates,DU UAE,Transguard Group LLC,API User,E6AEAE17361
2022-02-26 10:27,73123252,"35,946.9260","35,942.0260",05.00 AED,5.00,4.9000,0.1000,566274166,1610790,Success,United Arab Emirates,DU UAE,Transguard Group LLC,API User,E6AEAE17361
2022-02-26 10:30,73123325,"35,942.0260","35,932.2260",10.00 AED,10.00,9.8000,0.2000,566274372,1610795,Success,United Arab Emirates,DU UAE,Transguard Group LLC,API User,E6AEAE22430
2022-02-26 10:31,73123368,"35,932.2260","35,927.3260",05.00 AED,5.00,4.9000,0.1000,566274514,1610798,Success,United Arab Emirates,DU UAE,Transguard Group LLC,API User,E6AEAE17361
2022-02-26 10:36,73123535,"35,927.3260","35,922.4260",05.00 AED,5.00,4.9000,0.1000,566274967,1610807,Success,United Arab Emirates,DU UAE,Transguard Group LLC,API User,E6AEAE17361
2022-02-26 10:37,73123586,"35,922.4260","35,902.8260",20.00 AED,20.00,19.6000,0.4000,566275083,1610810,Success,United Arab Emirates,DU UAE,Transguard Group LLC,API User,E6AEAE12938
2022-02-26 10:38,73123641,"35,902.8260","35,897.9260",05.00 AED,5.00,4.9000,0.1000,566275214,1610814,Success,United Arab Emirates,DU UAE,Transguard Group LLC,API User,E6AEAE17361
2022-02-26 10:40,73123708,"35,897.9260","35,893.0260",05.00 AED,5.00,4.9000,0.1000,566275396,1610817,Success,United Arab Emirates,DU UAE,Transguard Group LLC,API User,E6AEAE17361
2022-02-26 10:41,73123739,"35,893.0260","35,888.1260",05.00 AED,5.00,4.9000,0.1000,566275469,1610822,Success,United Arab Emirates,DU UAE,Transguard Group LLC,API User,E6AEAE17361
2022-02-26 10:41,73123742,"35,888.1260","35,848.7260",40.00 AED,40.00,39.4000,0.6000,566275481,73123742,Success,United Arab Emirates,Etisalat UAE,Transguard Group LLC,mohammed.arafath@transguardgroup.com,ETAEAE43583
2022-02-26 10:49,73124000,"35,848.7260","35,843.8260",05.00 AED,5.00,4.9000,0.1000,566276113,1610840,Success,United Arab Emirates,DU UAE,Transguard Group LLC,API User,E6AEAE17361
2022-02-26 10:52,73124120,"35,843.8260","35,838.9260",05.00 AED,5.00,4.9000,0.1000,566276429,1610847,Success,United Arab Emirates,DU UAE,Transguard Group LLC,API User,E6AEAE17361
2022-02-26 10:55,73124223,"35,838.9260","35,829.1260",10.00 AED,10.00,9.8000,0.2000,566276704,1610853,Success,United Arab Emirates,DU UAE,Transguard Group LLC,API User,E6AEAE22430
2022-02-26 10:59,73124374,"35,829.1260","35,819.3260",10.00 AED,10.00,9.8000,0.2000,566277065,1610866,Success,United Arab Emirates,DU UAE,Transguard Group LLC,API User,E6AEAE22430
2022-02-26 11:05,73124528,"35,819.3260","35,814.4260",05.00 AED,5.00,4.9000,0.1000,566277479,1610876,Success,United Arab Emirates,DU UAE,Transguard Group LLC,API User,E6AEAE17361
2022-02-26 11:06,73124574,"35,814.4260","35,794.8260",20.00 AED,20.00,19.6000,0.4000,566277605,1610881,Success,United Arab Emirates,DU UAE,Transguard Group LLC,API User,E6AEAE12938
2022-02-26 11:06,73124585,"35,794.8260","35,789.9260",05.00 AED,5.00,4.9000,0.1000,566277646,1610886,Success,United Arab Emirates,DU UAE,Transguard Group LLC,API User,E6AEAE17361
2022-02-26 11:06,73124588,"35,789.9260","35,780.1260",10.00 AED,10.00,9.8000,0.2000,566277654,1610887,Success,United Arab Emirates,DU UAE,Transguard Group LLC,API User,E6AEAE22430
2022-02-26 11:10,73124713,"35,780.1260","35,775.2260",05.00 AED,5.00,4.9000,0.1000,566277997,1610892,Success,United Arab Emirates,DU UAE,Transguard Group LLC,API User,E6AEAE17361
2022-02-26 11:24,73125225,"35,775.2260","35,770.3260",05.00 AED,5.00,4.9000,0.1000,566279275,1610912,Success,United Arab Emirates,DU UAE,Transguard Group LLC,API User,E6AEAE17361
2022-02-26 11:28,73125342,"35,770.3260","35,760.5260",10.00 AED,10.00,9.8000,0.2000,566279588,1610918,Success,United Arab Emirates,DU UAE,Transguard Group LLC,API User,E6AEAE22430
2022-02-26 11:34,73125513,"35,760.5260","35,750.7260",10.00 AED,10.00,9.8000,0.2000,566280068,1610931,Success,United Arab Emirates,DU UAE,Transguard Group LLC,API User,E6AEAE22430
2022-02-26 11:36,73125586,"35,750.7260","35,745.8260",05.00 AED,5.00,4.9000,0.1000,566280278,1610937,Success,United Arab Emirates,DU UAE,Transguard Group LLC,API User,E6AEAE17361
2022-02-26 11:38,73125650,"35,745.8260","35,736.0260",10.00 AED,10.00,9.8000,0.2000,566280469,1610941,Success,United Arab Emirates,DU UAE,Transguard Group LLC,API User,E6AEAE22430
2022-02-26 11:40,73125722,"35,736.0260","35,728.1060",220.00 NPR,9.00,7.9200,1.0800,566280647,1610944,Success,Nepal,Ncell Nepal,Transguard Group LLC,API User,NCNPNP79518
2022-02-26 11:41,73125759,"35,728.1060","35,718.3060",10.00 AED,10.00,9.8000,0.2000,566280747,1610949,Success,United Arab Emirates,DU UAE,Transguard Group LLC,API User,E6AEAE22430
2022-02-26 11:42,73125765,"35,718.3060","35,713.4060",05.00 AED,5.00,4.9000,0.1000,566280760,1610950,Success,United Arab Emirates,DU UAE,Transguard Group LLC,API User,E6AEAE17361
2022-02-26 11:44,73125864,"35,713.4060","35,703.6060",10.00 AED,10.00,9.8000,0.2000,566281016,1610955,Success,United Arab Emirates,DU UAE,Transguard Group LLC,API User,E6AEAE22430
2022-02-26 11:50,73126062,"35,703.6060","35,699.8660",100.00 NPR,4.25,3.7400,0.5100,566281543,1610964,Success,Nepal,Nepal Telecom Nepal,Transguard Group LLC,API User,NP_NE_TopUp_100.00
2022-02-26 11:51,73126075,"35,699.8660","35,694.9660",05.00 AED,5.00,4.9000,0.1000,566281566,1610965,Success,United Arab Emirates,DU UAE,Transguard Group LLC,API User,E6AEAE17361
2022-02-26 11:55,73126248,"35,694.9660","35,690.0660",05.00 AED,5.00,4.9000,0.1000,566281985,1610979,Success,United Arab Emirates,DU UAE,Transguard Group LLC,API User,E6AEAE17361
2022-02-26 11:56,73126258,"35,690.0660","35,685.1660",05.00 AED,5.00,4.9000,0.1000,566282021,1610981,Success,United Arab Emirates,DU UAE,Transguard Group LLC,API User,E6AEAE17361
2022-02-26 11:56,73126276,"35,685.1660","35,680.2660",05.00 AED,5.00,4.9000,0.1000,566282082,1610986,Success,United Arab Emirates,DU UAE,Transguard Group LLC,API User,E6AEAE17361
2022-02-26 12:05,73126526,"35,680.2660","35,670.4660",10.00 AED,10.00,9.8000,0.2000,566282829,1611005,Success,United Arab Emirates,DU UAE,Transguard Group LLC,API User,E6AEAE22430
2022-02-26 12:05,73126530,"35,670.4660","35,660.6660",10.00 AED,10.00,9.8000,0.2000,566282834,1611006,Success,United Arab Emirates,DU UAE,Transguard Group LLC,API User,E6AEAE22430
2022-02-26 12:09,73126646,"35,660.6660","35,650.8660",10.00 AED,10.00,9.8000,0.2000,566283167,1611027,Success,United Arab Emirates,DU UAE,Transguard Group LLC,API User,E6AEAE22430
2022-02-26 12:11,73126738,"35,650.8660","35,641.0660",10.00 AED,10.00,9.8000,0.2000,566283386,1611031,Success,United Arab Emirates,DU UAE,Transguard Group LLC,API User,E6AEAE22430
2022-02-26 12:18,73126973,"35,641.0660","35,631.2660",10.00 AED,10.00,9.8000,0.2000,566283978,1611056,Success,United Arab Emirates,DU UAE,Transguard Group LLC,API User,E6AEAE22430
2022-02-26 12:24,73127142,"35,631.2660","35,626.3660",05.00 AED,5.00,4.9000,0.1000,566284440,1611062,Success,United Arab Emirates,DU UAE,Transguard Group LLC,API User,E6AEAE17361
2022-02-26 12:27,73127264,"35,626.3660","35,621.4660",05.00 AED,5.00,4.9000,0.1000,566284746,1611072,Success,United Arab Emirates,DU UAE,Transguard Group LLC,API User,E6AEAE17361
2022-02-26 12:28,73127279,"35,621.4660","35,611.6660",10.00 AED,10.00,9.8000,0.2000,566284788,1611078,Success,United Arab Emirates,DU UAE,Transguard Group LLC,API User,E6AEAE22430
2022-02-26 12:32,73127425,"35,611.6660","35,606.7660",05.00 AED,5.00,4.9000,0.1000,566285180,1611087,Success,United Arab Emirates,DU UAE,Transguard Group LLC,API User,E6AEAE17361
2022-02-26 12:39,73127633,"35,606.7660","35,602.3660",118.00 KES,5.00,4.4000,0.6000,566285747,1611103,Success,Kenya,Safaricom Kenya (Airtime Recharge),Transguard Group LLC,API User,KE_SA_TopUp
2022-02-26 12:39,73127636,"35,602.3660","35,592.5660",10.00 AED,10.00,9.8000,0.2000,566285750,1611104,Success,United Arab Emirates,DU UAE,Transguard Group LLC,API User,E6AEAE22430
2022-02-26 12:49,73128005,"35,592.5660","35,582.7660",10.00 AED,10.00,9.8000,0.2000,566286688,1611110,Success,United Arab Emirates,DU UAE,Transguard Group LLC,API User,E6AEAE22430
2022-02-26 12:52,73128100,"35,582.7660","35,572.9660",10.00 AED,10.00,9.8000,0.2000,566286938,1611118,Success,United Arab Emirates,DU UAE,Transguard Group LLC,API User,E6AEAE22430
2022-02-26 12:53,73128139,"35,572.9660","35,553.3660",20.00 AED,20.00,19.6000,0.4000,566287049,1611121,Success,United Arab Emirates,DU UAE,Transguard Group LLC,API User,E6AEAE12938
2022-02-26 12:53,73128163,"35,553.3660","35,548.4660",05.00 AED,5.00,4.9000,0.1000,566287107,1611127,Success,United Arab Emirates,DU UAE,Transguard Group LLC,API User,E6AEAE17361
2022-02-26 12:54,73128196,"35,548.4660","35,543.5660",05.00 AED,5.00,4.9000,0.1000,566287193,1611131,Success,United Arab Emirates,DU UAE,Transguard Group LLC,API User,E6AEAE17361
2022-02-26 12:58,73128331,"35,543.5660","35,538.6660",05.00 AED,5.00,4.9000,0.1000,566287549,1611137,Success,United Arab Emirates,DU UAE,Transguard Group LLC,API User,E6AEAE17361
2022-02-26 13:01,73128412,"35,538.6660","35,533.7660",05.00 AED,5.00,4.9000,0.1000,566287765,1611148,Success,United Arab Emirates,DU UAE,Transguard Group LLC,API User,E6AEAE17361
2022-02-26 13:01,73128417,"35,533.7660","35,528.8660",05.00 AED,5.00,4.9000,0.1000,566287776,1611151,Success,United Arab Emirates,DU UAE,Transguard Group LLC,API User,E6AEAE17361
2022-02-26 13:01,73128419,"35,528.8660","35,523.9660",05.00 AED,5.00,4.9000,0.1000,566287782,1611152,Success,United Arab Emirates,DU UAE,Transguard Group LLC,API User,E6AEAE17361
2022-02-26 13:02,73128449,"35,523.9660","35,519.0660",05.00 AED,5.00,4.9000,0.1000,566287843,1611158,Success,United Arab Emirates,DU UAE,Transguard Group LLC,API User,E6AEAE17361
2022-02-26 13:04,73128542,"35,519.0660","35,514.1660",05.00 AED,5.00,4.9000,0.1000,566288127,1611162,Success,United Arab Emirates,DU UAE,Transguard Group LLC,API User,E6AEAE17361
2022-02-26 13:05,73128578,"35,514.1660","35,504.3660",10.00 AED,10.00,9.8000,0.2000,566288227,1611165,Success,United Arab Emirates,DU UAE,Transguard Group LLC,API User,E6AEAE22430
2022-02-26 13:06,73128617,"35,504.3660","35,499.4660",05.00 AED,5.00,4.9000,0.1000,566288346,1611168,Success,United Arab Emirates,DU UAE,Transguard Group LLC,API User,E6AEAE17361
2022-02-26 13:11,73128764,"35,499.4660","35,470.0660",30.00 AED,30.00,29.4000,0.6000,566288782,1611171,Success,United Arab Emirates,DU UAE,Transguard Group LLC,API User,E6AEAE46146
2022-02-26 13:15,73128894,"35,470.0660","35,430.8660",40.00 AED,40.00,39.2000,0.8000,566289146,1611177,Success,United Arab Emirates,DU UAE,Transguard Group LLC,API User,E6AEAE64011
2022-02-26 13:17,73128987,"35,430.8660","35,411.2660",20.00 AED,20.00,19.6000,0.4000,566289347,1611183,Success,United Arab Emirates,DU UAE,Transguard Group LLC,API User,E6AEAE12938
2022-02-26 13:18,73129053,"35,411.2660","35,406.3660",05.00 AED,5.00,4.9000,0.1000,566289500,1611188,Success,United Arab Emirates,DU UAE,Transguard Group LLC,API User,E6AEAE17361
2022-02-26 13:19,73129067,"35,406.3660","35,398.4460",220.00 NPR,9.00,7.9200,1.0800,566289534,1611189,Success,Nepal,Ncell Nepal,Transguard Group LLC,API User,NCNPNP79518
2022-02-26 13:22,73129183,"35,398.4460","35,393.5460",05.00 AED,5.00,4.9000,0.1000,566289852,1611193,Success,United Arab Emirates,DU UAE,Transguard Group LLC,API User,E6AEAE17361
2022-02-26 13:24,73129265,"35,393.5460","35,388.6460",05.00 AED,5.00,4.9000,0.1000,566290062,1611202,Success,United Arab Emirates,DU UAE,Transguard Group LLC,API User,E6AEAE17361
2022-02-26 13:40,73129823,"35,388.6460","35,383.7460",05.00 AED,5.00,4.9000,0.1000,566291512,1611213,Success,United Arab Emirates,DU UAE,Transguard Group LLC,API User,E6AEAE17361
2022-02-26 13:40,73129852,"35,383.7460","35,378.8460",05.00 AED,5.00,4.9000,0.1000,566291571,1611216,Success,United Arab Emirates,DU UAE,Transguard Group LLC,API User,E6AEAE17361
2022-02-26 13:42,73129912,"35,378.8460","35,373.9460",05.00 AED,5.00,4.9000,0.1000,566291704,1611219,Success,United Arab Emirates,DU UAE,Transguard Group LLC,API User,E6AEAE17361
2022-02-26 13:45,73130042,"35,373.9460","35,364.1460",10.00 AED,10.00,9.8000,0.2000,566292027,1611229,Success,United Arab Emirates,DU UAE,Transguard Group LLC,API User,E6AEAE22430
2022-02-26 13:52,73130292,"35,364.1460","35,356.8860",200.00 NPR,8.25,7.2600,0.9900,566292673,1611242,Success,Nepal,Nepal Telecom Nepal,Transguard Group LLC,API User,NP_NE_TopUp_200.00
2022-02-26 13:57,73130449,"35,356.8860","35,347.0860",10.00 AED,10.00,9.8000,0.2000,566293178,1611247,Success,United Arab Emirates,DU UAE,Transguard Group LLC,API User,E6AEAE22430
2022-02-26 13:58,73130460,"35,347.0860","35,337.2860",10.00 AED,10.00,9.8000,0.2000,566293208,1611249,Success,United Arab Emirates,DU UAE,Transguard Group LLC,API User,E6AEAE22430
2022-02-26 13:59,73130514,"35,337.2860","35,333.5460",100.00 NPR,4.25,3.7400,0.5100,566293356,1611254,Success,Nepal,Ncell Nepal,Transguard Group LLC,API User,NP_NC_TopUp_100.00
2022-02-26 14:13,73131023,"35,333.5460","35,328.6460",05.00 AED,5.00,4.9000,0.1000,566294762,1611262,Success,United Arab Emirates,DU UAE,Transguard Group LLC,API User,E6AEAE17361
2022-02-26 14:21,73131276,"35,328.6460","35,318.8460",10.00 AED,10.00,9.8000,0.2000,566295521,1611266,Success,United Arab Emirates,DU UAE,Transguard Group LLC,API User,E6AEAE22430
2022-02-26 14:22,73131318,"35,318.8460","35,313.9460",05.00 AED,5.00,4.9000,0.1000,566295635,1611269,Success,United Arab Emirates,DU UAE,Transguard Group LLC,API User,E6AEAE17361
2022-02-26 14:23,73131379,"35,313.9460","35,306.0260",220.00 NPR,9.00,7.9200,1.0800,566295809,1611276,Success,Nepal,Ncell Nepal,Transguard Group LLC,API User,NCNPNP79518
2022-02-26 14:24,73131404,"35,306.0260","35,296.2260",10.00 AED,10.00,9.8000,0.2000,566295868,1611280,Success,United Arab Emirates,DU UAE,Transguard Group LLC,API User,E6AEAE22430
2022-02-26 14:27,73131486,"35,296.2260","35,276.6260",20.00 AED,20.00,19.6000,0.4000,566296102,1611287,Success,United Arab Emirates,DU UAE,Transguard Group LLC,API User,E6AEAE12938
2022-02-26 14:32,73131687,"35,276.6260","35,257.0260",20.00 AED,20.00,19.6000,0.4000,566296710,1611293,Success,United Arab Emirates,DU UAE,Transguard Group LLC,API User,E6AEAE12938
2022-02-26 14:46,73132174,"35,257.0260","35,252.6260",118.00 KES,5.00,4.4000,0.6000,566298042,1611306,Success,Kenya,Safaricom Kenya (Airtime Recharge),Transguard Group LLC,API User,KE_SA_TopUp
2022-02-26 14:49,73132280,"35,252.6260","35,247.7260",05.00 AED,5.00,4.9000,0.1000,566298392,1611311,Success,United Arab Emirates,DU UAE,Transguard Group LLC,API User,E6AEAE17361
2022-02-26 14:55,73132485,"35,247.7260","35,228.1260",20.00 AED,20.00,19.6000,0.4000,566298961,1611324,Success,United Arab Emirates,DU UAE,Transguard Group LLC,API User,E6AEAE12938
2022-02-26 14:58,73132583,"35,228.1260","35,223.2260",05.00 AED,5.00,4.9000,0.1000,566299272,1611327,Success,United Arab Emirates,DU UAE,Transguard Group LLC,API User,E6AEAE17361
2022-02-26 15:04,73132763,"35,223.2260","35,218.3260",05.00 AED,5.00,4.9000,0.1000,566299865,1611335,Success,United Arab Emirates,DU UAE,Transguard Group LLC,API User,E6AEAE17361
2022-02-26 15:10,73132958,"35,218.3260","35,198.7260",20.00 AED,20.00,19.6000,0.4000,566300508,1611344,Success,United Arab Emirates,DU UAE,Transguard Group LLC,API User,E6AEAE12938
2022-02-26 15:17,73133211,"35,198.7260","35,188.9260",10.00 AED,10.00,9.8000,0.2000,566301193,1611350,Success,United Arab Emirates,DU UAE,Transguard Group LLC,API User,E6AEAE22430
2022-02-26 15:30,73133655,"35,188.9260","35,184.0260",05.00 AED,5.00,4.9000,0.1000,566302582,1611371,Success,United Arab Emirates,DU UAE,Transguard Group LLC,API User,E6AEAE17361
2022-02-26 15:31,73133683,"35,184.0260","35,179.1260",05.00 AED,5.00,4.9000,0.1000,566302673,73133683,Success,United Arab Emirates,DU UAE,Transguard Group LLC,mohammed.arafath@transguardgroup.com,E6AEAE17361
2022-02-26 15:37,73133893,"35,179.1260","35,159.5260",20.00 AED,20.00,19.6000,0.4000,566303362,1611378,Success,United Arab Emirates,DU UAE,Transguard Group LLC,API User,E6AEAE12938
2022-02-26 15:38,73133940,"35,159.5260","35,155.7860",100.00 NPR,4.25,3.7400,0.5100,566303504,1611382,Success,Nepal,Nepal Telecom Nepal,Transguard Group LLC,API User,NP_NE_TopUp_100.00
2022-02-26 15:41,73134014,"35,155.7860","35,150.8860",05.00 AED,5.00,4.9000,0.1000,566303724,1611386,Success,United Arab Emirates,DU UAE,Transguard Group LLC,API User,E6AEAE17361
2022-02-26 15:42,73134052,"35,150.8860","35,142.0860",100.00 PHP,10.00,8.8000,1.2000,566303857,1611391,Success,Philippines,BS_Globe Philippines,Transguard Group LLC,API User,PH_GB_TopUp_100.00
2022-02-26 15:43,73134093,"35,142.0860","35,132.2860",10.00 AED,10.00,9.8000,0.2000,566303980,1611394,Success,United Arab Emirates,DU UAE,Transguard Group LLC,API User,E6AEAE22430
2022-02-26 15:50,73134367,"35,132.2860","35,127.3860",05.00 AED,5.00,4.9000,0.1000,566304779,1611403,Success,United Arab Emirates,DU UAE,Transguard Group LLC,API User,E6AEAE17361
2022-02-26 15:54,73134510,"35,127.3860","35,122.4860",05.00 AED,5.00,4.9000,0.1000,566305247,1611408,Success,United Arab Emirates,DU UAE,Transguard Group LLC,API User,E6AEAE17361
2022-02-26 16:00,73134700,"35,122.4860","35,117.5860",05.00 AED,5.00,4.9000,0.1000,566305885,1611416,Success,United Arab Emirates,DU UAE,Transguard Group LLC,API User,E6AEAE17361
2022-02-26 16:01,73134737,"35,117.5860","35,107.7860",10.00 AED,10.00,9.8000,0.2000,566306011,1611421,Success,United Arab Emirates,DU UAE,Transguard Group LLC,API User,E6AEAE22430
2022-02-26 16:01,73134738,"35,107.7860","35,102.8860",05.00 AED,5.00,4.9000,0.1000,566306019,1611422,Success,United Arab Emirates,DU UAE,Transguard Group LLC,API User,E6AEAE17361
2022-02-26 16:02,73134792,"35,102.8860","35,097.9860",05.00 AED,5.00,4.9000,0.1000,566306156,1611425,Success,United Arab Emirates,DU UAE,Transguard Group LLC,API User,E6AEAE17361
2022-02-26 16:05,73134909,"35,097.9860","35,058.7860",40.00 AED,40.00,39.2000,0.8000,566306480,1611434,Success,United Arab Emirates,DU UAE,Transguard Group LLC,API User,E6AEAE64011
2022-02-26 16:06,73134960,"35,058.7860","35,019.5860",40.00 AED,40.00,39.2000,0.8000,566306645,1611437,Success,United Arab Emirates,DU UAE,Transguard Group LLC,API User,E6AEAE64011
2022-02-26 16:09,73135044,"35,019.5860","35,014.6860",05.00 AED,5.00,4.9000,0.1000,566306945,1611443,Success,United Arab Emirates,DU UAE,Transguard Group LLC,API User,E6AEAE17361
2022-02-26 16:09,73135060,"35,014.6860","35,004.8860",10.00 AED,10.00,9.8000,0.2000,566306988,1611447,Success,United Arab Emirates,DU UAE,Transguard Group LLC,API User,E6AEAE22430
2022-02-26 16:10,73135078,"35,004.8860","35,000.4860",01.09 USD,5.00,4.4000,0.6000,566307045,1611451,Success,Afghanistan,MTN Afghanistan,Transguard Group LLC,API User,AF_MT_TopUp
2022-02-26 16:13,73135194,"35,000.4860","34,980.8860",20.00 AED,20.00,19.6000,0.4000,566307419,1611456,Success,United Arab Emirates,DU UAE,Transguard Group LLC,API User,E6AEAE12938
2022-02-26 16:13,73135209,"34,980.8860","34,975.9860",05.00 AED,5.00,4.9000,0.1000,566307456,1611458,Success,United Arab Emirates,DU UAE,Transguard Group LLC,API User,E6AEAE17361
2022-02-26 16:15,73135265,"34,975.9860","34,966.1860",10.00 AED,10.00,9.8000,0.2000,566307677,1611463,Success,United Arab Emirates,DU UAE,Transguard Group LLC,API User,E6AEAE22430
2022-02-26 16:21,73135525,"34,966.1860","34,961.2860",05.00 AED,5.00,4.9000,0.1000,566308453,1611470,Success,United Arab Emirates,DU UAE,Transguard Group LLC,API User,E6AEAE17361
2022-02-26 16:24,73135677,"34,961.2860","34,958.2060",50.00 INR,3.50,3.0800,0.4200,566308875,1611475,Success,India,Vi India,Transguard Group LLC,API User,VFININ24286
2022-02-26 16:29,73135862,"34,958.2060","34,953.3060",05.00 AED,5.00,4.9000,0.1000,566309426,1611478,Success,United Arab Emirates,DU UAE,Transguard Group LLC,API User,E6AEAE17361
2022-02-26 16:33,73136035,"34,953.3060","34,948.4060",05.00 AED,5.00,4.9000,0.1000,566310004,1611481,Success,United Arab Emirates,DU UAE,Transguard Group LLC,API User,E6AEAE17361
2022-02-26 16:35,73136125,"34,948.4060","34,938.6060",10.00 AED,10.00,9.8000,0.2000,566310267,1611486,Success,United Arab Emirates,DU UAE,Transguard Group LLC,API User,E6AEAE22430
2022-02-26 16:36,73136144,"34,938.6060","34,928.8060",10.00 AED,10.00,9.8000,0.2000,566310345,1611490,Success,United Arab Emirates,DU UAE,Transguard Group LLC,API User,E6AEAE22430
2022-02-26 16:37,73136191,"34,928.8060","34,923.9060",05.00 AED,5.00,4.9000,0.1000,566310504,1611494,Success,United Arab Emirates,DU UAE,Transguard Group LLC,API User,E6AEAE17361
2022-02-26 16:40,73136326,"34,923.9060","34,919.0060",05.00 AED,5.00,4.9000,0.1000,566310916,1611499,Success,United Arab Emirates,DU UAE,Transguard Group LLC,API User,E6AEAE17361
2022-02-26 16:43,73136454,"34,919.0060","34,909.2060",10.00 AED,10.00,9.8000,0.2000,566311277,1611504,Success,United Arab Emirates,DU UAE,Transguard Group LLC,API User,E6AEAE22430
2022-02-26 16:47,73136628,"34,909.2060","34,899.4060",10.00 AED,10.00,9.8000,0.2000,566311802,1611511,Success,United Arab Emirates,DU UAE,Transguard Group LLC,API User,E6AEAE22430
2022-02-26 16:52,73136843,"34,899.4060","34,889.6060",10.00 AED,10.00,9.8000,0.2000,566312536,1611517,Success,United Arab Emirates,DU UAE,Transguard Group LLC,API User,E6AEAE22430
2022-02-26 16:53,73136882,"34,889.6060","34,879.8060",10.00 AED,10.00,9.8000,0.2000,566312657,1611523,Success,United Arab Emirates,DU UAE,Transguard Group LLC,API User,E6AEAE22430
2022-02-26 16:54,73136925,"34,879.8060","34,874.9060",05.00 AED,5.00,4.9000,0.1000,566312826,1611532,Success,United Arab Emirates,DU UAE,Transguard Group LLC,API User,E6AEAE17361
2022-02-26 16:55,73136948,"34,874.9060","34,870.0060",05.00 AED,5.00,4.9000,0.1000,566312883,1611535,Success,United Arab Emirates,DU UAE,Transguard Group LLC,API User,E6AEAE17361
2022-02-26 17:00,73137208,"34,870.0060","34,860.2060",10.00 AED,10.00,9.8000,0.2000,566313642,1611543,Success,United Arab Emirates,DU UAE,Transguard Group LLC,API User,E6AEAE22430
2022-02-26 17:01,73137232,"34,860.2060","34,850.4060",10.00 AED,10.00,9.8000,0.2000,566313724,1611547,Success,United Arab Emirates,DU UAE,Transguard Group LLC,API User,E6AEAE22430
2022-02-26 17:02,73137298,"34,850.4060","34,840.6060",10.00 AED,10.00,9.8000,0.2000,566313934,1611552,Success,United Arab Emirates,DU UAE,Transguard Group LLC,API User,E6AEAE22430
2022-02-26 17:04,73137353,"34,840.6060","34,835.7060",05.00 AED,5.00,4.9000,0.1000,566314117,1611557,Success,United Arab Emirates,DU UAE,Transguard Group LLC,API User,E6AEAE17361
2022-02-26 17:04,73137374,"34,835.7060","34,830.8060",05.00 AED,5.00,4.9000,0.1000,566314190,1611563,Success,United Arab Emirates,DU UAE,Transguard Group LLC,API User,E6AEAE17361
2022-02-26 17:09,73137603,"34,830.8060","34,825.9060",05.00 AED,5.00,4.9000,0.1000,566314932,1611567,Success,United Arab Emirates,DU UAE,Transguard Group LLC,API User,E6AEAE17361
2022-02-26 17:14,73137833,"34,825.9060","34,816.1060",10.00 AED,10.00,9.8000,0.2000,566315588,1611579,Success,United Arab Emirates,DU UAE,Transguard Group LLC,API User,E6AEAE22430
2022-02-26 17:14,73137848,"34,816.1060","34,811.2060",05.00 AED,5.00,4.9000,0.1000,566315651,1611581,Success,United Arab Emirates,DU UAE,Transguard Group LLC,API User,E6AEAE17361
2022-02-26 17:21,73138126,"34,811.2060","34,806.3060",05.00 AED,5.00,4.9000,0.1000,566316565,1611592,Success,United Arab Emirates,DU UAE,Transguard Group LLC,API User,E6AEAE17361
2022-02-26 17:21,73138143,"34,806.3060","34,796.5060",10.00 AED,10.00,9.8000,0.2000,566316626,1611596,Success,United Arab Emirates,DU UAE,Transguard Group LLC,API User,E6AEAE22430
2022-02-26 17:23,73138214,"34,796.5060","34,791.6060",05.00 AED,5.00,4.9000,0.1000,566316867,1611600,Success,United Arab Emirates,DU UAE,Transguard Group LLC,API User,E6AEAE17361
2022-02-26 17:27,73138409,"34,791.6060","34,786.7060",05.00 AED,5.00,4.9000,0.1000,566317465,1611605,Success,United Arab Emirates,DU UAE,Transguard Group LLC,API User,E6AEAE17361
2022-02-26 17:34,73138718,"34,786.7060","34,776.9060",10.00 AED,10.00,9.8000,0.2000,566318555,1611611,Success,United Arab Emirates,DU UAE,Transguard Group LLC,API User,E6AEAE22430
2022-02-26 17:35,73138772,"34,776.9060","34,772.0060",05.00 AED,5.00,4.9000,0.1000,566318754,1611614,Success,United Arab Emirates,DU UAE,Transguard Group LLC,API User,E6AEAE17361
2022-02-26 17:38,73138927,"34,772.0060","34,763.6460",300.00 PKR,9.50,8.3600,1.1400,566319290,1611617,Success,Pakistan,Ufone Pakistan,Transguard Group LLC,API User,PK_UF_TopUp_300.00
2022-02-26 17:41,73139077,"34,763.6460","34,758.7460",05.00 AED,5.00,4.9000,0.1000,566319729,1611625,Success,United Arab Emirates,DU UAE,Transguard Group LLC,API User,E6AEAE17361
2022-02-26 17:41,73139087,"34,758.7460","34,748.9460",10.00 AED,10.00,9.8000,0.2000,566319748,1611627,Success,United Arab Emirates,DU UAE,Transguard Group LLC,API User,E6AEAE22430
2022-02-26 17:43,73139205,"34,748.9460","34,744.0460",05.00 AED,5.00,4.9000,0.1000,566320119,1611633,Success,United Arab Emirates,DU UAE,Transguard Group LLC,API User,E6AEAE17361
2022-02-26 17:43,73139209,"34,744.0460","34,739.1460",05.00 AED,5.00,4.9000,0.1000,566320133,1611634,Success,United Arab Emirates,DU UAE,Transguard Group LLC,API User,E6AEAE17361
2022-02-26 17:44,73139226,"34,739.1460","34,734.2460",05.00 AED,5.00,4.9000,0.1000,566320182,1611636,Success,United Arab Emirates,DU UAE,Transguard Group LLC,API User,E6AEAE17361
2022-02-26 17:54,73139798,"34,734.2460","34,729.3460",05.00 AED,5.00,4.9000,0.1000,566321993,1611648,Success,United Arab Emirates,DU UAE,Transguard Group LLC,API User,E6AEAE17361
2022-02-26 17:59,73140109,"34,729.3460","34,724.4460",05.00 AED,5.00,4.9000,0.1000,566322845,1611655,Success,United Arab Emirates,DU UAE,Transguard Group LLC,API User,E6AEAE17361
2022-02-26 18:02,73140230,"34,724.4460","34,685.2460",40.00 AED,40.00,39.2000,0.8000,566323306,1611660,Success,United Arab Emirates,DU UAE,Transguard Group LLC,API User,E6AEAE64011
2022-02-26 18:13,73140878,"34,685.2460","34,680.3460",05.00 AED,5.00,4.9000,0.1000,566325280,1611670,Success,United Arab Emirates,DU UAE,Transguard Group LLC,API User,E6AEAE17361
2022-02-26 18:15,73140997,"34,680.3460","34,670.5460",10.00 AED,10.00,9.8000,0.2000,566325721,1611678,Success,United Arab Emirates,DU UAE,Transguard Group LLC,API User,E6AEAE22430
2022-02-26 18:16,73141034,"34,670.5460","34,665.6460",05.00 AED,5.00,4.9000,0.1000,566325831,1611686,Success,United Arab Emirates,DU UAE,Transguard Group LLC,API User,E6AEAE17361
2022-02-26 18:18,73141154,"34,665.6460","34,660.7460",05.00 AED,5.00,4.9000,0.1000,566326194,1611693,Success,United Arab Emirates,DU UAE,Transguard Group LLC,API User,E6AEAE17361
2022-02-26 18:19,73141213,"34,660.7460","34,655.8460",05.00 AED,5.00,4.9000,0.1000,566326388,1611698,Success,United Arab Emirates,DU UAE,Transguard Group LLC,API User,E6AEAE17361
2022-02-26 18:21,73141339,"34,655.8460","34,646.0460",10.00 AED,10.00,9.8000,0.2000,566326799,1611705,Success,United Arab Emirates,DU UAE,Transguard Group LLC,API User,E6AEAE22430
2022-02-26 18:26,73141589,"34,646.0460","34,641.1460",05.00 AED,5.00,4.9000,0.1000,566327597,1611718,Success,United Arab Emirates,DU UAE,Transguard Group LLC,API User,E6AEAE17361
2022-02-26 18:28,73141718,"34,641.1460","34,636.2460",05.00 AED,5.00,4.9000,0.1000,566327962,1611721,Success,United Arab Emirates,DU UAE,Transguard Group LLC,API User,E6AEAE17361
2022-02-26 18:30,73141830,"34,636.2460","34,631.3460",05.00 AED,5.00,4.9000,0.1000,566328347,1611728,Success,United Arab Emirates,DU UAE,Transguard Group LLC,API User,E6AEAE17361
2022-02-26 18:30,73141858,"34,631.3460","34,621.5460",10.00 AED,10.00,9.8000,0.2000,566328424,1611732,Success,United Arab Emirates,DU UAE,Transguard Group LLC,API User,E6AEAE22430
2022-02-26 18:31,73141906,"34,621.5460","34,611.7460",10.00 AED,10.00,9.8000,0.2000,566328575,1611734,Success,United Arab Emirates,DU UAE,Transguard Group LLC,API User,E6AEAE22430
2022-02-26 18:38,73142291,"34,611.7460","34,606.8460",05.00 AED,5.00,4.9000,0.1000,566329785,1611739,Success,United Arab Emirates,DU UAE,Transguard Group LLC,API User,E6AEAE17361
2022-02-26 18:39,73142382,"34,606.8460","34,601.9460",05.00 AED,5.00,4.9000,0.1000,566330002,1611742,Success,United Arab Emirates,DU UAE,Transguard Group LLC,API User,E6AEAE17361
2022-02-26 18:42,73142548,"34,601.9460","34,592.1460",10.00 AED,10.00,9.8000,0.2000,566330532,1611754,Success,United Arab Emirates,DU UAE,Transguard Group LLC,API User,E6AEAE22430
2022-02-26 18:46,73142786,"34,592.1460","34,582.3460",10.00 AED,10.00,9.8000,0.2000,566331280,1611763,Success,United Arab Emirates,DU UAE,Transguard Group LLC,API User,E6AEAE22430
2022-02-26 18:46,73142788,"34,582.3460","34,577.4460",05.00 AED,5.00,4.9000,0.1000,566331282,1611764,Success,United Arab Emirates,DU UAE,Transguard Group LLC,API User,E6AEAE17361
2022-02-26 18:46,73142838,"34,577.4460","34,567.6460",10.00 AED,10.00,9.8000,0.2000,566331452,1611767,Success,United Arab Emirates,DU UAE,Transguard Group LLC,API User,E6AEAE22430
2022-02-26 18:49,73143049,"34,567.6460","34,562.7460",05.00 AED,5.00,4.9000,0.1000,566332048,1611770,Success,United Arab Emirates,DU UAE,Transguard Group LLC,API User,E6AEAE17361
2022-02-26 18:51,73143169,"34,562.7460","34,552.9460",10.00 AED,10.00,9.8000,0.2000,566332380,1611777,Success,United Arab Emirates,DU UAE,Transguard Group LLC,API User,E6AEAE22430
2022-02-26 18:52,73143241,"34,552.9460","34,545.6860",200.00 NPR,8.25,7.2600,0.9900,566332625,1611782,Success,Nepal,Nepal Telecom Nepal,Transguard Group LLC,API User,NP_NE_TopUp_200.00
2022-02-26 18:53,73143272,"34,545.6860","34,540.7860",05.00 AED,5.00,4.9000,0.1000,566332727,1611785,Success,United Arab Emirates,DU UAE,Transguard Group LLC,API User,E6AEAE17361
2022-02-26 18:56,73143466,"34,540.7860","34,530.9860",10.00 AED,10.00,9.8000,0.2000,566333306,1611792,Success,United Arab Emirates,DU UAE,Transguard Group LLC,API User,E6AEAE22430
2022-02-26 18:57,73143502,"34,530.9860","34,521.1860",10.00 AED,10.00,9.8000,0.2000,566333410,1611799,Success,United Arab Emirates,DU UAE,Transguard Group LLC,API User,E6AEAE22430
2022-02-26 18:57,73143513,"34,521.1860","34,516.2860",05.00 AED,5.00,4.9000,0.1000,566333440,1611800,Success,United Arab Emirates,DU UAE,Transguard Group LLC,API User,E6AEAE17361
2022-02-26 18:58,73143572,"34,516.2860","34,506.4860",10.00 AED,10.00,9.8000,0.2000,566333587,1611803,Success,United Arab Emirates,DU UAE,Transguard Group LLC,API User,E6AEAE22430
2022-02-26 18:58,73143616,"34,506.4860","34,501.5860",05.00 AED,5.00,4.9000,0.1000,566333718,1611806,Success,United Arab Emirates,DU UAE,Transguard Group LLC,API User,E6AEAE17361
2022-02-26 18:59,73143671,"34,501.5860","34,496.6860",05.00 AED,5.00,4.9000,0.1000,566333890,1611811,Success,United Arab Emirates,DU UAE,Transguard Group LLC,API User,E6AEAE17361
2022-02-26 18:59,73143676,"34,496.6860","34,491.7860",05.00 AED,5.00,4.9000,0.1000,566333908,1611812,Success,United Arab Emirates,DU UAE,Transguard Group LLC,API User,E6AEAE17361
2022-02-26 19:00,73143766,"34,491.7860","34,452.5860",40.00 AED,40.00,39.2000,0.8000,566334144,1611818,Success,United Arab Emirates,DU UAE,Transguard Group LLC,API User,E6AEAE64011
2022-02-26 19:06,73144180,"34,452.5860","34,442.7860",10.00 AED,10.00,9.8000,0.2000,566335284,1611833,Success,United Arab Emirates,DU UAE,Transguard Group LLC,API User,E6AEAE22430
2022-02-26 19:08,73144327,"34,442.7860","34,432.9860",10.00 AED,10.00,9.8000,0.2000,566335689,1611837,Success,United Arab Emirates,DU UAE,Transguard Group LLC,API User,E6AEAE22430
2022-02-26 19:13,73144665,"34,432.9860","34,423.1860",10.00 AED,10.00,9.8000,0.2000,566336756,1611857,Success,United Arab Emirates,DU UAE,Transguard Group LLC,API User,E6AEAE22430
2022-02-26 19:15,73144773,"34,423.1860","34,403.5860",20.00 AED,20.00,19.6000,0.4000,566337077,1611865,Success,United Arab Emirates,DU UAE,Transguard Group LLC,API User,E6AEAE12938
2022-02-26 19:17,73144950,"34,403.5860","34,398.6860",05.00 AED,5.00,4.9000,0.1000,566337601,1611873,Success,United Arab Emirates,DU UAE,Transguard Group LLC,API User,E6AEAE17361
2022-02-26 19:22,73145280,"34,398.6860","34,393.7860",05.00 AED,5.00,4.9000,0.1000,566338537,1611889,Success,United Arab Emirates,DU UAE,Transguard Group LLC,API User,E6AEAE17361
2022-02-26 19:24,73145433,"34,393.7860","34,388.8860",05.00 AED,5.00,4.9000,0.1000,566338927,1611903,Success,United Arab Emirates,DU UAE,Transguard Group LLC,API User,E6AEAE17361
2022-02-26 19:24,73145438,"34,388.8860","34,379.0860",10.00 AED,10.00,9.8000,0.2000,566338944,1611904,Success,United Arab Emirates,DU UAE,Transguard Group LLC,API User,E6AEAE22430
2022-02-26 19:25,73145555,"34,379.0860","34,370.7260",300.00 PKR,9.50,8.3600,1.1400,566339318,1611908,Success,Pakistan,Ufone Pakistan,Transguard Group LLC,API User,PK_UF_TopUp_300.00
2022-02-26 19:26,73145595,"34,370.7260","34,360.9260",10.00 AED,10.00,9.8000,0.2000,566339463,1611913,Success,United Arab Emirates,DU UAE,Transguard Group LLC,API User,E6AEAE22430
2022-02-26 19:26,73145600,"34,360.9260","34,356.7460",150.00 PKR,4.75,4.1800,0.5700,566339495,1611914,Success,Pakistan,Ufone Pakistan,Transguard Group LLC,API User,UFPKPK90336
2022-02-26 19:33,73146054,"34,356.7460","34,346.9460",10.00 AED,10.00,9.8000,0.2000,566340881,1611933,Success,United Arab Emirates,DU UAE,Transguard Group LLC,API User,E6AEAE22430
2022-02-26 19:34,73146093,"34,346.9460","34,342.0460",05.00 AED,5.00,4.9000,0.1000,566341014,1611939,Success,United Arab Emirates,DU UAE,Transguard Group LLC,API User,E6AEAE17361
2022-02-26 19:34,73146142,"34,342.0460","34,337.1460",05.00 AED,5.00,4.9000,0.1000,566341153,1611943,Success,United Arab Emirates,DU UAE,Transguard Group LLC,API User,E6AEAE17361
2022-02-26 19:37,73146333,"34,337.1460","34,332.2460",05.00 AED,5.00,4.9000,0.1000,566341802,1611946,Success,United Arab Emirates,DU UAE,Transguard Group LLC,API User,E6AEAE17361
2022-02-26 19:39,73146480,"34,332.2460","34,317.5460",15.00 AED,15.00,14.7000,0.3000,566342216,1611951,Success,United Arab Emirates,DU UAE,Transguard Group LLC,API User,E6AEAE8527
2022-02-26 19:39,73146492,"34,317.5460","34,302.8460",15.00 AED,15.00,14.7000,0.3000,566342264,1611952,Success,United Arab Emirates,DU UAE,Transguard Group LLC,API User,E6AEAE8527
2022-02-26 19:41,73146593,"34,302.8460","34,293.0460",10.00 AED,10.00,9.8000,0.2000,566342588,1611960,Success,United Arab Emirates,DU UAE,Transguard Group LLC,API User,E6AEAE22430
2022-02-26 19:41,73146621,"34,293.0460","34,288.1460",05.00 AED,5.00,4.9000,0.1000,566342675,1611962,Success,United Arab Emirates,DU UAE,Transguard Group LLC,API User,E6AEAE17361
2022-02-26 19:43,73146712,"34,288.1460","34,278.3460",10.00 AED,10.00,9.8000,0.2000,566342963,1611972,Success,United Arab Emirates,DU UAE,Transguard Group LLC,API User,E6AEAE22430
2022-02-26 19:43,73146736,"34,278.3460","34,273.4460",05.00 AED,5.00,4.9000,0.1000,566343027,1611975,Success,United Arab Emirates,DU UAE,Transguard Group LLC,API User,E6AEAE17361
2022-02-26 19:43,73146750,"34,273.4460","34,268.5460",05.00 AED,5.00,4.9000,0.1000,566343064,1611977,Success,United Arab Emirates,DU UAE,Transguard Group LLC,API User,E6AEAE17361
2022-02-26 19:47,73146971,"34,268.5460","34,263.6460",05.00 AED,5.00,4.9000,0.1000,566343743,1611984,Success,United Arab Emirates,DU UAE,Transguard Group LLC,API User,E6AEAE17361
2022-02-26 19:48,73147039,"34,263.6460","34,258.7460",05.00 AED,5.00,4.9000,0.1000,566343958,1611988,Success,United Arab Emirates,DU UAE,Transguard Group LLC,API User,E6AEAE17361
2022-02-26 19:49,73147102,"34,258.7460","34,253.8460",05.00 AED,5.00,4.9000,0.1000,566344179,1611994,Success,United Arab Emirates,DU UAE,Transguard Group LLC,API User,E6AEAE17361
2022-02-26 19:51,73147234,"34,253.8460","34,244.0460",10.00 AED,10.00,9.8000,0.2000,566344660,1612004,Success,United Arab Emirates,DU UAE,Transguard Group LLC,API User,E6AEAE22430
2022-02-26 19:53,73147325,"34,244.0460","34,239.1460",05.00 AED,5.00,4.9000,0.1000,566344936,1612010,Success,United Arab Emirates,DU UAE,Transguard Group LLC,API User,E6AEAE17361
2022-02-26 19:57,73147575,"34,239.1460","34,234.2460",05.00 AED,5.00,4.9000,0.1000,566345690,1612015,Success,United Arab Emirates,DU UAE,Transguard Group LLC,API User,E6AEAE17361
2022-02-26 19:57,73147585,"34,234.2460","34,224.4460",10.00 AED,10.00,9.8000,0.2000,566345723,1612016,Success,United Arab Emirates,DU UAE,Transguard Group LLC,API User,E6AEAE22430
2022-02-26 19:58,73147693,"34,224.4460","34,219.5460",05.00 AED,5.00,4.9000,0.1000,566346065,1612020,Success,United Arab Emirates,DU UAE,Transguard Group LLC,API User,E6AEAE17361
2022-02-26 19:59,73147717,"34,219.5460","34,214.6460",05.00 AED,5.00,4.9000,0.1000,566346112,1612022,Success,United Arab Emirates,DU UAE,Transguard Group LLC,API User,E6AEAE17361
2022-02-26 19:59,73147746,"34,214.6460","34,210.4660",50.00 PHP,4.75,4.1800,0.5700,566346179,1612025,Success,Philippines,Smart (SunCellular) Philippines,Transguard Group LLC,API User,PH_SM_TopUp_50.00
2022-02-26 20:00,73147810,"34,210.4660","34,205.5660",05.00 AED,5.00,4.9000,0.1000,566346351,1612030,Success,United Arab Emirates,DU UAE,Transguard Group LLC,API User,E6AEAE17361
2022-02-26 20:02,73148001,"34,205.5660","34,195.7660",10.00 AED,10.00,9.8000,0.2000,566346866,1612036,Success,United Arab Emirates,DU UAE,Transguard Group LLC,API User,E6AEAE22430
2022-02-26 20:04,73148165,"34,195.7660","34,185.9660",10.00 AED,10.00,9.8000,0.2000,566347413,1612040,Success,United Arab Emirates,DU UAE,Transguard Group LLC,API User,E6AEAE22430
2022-02-26 20:05,73148231,"34,185.9660","34,181.0660",05.00 AED,5.00,4.9000,0.1000,566347625,1612045,Success,United Arab Emirates,DU UAE,Transguard Group LLC,API User,E6AEAE17361
2022-02-26 20:06,73148252,"34,181.0660","34,171.2660",10.00 AED,10.00,9.8000,0.2000,566347682,1612048,Success,United Arab Emirates,DU UAE,Transguard Group LLC,API User,E6AEAE22430
2022-02-26 20:07,73148310,"34,171.2660","34,161.4660",10.00 AED,10.00,9.8000,0.2000,566347869,1612052,Success,United Arab Emirates,DU UAE,Transguard Group LLC,API User,E6AEAE22430
2022-02-26 20:09,73148464,"34,161.4660","34,151.6660",10.00 AED,10.00,9.8000,0.2000,566348339,1612064,Success,United Arab Emirates,DU UAE,Transguard Group LLC,API User,E6AEAE22430
2022-02-26 20:15,73148879,"34,151.6660","34,146.7660",05.00 AED,5.00,4.9000,0.1000,566349648,1612079,Success,United Arab Emirates,DU UAE,Transguard Group LLC,API User,E6AEAE17361
2022-02-26 20:16,73148916,"34,146.7660","34,141.8660",05.00 AED,5.00,4.9000,0.1000,566349778,1612080,Success,United Arab Emirates,DU UAE,Transguard Group LLC,API User,E6AEAE17361
2022-02-26 20:17,73148992,"34,141.8660","34,136.9660",05.00 AED,5.00,4.9000,0.1000,566350033,1612083,Success,United Arab Emirates,DU UAE,Transguard Group LLC,API User,E6AEAE17361
2022-02-26 20:18,73149090,"34,136.9660","34,127.1660",10.00 AED,10.00,9.8000,0.2000,566350338,1612089,Success,United Arab Emirates,DU UAE,Transguard Group LLC,API User,E6AEAE22430
2022-02-26 20:20,73149225,"34,127.1660","34,117.3660",10.00 AED,10.00,9.8000,0.2000,566350755,1612092,Success,United Arab Emirates,DU UAE,Transguard Group LLC,API User,E6AEAE22430
2022-02-26 20:24,73149440,"34,117.3660","34,112.4660",05.00 AED,5.00,4.9000,0.1000,566351475,1612099,Success,United Arab Emirates,DU UAE,Transguard Group LLC,API User,E6AEAE17361
2022-02-26 20:28,73149732,"34,112.4660","34,102.6660",10.00 AED,10.00,9.8000,0.2000,566352409,1612109,Success,United Arab Emirates,DU UAE,Transguard Group LLC,API User,E6AEAE22430
2022-02-26 20:29,73149774,"34,102.6660","34,097.7660",05.00 AED,5.00,4.9000,0.1000,566352586,1612115,Failure,United Arab Emirates,DU UAE,Transguard Group LLC,API User,E6AEAE17361
2022-02-26 20:29,73149774,"34,097.7660","34,092.8660",05.00 AED,5.00,4.9000,0.1000,566352586,1612115,Failure,United Arab Emirates,DU UAE,Transguard Group LLC,API User,E6AEAE17361
2022-02-26 20:30,73149829,"34,102.6660","34,092.8660",10.00 AED,10.00,9.8000,0.2000,566352743,1612119,Success,United Arab Emirates,DU UAE,Transguard Group LLC,API User,E6AEAE22430
2022-02-26 20:30,73149866,"34,092.8660","34,083.0660",10.00 AED,10.00,9.8000,0.2000,566352874,1612122,Success,United Arab Emirates,DU UAE,Transguard Group LLC,API User,E6AEAE22430
2022-02-26 20:31,73149901,"34,083.0660","34,073.2660",10.00 AED,10.00,9.8000,0.2000,566353005,1612125,Success,United Arab Emirates,DU UAE,Transguard Group LLC,API User,E6AEAE22430
2022-02-26 20:33,73150005,"34,073.2660","34,063.4660",10.00 AED,10.00,9.8000,0.2000,566353369,1612131,Success,United Arab Emirates,DU UAE,Transguard Group LLC,API User,E6AEAE22430
2022-02-26 20:35,73150161,"34,063.4660","34,043.8660",20.00 AED,20.00,19.6000,0.4000,566353833,1612139,Success,United Arab Emirates,DU UAE,Transguard Group LLC,API User,E6AEAE12938
2022-02-26 20:37,73150271,"34,043.8660","34,034.0660",10.00 AED,10.00,9.8000,0.2000,566354192,1612144,Success,United Arab Emirates,DU UAE,Transguard Group LLC,API User,E6AEAE22430
2022-02-26 20:38,73150328,"34,034.0660","34,024.2660",10.00 AED,10.00,9.8000,0.2000,566354352,1612149,Success,United Arab Emirates,DU UAE,Transguard Group LLC,API User,E6AEAE22430
2022-02-26 20:39,73150404,"34,024.2660","34,019.3660",05.00 AED,5.00,4.9000,0.1000,566354623,1612154,Success,United Arab Emirates,DU UAE,Transguard Group LLC,API User,E6AEAE17361
2022-02-26 20:41,73150485,"34,019.3660","34,009.5660",10.00 AED,10.00,9.8000,0.2000,566354937,1612158,Success,United Arab Emirates,DU UAE,Transguard Group LLC,API User,E6AEAE22430
2022-02-26 20:41,73150512,"34,009.5660","34,002.3060",200.00 NPR,8.25,7.2600,0.9900,566355038,1612163,Success,Nepal,Nepal Telecom Nepal,Transguard Group LLC,API User,NP_NE_TopUp_200.00
2022-02-26 20:42,73150529,"34,002.3060","33,997.4060",05.00 AED,5.00,4.9000,0.1000,566355079,1612165,Success,United Arab Emirates,DU UAE,Transguard Group LLC,API User,E6AEAE17361
2022-02-26 20:42,73150592,"33,997.4060","33,987.6060",10.00 AED,10.00,9.8000,0.2000,566355270,1612168,Success,United Arab Emirates,DU UAE,Transguard Group LLC,API User,E6AEAE22430
2022-02-26 20:44,73150694,"33,987.6060","33,982.7060",05.00 AED,5.00,4.9000,0.1000,566355620,1612171,Success,United Arab Emirates,DU UAE,Transguard Group LLC,API User,E6AEAE17361
2022-02-26 20:46,73150783,"33,982.7060","33,977.8060",05.00 AED,5.00,4.9000,0.1000,566355980,1612174,Success,United Arab Emirates,DU UAE,Transguard Group LLC,API User,E6AEAE17361
2022-02-26 20:49,73150966,"33,977.8060","33,933.7060",45.00 AED,45.00,44.1000,0.9000,566356640,1612181,Success,United Arab Emirates,DU UAE,Transguard Group LLC,API User,E6AEAE35243
2022-02-26 20:54,73151265,"33,933.7060","33,928.8060",05.00 AED,5.00,4.9000,0.1000,566357566,1612194,Success,United Arab Emirates,DU UAE,Transguard Group LLC,API User,E6AEAE17361
2022-02-26 20:54,73151269,"33,928.8060","33,923.9060",05.00 AED,5.00,4.9000,0.1000,566357584,1612195,Success,United Arab Emirates,DU UAE,Transguard Group LLC,API User,E6AEAE17361
2022-02-26 20:57,73151431,"33,923.9060","33,919.0060",05.00 AED,5.00,4.9000,0.1000,566358109,1612201,Success,United Arab Emirates,DU UAE,Transguard Group LLC,API User,E6AEAE17361
2022-02-26 21:04,73151945,"33,919.0060","33,914.1060",05.00 AED,5.00,4.9000,0.1000,566359682,1612219,Success,United Arab Emirates,DU UAE,Transguard Group LLC,API User,E6AEAE17361
2022-02-26 21:08,73152207,"33,914.1060","33,909.2060",05.00 AED,5.00,4.9000,0.1000,566360399,1612226,Success,United Arab Emirates,DU UAE,Transguard Group LLC,API User,E6AEAE17361
2022-02-26 21:13,73152549,"33,909.2060","33,889.6060",20.00 AED,20.00,19.6000,0.4000,566361474,1612236,Success,United Arab Emirates,DU UAE,Transguard Group LLC,API User,E6AEAE12938
2022-02-26 21:13,73152562,"33,889.6060","33,884.7060",05.00 AED,5.00,4.9000,0.1000,566361513,1612238,Success,United Arab Emirates,DU UAE,Transguard Group LLC,API User,E6AEAE17361
2022-02-26 21:14,73152637,"33,884.7060","33,874.9060",10.00 AED,10.00,9.8000,0.2000,566361741,1612243,Success,United Arab Emirates,DU UAE,Transguard Group LLC,API User,E6AEAE22430
2022-02-26 21:15,73152695,"33,874.9060","33,866.1060","7,350.82 UGX",10.00,8.8000,1.2000,566361944,1612247,Success,Uganda,MTN Uganda,Transguard Group LLC,API User,UG_MT_TopUp
2022-02-26 21:16,73152733,"33,866.1060","33,856.3060",10.00 AED,10.00,9.8000,0.2000,566362039,1612250,Success,United Arab Emirates,DU UAE,Transguard Group LLC,API User,E6AEAE22430
2022-02-26 21:18,73152867,"33,856.3060","33,846.5060",10.00 AED,10.00,9.8000,0.2000,566362465,1612257,Success,United Arab Emirates,DU UAE,Transguard Group LLC,API User,E6AEAE22430
2022-02-26 21:20,73152981,"33,846.5060","33,841.6060",05.00 AED,5.00,4.9000,0.1000,566362843,1612260,Success,United Arab Emirates,DU UAE,Transguard Group LLC,API User,E6AEAE17361
2022-02-26 21:26,73153371,"33,841.6060","33,836.7060",05.00 AED,5.00,4.9000,0.1000,566363973,1612270,Success,United Arab Emirates,DU UAE,Transguard Group LLC,API User,E6AEAE17361
2022-02-26 21:29,73153586,"33,836.7060","33,832.5260",150.00 PKR,4.75,4.1800,0.5700,566364597,1612277,Success,Pakistan,Jazz Pakistan,Transguard Group LLC,API User,MBPKPK20699
2022-02-26 21:37,73154073,"33,832.5260","33,793.3260",40.00 AED,40.00,39.2000,0.8000,566366082,1612283,Success,United Arab Emirates,DU UAE,Transguard Group LLC,API User,E6AEAE64011
2022-02-26 21:38,73154165,"33,793.3260","33,783.5260",10.00 AED,10.00,9.8000,0.2000,566366370,1612286,Success,United Arab Emirates,DU UAE,Transguard Group LLC,API User,E6AEAE22430
2022-02-26 21:40,73154306,"33,783.5260","33,773.7260",10.00 AED,10.00,9.8000,0.2000,566366748,1612292,Success,United Arab Emirates,DU UAE,Transguard Group LLC,API User,E6AEAE22430
2022-02-26 21:41,73154409,"33,773.7260","33,763.9260",10.00 AED,10.00,9.8000,0.2000,566367083,1612298,Success,United Arab Emirates,DU UAE,Transguard Group LLC,API User,E6AEAE22430
2022-02-26 21:42,73154482,"33,763.9260","33,754.1260",10.00 AED,10.00,9.8000,0.2000,566367268,1612301,Success,United Arab Emirates,DU UAE,Transguard Group LLC,API User,E6AEAE22430
2022-02-26 21:47,73154739,"33,754.1260","33,749.2260",05.00 AED,5.00,4.9000,0.1000,566368138,1612308,Success,United Arab Emirates,DU UAE,Transguard Group LLC,API User,E6AEAE17361
2022-02-26 21:52,73155044,"33,749.2260","33,744.3260",05.00 AED,5.00,4.9000,0.1000,566369067,1612316,Success,United Arab Emirates,DU UAE,Transguard Group LLC,API User,E6AEAE17361
2022-02-26 21:52,73155084,"33,744.3260","33,739.4260",05.00 AED,5.00,4.9000,0.1000,566369204,1612320,Success,United Arab Emirates,DU UAE,Transguard Group LLC,API User,E6AEAE17361
2022-02-26 21:54,73155171,"33,739.4260","33,734.5260",05.00 AED,5.00,4.9000,0.1000,566369512,1612323,Success,United Arab Emirates,DU UAE,Transguard Group LLC,API User,E6AEAE17361
2022-02-26 21:56,73155281,"33,734.5260","33,729.6260",05.00 AED,5.00,4.9000,0.1000,566369950,1612328,Success,United Arab Emirates,DU UAE,Transguard Group LLC,API User,E6AEAE17361
2022-02-26 21:58,73155396,"33,729.6260","33,716.4260",355.00 KES,15.00,13.2000,1.8000,566370301,1612333,Success,Kenya,Safaricom Kenya (Airtime Recharge),Transguard Group LLC,API User,KE_SA_TopUp
2022-02-26 22:01,73155569,"33,716.4260","33,696.8260",20.00 AED,20.00,19.6000,0.4000,566370893,1612336,Success,United Arab Emirates,DU UAE,Transguard Group LLC,API User,E6AEAE12938
2022-02-26 22:02,73155603,"33,696.8260","33,691.9260",05.00 AED,5.00,4.9000,0.1000,566370987,1612340,Success,United Arab Emirates,DU UAE,Transguard Group LLC,API User,E6AEAE17361
2022-02-26 22:02,73155619,"33,691.9260","33,682.1260",10.00 AED,10.00,9.8000,0.2000,566371034,1612342,Success,United Arab Emirates,DU UAE,Transguard Group LLC,API User,E6AEAE22430
2022-02-26 22:12,73156141,"33,682.1260","33,667.6060",400.00 NPR,16.50,14.5200,1.9800,566372856,1612357,Success,Nepal,Nepal Telecom Nepal,Transguard Group LLC,API User,NENPNP18292
2022-02-26 22:17,73156354,"33,667.6060","33,663.8660",100.00 NPR,4.25,3.7400,0.5100,566373598,1612369,Success,Nepal,Nepal Telecom Nepal,Transguard Group LLC,API User,NP_NE_TopUp_100.00
2022-02-26 22:22,73156588,"33,663.8660","33,655.5060",100.00 PHP,9.50,8.3600,1.1400,566374598,1612379,Success,Philippines,Smart (SunCellular) Philippines,Transguard Group LLC,API User,PH_SM_TopUp_100.00
2022-02-26 22:23,73156602,"33,655.5060","33,650.6060",05.00 AED,5.00,4.9000,0.1000,566374662,1612381,Success,United Arab Emirates,DU UAE,Transguard Group LLC,API User,E6AEAE17361
2022-02-26 22:26,73156721,"33,650.6060","33,645.7060",05.00 AED,5.00,4.9000,0.1000,566375145,1612388,Success,United Arab Emirates,DU UAE,Transguard Group LLC,API User,E6AEAE17361
2022-02-26 22:28,73156819,"33,645.7060","33,640.8060",05.00 AED,5.00,4.9000,0.1000,566375497,1612395,Success,United Arab Emirates,DU UAE,Transguard Group LLC,API User,E6AEAE17361
2022-02-26 22:31,73156950,"33,640.8060","33,635.9060",05.00 AED,5.00,4.9000,0.1000,566375972,1612401,Success,United Arab Emirates,DU UAE,Transguard Group LLC,API User,E6AEAE17361
2022-02-26 22:35,73157143,"33,635.9060","33,627.9860",220.00 NPR,9.00,7.9200,1.0800,566376704,1612411,Success,Nepal,Ncell Nepal,Transguard Group LLC,API User,NCNPNP79518
2022-02-26 22:36,73157181,"33,627.9860","33,623.0860",05.00 AED,5.00,4.9000,0.1000,566376869,1612415,Success,United Arab Emirates,DU UAE,Transguard Group LLC,API User,E6AEAE17361
2022-02-26 22:40,73157341,"33,623.0860","33,613.2860",10.00 AED,10.00,9.8000,0.2000,566377462,1612420,Success,United Arab Emirates,DU UAE,Transguard Group LLC,API User,E6AEAE22430
2022-02-26 22:47,73157643,"33,613.2860","33,608.3860",05.00 AED,5.00,4.9000,0.1000,566378583,1612423,Success,United Arab Emirates,DU UAE,Transguard Group LLC,API User,E6AEAE17361
2022-02-26 22:47,73157650,"33,608.3860","33,603.4860",05.00 AED,5.00,4.9000,0.1000,566378626,1612426,Success,United Arab Emirates,DU UAE,Transguard Group LLC,API User,E6AEAE17361
2022-02-26 22:48,73157707,"33,603.4860","33,598.5860",05.00 AED,5.00,4.9000,0.1000,566378797,1612429,Success,United Arab Emirates,DU UAE,Transguard Group LLC,API User,E6AEAE17361
2022-02-26 22:57,73158067,"33,598.5860","33,588.7860",10.00 AED,10.00,9.8000,0.2000,566380229,1612438,Success,United Arab Emirates,DU UAE,Transguard Group LLC,API User,E6AEAE22430
2022-02-26 23:06,73158365,"33,588.7860","33,583.8860",05.00 AED,5.00,4.9000,0.1000,566381524,1612445,Success,United Arab Emirates,DU UAE,Transguard Group LLC,API User,E6AEAE17361
2022-02-26 23:08,73158443,"33,583.8860","33,578.9860",05.00 AED,5.00,4.9000,0.1000,566381857,1612448,Success,United Arab Emirates,DU UAE,Transguard Group LLC,API User,E6AEAE17361
2022-02-26 23:11,73158543,"33,578.9860","33,569.1860",10.00 AED,10.00,9.8000,0.2000,566382284,1612451,Success,United Arab Emirates,DU UAE,Transguard Group LLC,API User,E6AEAE22430
2022-02-26 23:27,73159123,"33,569.1860","33,549.5860",20.00 AED,20.00,19.6000,0.4000,566384555,1612458,Success,United Arab Emirates,DU UAE,Transguard Group LLC,API User,E6AEAE12938
2022-02-26 23:28,73159180,"33,549.5860","33,544.6860",05.00 AED,5.00,4.9000,0.1000,566384756,1612462,Success,United Arab Emirates,DU UAE,Transguard Group LLC,API User,E6AEAE17361
2022-02-26 23:31,73159253,"33,544.6860","33,534.8860",10.00 AED,10.00,9.8000,0.2000,566385114,1612467,Success,United Arab Emirates,DU UAE,Transguard Group LLC,API User,E6AEAE22430
2022-02-26 23:52,73159927,"33,534.8860","33,529.9860",05.00 AED,5.00,4.9000,0.1000,566387894,1612477,Success,United Arab Emirates,DU UAE,Transguard Group LLC,API User,E6AEAE17361
2022-02-27 00:02,73160251,"33,529.9860","33,525.0860",05.00 AED,5.00,4.9000,0.1000,566389203,1612484,Success,United Arab Emirates,DU UAE,Transguard Group LLC,API User,E6AEAE17361
2022-02-27 00:36,73161901,"33,525.0860","33,515.2860",10.00 AED,10.00,9.8000,0.2000,566394164,1612500,Success,United Arab Emirates,DU UAE,Transguard Group LLC,API User,E6AEAE22430
2022-02-27 00:38,73161964,"33,515.2860","33,510.3860",05.00 AED,5.00,4.9000,0.1000,566394364,1612504,Success,United Arab Emirates,DU UAE,Transguard Group LLC,API User,E6AEAE17361
2022-02-27 00:57,73162626,"33,510.3860","33,505.4860",05.00 AED,5.00,4.9000,0.1000,566396711,1612509,Success,United Arab Emirates,DU UAE,Transguard Group LLC,API User,E6AEAE17361
2022-02-27 00:57,73162655,"33,505.4860","33,500.5860",05.00 AED,5.00,4.9000,0.1000,566396793,1612512,Success,United Arab Emirates,DU UAE,Transguard Group LLC,API User,E6AEAE17361
2022-02-27 00:58,73162669,"33,500.5860","33,490.7860",10.00 AED,10.00,9.8000,0.2000,566396836,1612515,Success,United Arab Emirates,DU UAE,Transguard Group LLC,API User,E6AEAE22430
2022-02-27 00:59,73162729,"33,490.7860","33,485.8860",05.00 AED,5.00,4.9000,0.1000,566397053,1612519,Success,United Arab Emirates,DU UAE,Transguard Group LLC,API User,E6AEAE17361
2022-02-27 01:00,73162759,"33,485.8860","33,476.0860",10.00 AED,10.00,9.8000,0.2000,566397175,1612522,Success,United Arab Emirates,DU UAE,Transguard Group LLC,API User,E6AEAE22430
2022-02-27 01:01,73162781,"33,476.0860","33,471.1860",05.00 AED,5.00,4.9000,0.1000,566397265,1612527,Success,United Arab Emirates,DU UAE,Transguard Group LLC,API User,E6AEAE17361
2022-02-27 01:38,73164052,"33,471.1860","33,461.3860",10.00 AED,10.00,9.8000,0.2000,566402017,1612539,Success,United Arab Emirates,DU UAE,Transguard Group LLC,API User,E6AEAE22430
2022-02-27 01:49,73164359,"33,461.3860","33,451.5860",10.00 AED,10.00,9.8000,0.2000,566403285,1612547,Success,United Arab Emirates,DU UAE,Transguard Group LLC,API User,E6AEAE22430
2022-02-27 01:55,73164531,"33,451.5860","33,446.6860",05.00 AED,5.00,4.9000,0.1000,566404040,1612550,Success,United Arab Emirates,DU UAE,Transguard Group LLC,API User,E6AEAE17361
2022-02-27 03:28,73167273,"33,446.6860","33,441.7860",05.00 AED,5.00,4.9000,0.1000,566415513,1612570,Success,United Arab Emirates,DU UAE,Transguard Group LLC,API User,E6AEAE17361
2022-02-27 03:28,73167275,"33,441.7860","33,436.8860",05.00 AED,5.00,4.9000,0.1000,566415519,1612571,Success,United Arab Emirates,DU UAE,Transguard Group LLC,API User,E6AEAE17361
2022-02-27 03:30,73167316,"33,436.8860","33,427.0860",10.00 AED,10.00,9.8000,0.2000,566415722,1612574,Success,United Arab Emirates,DU UAE,Transguard Group LLC,API User,E6AEAE22430
2022-02-27 03:35,73167439,"33,427.0860","33,422.1860",05.00 AED,5.00,4.9000,0.1000,566416260,1612582,Success,United Arab Emirates,DU UAE,Transguard Group LLC,API User,E6AEAE17361
2022-02-27 04:29,73168713,"33,422.1860","33,414.2660",220.00 NPR,9.00,7.9200,1.0800,566422518,1612589,Success,Nepal,Ncell Nepal,Transguard Group LLC,API User,NCNPNP79518
2022-02-27 04:32,73168772,"33,414.2660","33,409.3660",05.00 AED,5.00,4.9000,0.1000,566422804,1612594,Success,United Arab Emirates,DU UAE,Transguard Group LLC,API User,E6AEAE17361
2022-02-27 04:39,73168932,"33,409.3660","33,404.4660",05.00 AED,5.00,4.9000,0.1000,566423627,1612597,Success,United Arab Emirates,DU UAE,Transguard Group LLC,API User,E6AEAE17361
2022-02-27 04:53,73169232,"33,404.4660","33,399.5660",05.00 AED,5.00,4.9000,0.1000,566425159,1612613,Success,United Arab Emirates,DU UAE,Transguard Group LLC,API User,E6AEAE17361
2022-02-27 05:03,73169412,"33,399.5660","33,389.7660",10.00 AED,10.00,9.8000,0.2000,566426164,1612618,Success,United Arab Emirates,DU UAE,Transguard Group LLC,API User,E6AEAE22430
2022-02-27 05:07,73169495,"33,389.7660","33,370.1660",20.00 AED,20.00,19.6000,0.4000,566426556,1612623,Success,United Arab Emirates,DU UAE,Transguard Group LLC,API User,E6AEAE12938
2022-02-27 05:09,73169547,"33,370.1660","33,365.2660",05.00 AED,5.00,4.9000,0.1000,566426729,1612626,Success,United Arab Emirates,DU UAE,Transguard Group LLC,API User,E6AEAE17361
2022-02-27 05:11,73169582,"33,365.2660","33,350.5660",15.00 AED,15.00,14.7000,0.3000,566426945,1612629,Success,United Arab Emirates,DU UAE,Transguard Group LLC,API User,E6AEAE8527
2022-02-27 05:21,73169791,"33,350.5660","33,345.6660",05.00 AED,5.00,4.9000,0.1000,566427875,1612633,Success,United Arab Emirates,DU UAE,Transguard Group LLC,API User,E6AEAE17361
2022-02-27 05:22,73169812,"33,345.6660","33,335.8660",10.00 AED,10.00,9.8000,0.2000,566427946,1612636,Success,United Arab Emirates,DU UAE,Transguard Group LLC,API User,E6AEAE22430
2022-02-27 05:26,73169888,"33,335.8660","33,330.9660",05.00 AED,5.00,4.9000,0.1000,566428256,1612639,Success,United Arab Emirates,DU UAE,Transguard Group LLC,API User,E6AEAE17361
2022-02-27 05:56,73170596,"33,330.9660","33,326.0660",05.00 AED,5.00,4.9000,0.1000,566430826,1612646,Success,United Arab Emirates,DU UAE,Transguard Group LLC,API User,E6AEAE17361
2022-02-27 06:10,73170945,"33,326.0660","33,321.1660",05.00 AED,5.00,4.9000,0.1000,566431916,1612651,Success,United Arab Emirates,DU UAE,Transguard Group LLC,API User,E6AEAE17361
2022-02-27 06:29,73171452,"33,321.1660","33,316.2660",05.00 AED,5.00,4.9000,0.1000,566433460,1612656,Success,United Arab Emirates,DU UAE,Transguard Group LLC,API User,E6AEAE17361
2022-02-27 06:31,73171505,"33,316.2660","33,306.4660",10.00 AED,10.00,9.8000,0.2000,566433628,1612660,Success,United Arab Emirates,DU UAE,Transguard Group LLC,API User,E6AEAE22430
2022-02-27 06:35,73171617,"33,306.4660","33,296.6660",10.00 AED,10.00,9.8000,0.2000,566433936,1612668,Success,United Arab Emirates,DU UAE,Transguard Group LLC,API User,E6AEAE22430
2022-02-27 06:37,73171686,"33,296.6660","33,291.7660",05.00 AED,5.00,4.9000,0.1000,566434167,1612671,Success,United Arab Emirates,DU UAE,Transguard Group LLC,API User,E6AEAE17361
2022-02-27 06:39,73171736,"33,291.7660","33,286.8660",05.00 AED,5.00,4.9000,0.1000,566434316,1612674,Success,United Arab Emirates,DU UAE,Transguard Group LLC,API User,E6AEAE17361
2022-02-27 06:52,73172034,"33,286.8660","33,277.0660",10.00 AED,10.00,9.8000,0.2000,566435237,1612679,Success,United Arab Emirates,DU UAE,Transguard Group LLC,API User,E6AEAE22430
2022-02-27 06:54,73172112,"33,277.0660","33,272.1660",05.00 AED,5.00,4.9000,0.1000,566435431,1612684,Success,United Arab Emirates,DU UAE,Transguard Group LLC,API User,E6AEAE17361
2022-02-27 06:54,73172118,"33,272.1660","33,267.2660",05.00 AED,5.00,4.9000,0.1000,566435447,1612685,Success,United Arab Emirates,DU UAE,Transguard Group LLC,API User,E6AEAE17361
2022-02-27 06:55,73172156,"33,267.2660","33,257.4660",10.00 AED,10.00,9.8000,0.2000,566435554,1612688,Success,United Arab Emirates,DU UAE,Transguard Group LLC,API User,E6AEAE22430
2022-02-27 07:00,73172277,"33,257.4660","33,247.6660",10.00 AED,10.00,9.8000,0.2000,566435889,1612695,Success,United Arab Emirates,DU UAE,Transguard Group LLC,API User,E6AEAE22430
2022-02-27 07:01,73172303,"33,247.6660","33,243.9260",100.00 NPR,4.25,3.7400,0.5100,566435971,1612698,Success,Nepal,Ncell Nepal,Transguard Group LLC,API User,NP_NC_TopUp_100.00
2022-02-27 07:04,73172404,"33,243.9260","33,239.0260",05.00 AED,5.00,4.9000,0.1000,566436234,1612701,Failure,United Arab Emirates,DU UAE,Transguard Group LLC,API User,E6AEAE17361
2022-02-27 07:04,73172404,"33,239.0260","33,234.1260",05.00 AED,5.00,4.9000,0.1000,566436234,1612701,Failure,United Arab Emirates,DU UAE,Transguard Group LLC,API User,E6AEAE17361
2022-02-27 07:11,73172600,"33,243.9260","33,234.1260",10.00 AED,10.00,9.8000,0.2000,566436782,1612704,Success,United Arab Emirates,DU UAE,Transguard Group LLC,API User,E6AEAE22430
2022-02-27 07:12,73172636,"33,234.1260","33,229.2260",05.00 AED,5.00,4.9000,0.1000,566436879,1612707,Success,United Arab Emirates,DU UAE,Transguard Group LLC,API User,E6AEAE17361
2022-02-27 07:29,73173158,"33,229.2260","33,224.3260",05.00 AED,5.00,4.9000,0.1000,566438369,1612711,Success,United Arab Emirates,DU UAE,Transguard Group LLC,API User,E6AEAE17361
2022-02-27 07:55,73173990,"33,224.3260","33,219.4260",05.00 AED,5.00,4.9000,0.1000,566440465,1612719,Success,United Arab Emirates,DU UAE,Transguard Group LLC,API User,E6AEAE17361
2022-02-27 08:01,73174206,"33,219.4260","33,209.6260",10.00 AED,10.00,9.8000,0.2000,566440976,1612725,Success,United Arab Emirates,DU UAE,Transguard Group LLC,API User,E6AEAE22430
2022-02-27 08:10,73174511,"33,209.6260","33,204.7260",05.00 AED,5.00,4.9000,0.1000,566441717,1612730,Success,United Arab Emirates,DU UAE,Transguard Group LLC,API User,E6AEAE17361
2022-02-27 08:12,73174582,"33,204.7260","33,194.9260",10.00 AED,10.00,9.8000,0.2000,566441887,1612733,Success,United Arab Emirates,DU UAE,Transguard Group LLC,API User,E6AEAE22430
2022-02-27 08:16,73174727,"33,194.9260","33,190.0260",05.00 AED,5.00,4.9000,0.1000,566442213,1612736,Success,United Arab Emirates,DU UAE,Transguard Group LLC,API User,E6AEAE17361
2022-02-27 08:23,73175008,"33,190.0260","33,185.1260",05.00 AED,5.00,4.9000,0.1000,566442860,1612744,Success,United Arab Emirates,DU UAE,Transguard Group LLC,API User,E6AEAE17361
2022-02-27 08:49,73176027,"33,185.1260","33,180.2260",05.00 AED,5.00,4.9000,0.1000,566445139,1612770,Success,United Arab Emirates,DU UAE,Transguard Group LLC,API User,E6AEAE17361
2022-02-27 09:03,73176602,"33,180.2260","33,175.3260",05.00 AED,5.00,4.9000,0.1000,566446408,1612779,Success,United Arab Emirates,DU UAE,Transguard Group LLC,API User,E6AEAE17361
2022-02-27 09:04,73176633,"33,175.3260","33,170.4260",05.00 AED,5.00,4.9000,0.1000,566446466,1612782,Success,United Arab Emirates,DU UAE,Transguard Group LLC,API User,E6AEAE17361
2022-02-27 09:07,73176768,"33,170.4260","33,165.5260",05.00 AED,5.00,4.9000,0.1000,566446763,1612785,Success,United Arab Emirates,DU UAE,Transguard Group LLC,API User,E6AEAE17361
2022-02-27 09:12,73176987,"33,165.5260","33,145.9260",20.00 AED,20.00,19.6000,0.4000,566447249,1612788,Success,United Arab Emirates,DU UAE,Transguard Group LLC,API User,E6AEAE12938
2022-02-27 09:36,73178092,"33,145.9260","33,141.7460",150.00 PKR,4.75,4.1800,0.5700,566449635,1612797,Success,Pakistan,Jazz Pakistan,Transguard Group LLC,API User,MBPKPK20699
2022-02-27 09:51,73178785,"33,141.7460","33,136.8460",05.00 AED,5.00,4.9000,0.1000,566451110,1612804,Success,United Arab Emirates,DU UAE,Transguard Group LLC,API User,E6AEAE17361
2022-02-27 09:52,73178843,"33,136.8460","33,131.9460",05.00 AED,5.00,4.9000,0.1000,566451255,1612807,Success,United Arab Emirates,DU UAE,Transguard Group LLC,API User,E6AEAE17361
2022-02-27 10:17,73179979,"33,131.9460","33,122.1460",10.00 AED,10.00,9.8000,0.2000,566453780,1612817,Success,United Arab Emirates,DU UAE,Transguard Group LLC,API User,E6AEAE22430
2022-02-27 10:17,73180008,"33,122.1460","33,112.3460",10.00 AED,10.00,9.8000,0.2000,566453840,1612819,Success,United Arab Emirates,DU UAE,Transguard Group LLC,API User,E6AEAE22430
2022-02-27 10:18,73180021,"33,112.3460","33,102.5460",10.00 AED,10.00,9.8000,0.2000,566453880,1612822,Success,United Arab Emirates,DU UAE,Transguard Group LLC,API User,E6AEAE22430
2022-02-27 10:24,73180291,"33,102.5460","33,097.6460",05.00 AED,5.00,4.9000,0.1000,566454483,1612827,Success,United Arab Emirates,DU UAE,Transguard Group LLC,API User,E6AEAE17361
2022-02-27 10:37,73180990,"33,097.6460","33,092.7460",05.00 AED,5.00,4.9000,0.1000,566455894,1612832,Success,United Arab Emirates,DU UAE,Transguard Group LLC,API User,E6AEAE17361
2022-02-27 10:42,73181269,"33,092.7460","33,087.8460",05.00 AED,5.00,4.9000,0.1000,566456470,1612837,Success,United Arab Emirates,DU UAE,Transguard Group LLC,API User,E6AEAE17361
2022-02-27 10:43,73181313,"33,087.8460","33,082.9460",05.00 AED,5.00,4.9000,0.1000,566456557,1612840,Success,United Arab Emirates,DU UAE,Transguard Group LLC,API User,E6AEAE17361
2022-02-27 11:12,73182727,"33,082.9460","33,074.5860",300.00 PKR,9.50,8.3600,1.1400,566459628,1612849,Success,Pakistan,Ufone Pakistan,Transguard Group LLC,API User,PK_UF_TopUp_300.00
2022-02-27 11:15,73182842,"33,074.5860","33,069.6860",05.00 AED,5.00,4.9000,0.1000,566459875,1612852,Success,United Arab Emirates,DU UAE,Transguard Group LLC,API User,E6AEAE17361
2022-02-27 11:28,73183523,"33,069.6860","33,064.7860",05.00 AED,5.00,4.9000,0.1000,566461272,1612863,Success,United Arab Emirates,DU UAE,Transguard Group LLC,API User,E6AEAE17361
2022-02-27 11:34,73183864,"33,064.7860","33,059.8860",05.00 AED,5.00,4.9000,0.1000,566461912,1612868,Success,United Arab Emirates,DU UAE,Transguard Group LLC,API User,E6AEAE17361
2022-02-27 11:46,73184469,"33,059.8860","33,051.5260",100.00 PHP,9.50,8.3600,1.1400,566463175,1612875,Success,Philippines,Smart (SunCellular) Philippines,Transguard Group LLC,API User,PH_SM_TopUp_100.00
2022-02-27 11:51,73184732,"33,051.5260","33,046.6260",05.00 AED,5.00,4.9000,0.1000,566463709,1612878,Success,United Arab Emirates,DU UAE,Transguard Group LLC,API User,E6AEAE17361
2022-02-27 11:52,73184749,"33,046.6260","33,041.7260",05.00 AED,5.00,4.9000,0.1000,566463756,1612881,Success,United Arab Emirates,DU UAE,Transguard Group LLC,API User,E6AEAE17361
2022-02-27 11:57,73184990,"33,041.7260","33,031.9260",10.00 AED,10.00,9.8000,0.2000,566464253,1612891,Success,United Arab Emirates,DU UAE,Transguard Group LLC,API User,E6AEAE22430
2022-02-27 12:02,73185228,"33,031.9260","33,027.0260",05.00 AED,5.00,4.9000,0.1000,566464796,1612894,Success,United Arab Emirates,DU UAE,Transguard Group LLC,API User,E6AEAE17361
2022-02-27 12:05,73185313,"33,027.0260","33,022.1260",05.00 AED,5.00,4.9000,0.1000,566464988,1612898,Success,United Arab Emirates,DU UAE,Transguard Group LLC,API User,E6AEAE17361
2022-02-27 12:08,73185483,"33,022.1260","33,017.2260",05.00 AED,5.00,4.9000,0.1000,566465356,1612908,Success,United Arab Emirates,DU UAE,Transguard Group LLC,API User,E6AEAE17361
2022-02-27 12:10,73185594,"33,017.2260","33,007.4260",10.00 AED,10.00,9.8000,0.2000,566465581,1612918,Success,United Arab Emirates,DU UAE,Transguard Group LLC,API User,E6AEAE22430
2022-02-27 12:11,73185638,"33,007.4260","33,002.5260",05.00 AED,5.00,4.9000,0.1000,566465691,1612923,Success,United Arab Emirates,DU UAE,Transguard Group LLC,API User,E6AEAE17361
2022-02-27 12:18,73186015,"33,002.5260","32,997.6260",05.00 AED,5.00,4.9000,0.1000,566466437,1612933,Success,United Arab Emirates,DU UAE,Transguard Group LLC,API User,E6AEAE17361
2022-02-27 12:19,73186026,"32,997.6260","32,992.7260",05.00 AED,5.00,4.9000,0.1000,566466462,1612935,Success,United Arab Emirates,DU UAE,Transguard Group LLC,API User,E6AEAE17361
2022-02-27 12:27,73186395,"32,992.7260","32,982.9260",10.00 AED,10.00,9.8000,0.2000,566467360,1612938,Success,United Arab Emirates,DU UAE,Transguard Group LLC,API User,E6AEAE22430
2022-02-27 12:28,73186416,"32,982.9260","32,978.0260",05.00 AED,5.00,4.9000,0.1000,566467411,1612941,Success,United Arab Emirates,DU UAE,Transguard Group LLC,API User,E6AEAE17361
2022-02-27 12:30,73186503,"32,978.0260","32,968.2260",10.00 AED,10.00,9.8000,0.2000,566467634,1612944,Success,United Arab Emirates,DU UAE,Transguard Group LLC,API User,E6AEAE22430
2022-02-27 12:39,73186928,"32,968.2260","32,963.3260",05.00 AED,5.00,4.9000,0.1000,566468582,1612955,Success,United Arab Emirates,DU UAE,Transguard Group LLC,API User,E6AEAE17361
2022-02-27 12:55,73187712,"32,963.3260","32,953.5260",10.00 AED,10.00,9.8000,0.2000,566470254,1612976,Failure,United Arab Emirates,DU UAE,Transguard Group LLC,API User,E6AEAE22430
2022-02-27 12:55,73187712,"32,953.5260","32,943.7260",10.00 AED,10.00,9.8000,0.2000,566470254,1612976,Failure,United Arab Emirates,DU UAE,Transguard Group LLC,API User,E6AEAE22430
2022-02-27 12:56,73187729,"32,963.3260","32,958.4260",05.00 AED,5.00,4.9000,0.1000,566470295,1612979,Success,United Arab Emirates,DU UAE,Transguard Group LLC,API User,E6AEAE17361
2022-02-27 12:59,73187885,"32,958.4260","32,953.5260",05.00 AED,5.00,4.9000,0.1000,566470635,1612982,Success,United Arab Emirates,DU UAE,Transguard Group LLC,API User,E6AEAE17361
2022-02-27 13:03,73188030,"32,953.5260","32,943.7260",10.00 AED,10.00,9.8000,0.2000,566470960,1612986,Success,United Arab Emirates,DU UAE,Transguard Group LLC,API User,E6AEAE22430
2022-02-27 13:04,73188071,"32,943.7260","32,938.8260",05.00 AED,5.00,4.9000,0.1000,566471052,1612990,Success,United Arab Emirates,DU UAE,Transguard Group LLC,API User,E6AEAE17361
2022-02-27 13:04,73188129,"32,938.8260","32,933.9260",05.00 AED,5.00,4.9000,0.1000,566471160,1612993,Success,United Arab Emirates,DU UAE,Transguard Group LLC,API User,E6AEAE17361
2022-02-27 13:06,73188196,"32,933.9260","32,924.1260",10.00 AED,10.00,9.8000,0.2000,566471293,1612997,Success,United Arab Emirates,DU UAE,Transguard Group LLC,API User,E6AEAE22430
2022-02-27 13:09,73188331,"32,924.1260","32,919.2260",05.00 AED,5.00,4.9000,0.1000,566471586,1613001,Success,United Arab Emirates,DU UAE,Transguard Group LLC,API User,E6AEAE17361
2022-02-27 13:19,73188854,"32,919.2260","32,915.4860",98.00 NPR,4.25,3.7400,0.5100,566472647,1613004,Success,Nepal,Ncell Nepal,Transguard Group LLC,API User,NCNPNP3715
2022-02-27 13:31,73189464,"32,915.4860","32,910.5860",05.00 AED,5.00,4.9000,0.1000,566473994,1613009,Success,United Arab Emirates,DU UAE,Transguard Group LLC,API User,E6AEAE17361
2022-02-27 13:35,73189632,"32,910.5860","32,900.7860",10.00 AED,10.00,9.8000,0.2000,566474397,1613012,Success,United Arab Emirates,DU UAE,Transguard Group LLC,API User,E6AEAE22430
2022-02-27 13:39,73189824,"32,900.7860","32,895.8860",05.00 AED,5.00,4.9000,0.1000,566474833,1613015,Success,United Arab Emirates,DU UAE,Transguard Group LLC,API User,E6AEAE17361
2022-02-27 13:42,73189927,"32,895.8860","32,886.0860",10.00 AED,10.00,9.8000,0.2000,566475071,1613018,Success,United Arab Emirates,DU UAE,Transguard Group LLC,API User,E6AEAE22430
2022-02-27 13:48,73190208,"32,886.0860","32,881.1860",05.00 AED,5.00,4.9000,0.1000,566475691,1613021,Success,United Arab Emirates,DU UAE,Transguard Group LLC,API User,E6AEAE17361
2022-02-27 13:50,73190335,"32,881.1860","32,871.3860",10.00 AED,10.00,9.8000,0.2000,566475984,1613024,Success,United Arab Emirates,DU UAE,Transguard Group LLC,API User,E6AEAE22430
2022-02-27 13:56,73190551,"32,871.3860","32,866.4860",05.00 AED,5.00,4.9000,0.1000,566476523,1613027,Success,United Arab Emirates,DU UAE,Transguard Group LLC,API User,E6AEAE17361
2022-02-27 14:02,73190881,"32,866.4860","32,861.5860",05.00 AED,5.00,4.9000,0.1000,566477231,1613034,Success,United Arab Emirates,DU UAE,Transguard Group LLC,API User,E6AEAE17361
2022-02-27 14:06,73191049,"32,861.5860","32,856.6860",05.00 AED,5.00,4.9000,0.1000,566477615,1613038,Success,United Arab Emirates,DU UAE,Transguard Group LLC,API User,E6AEAE17361
2022-02-27 14:07,73191072,"32,856.6860","32,846.8860",10.00 AED,10.00,9.8000,0.2000,566477680,1613041,Success,United Arab Emirates,DU UAE,Transguard Group LLC,API User,E6AEAE22430
2022-02-27 14:08,73191132,"32,846.8860","32,841.9860",05.00 AED,5.00,4.9000,0.1000,566477808,1613044,Success,United Arab Emirates,DU UAE,Transguard Group LLC,API User,E6AEAE17361
2022-02-27 14:15,73191481,"32,841.9860","32,837.0860",05.00 AED,5.00,4.9000,0.1000,566478544,1613051,Success,United Arab Emirates,DU UAE,Transguard Group LLC,API User,E6AEAE17361
2022-02-27 14:25,73191962,"32,837.0860","32,817.4860",20.00 AED,20.00,19.6000,0.4000,566479674,1613054,Success,United Arab Emirates,DU UAE,Transguard Group LLC,API User,E6AEAE12938
2022-02-27 14:33,73192293,"32,817.4860","32,812.5860",05.00 AED,5.00,4.9000,0.1000,566480475,1613059,Success,United Arab Emirates,DU UAE,Transguard Group LLC,API User,E6AEAE17361
2022-02-27 14:49,73193016,"32,812.5860","32,807.6860",05.00 AED,5.00,4.9000,0.1000,566482181,1613070,Success,United Arab Emirates,DU UAE,Transguard Group LLC,API User,E6AEAE17361
2022-02-27 14:51,73193134,"32,807.6860","32,802.7860",05.00 AED,5.00,4.9000,0.1000,566482482,1613075,Success,United Arab Emirates,DU UAE,Transguard Group LLC,API User,E6AEAE17361
2022-02-27 14:54,73193243,"32,802.7860","32,797.8860",05.00 AED,5.00,4.9000,0.1000,566482750,1613080,Success,United Arab Emirates,DU UAE,Transguard Group LLC,API User,E6AEAE17361
2022-02-27 15:05,73193762,"32,797.8860","32,788.0860",10.00 AED,10.00,9.8000,0.2000,566483977,1613085,Success,United Arab Emirates,DU UAE,Transguard Group LLC,API User,E6AEAE22430
2022-02-27 15:07,73193876,"32,788.0860","32,783.1860",05.00 AED,5.00,4.9000,0.1000,566484225,1613088,Success,United Arab Emirates,DU UAE,Transguard Group LLC,API User,E6AEAE17361
2022-02-27 15:11,73194093,"32,783.1860","32,778.2860",05.00 AED,5.00,4.9000,0.1000,566484742,1613093,Success,United Arab Emirates,DU UAE,Transguard Group LLC,API User,E6AEAE17361
2022-02-27 15:11,73194096,"32,778.2860","32,773.3860",05.00 AED,5.00,4.9000,0.1000,566484745,1613094,Success,United Arab Emirates,DU UAE,Transguard Group LLC,API User,E6AEAE17361
2022-02-27 15:37,73195198,"32,773.3860","32,756.4460",650.00 PKR,19.25,16.9400,2.3100,566487529,1613118,Success,Pakistan,Telenor Pakistan,Transguard Group LLC,API User,TPPKPK28935
2022-02-27 15:40,73195330,"32,756.4460","32,751.5460",05.00 AED,5.00,4.9000,0.1000,566487871,1613121,Success,United Arab Emirates,DU UAE,Transguard Group LLC,API User,E6AEAE17361
2022-02-27 15:43,73195426,"32,751.5460","32,746.6460",05.00 AED,5.00,4.9000,0.1000,566488108,1613124,Success,United Arab Emirates,DU UAE,Transguard Group LLC,API User,E6AEAE17361
2022-02-27 15:49,73195673,"32,746.6460","32,741.7460",05.00 AED,5.00,4.9000,0.1000,566488792,1613129,Success,United Arab Emirates,DU UAE,Transguard Group LLC,API User,E6AEAE17361
2022-02-27 15:51,73195775,"32,741.7460","32,736.8460",05.00 AED,5.00,4.9000,0.1000,566489061,1613137,Success,United Arab Emirates,DU UAE,Transguard Group LLC,API User,E6AEAE17361
2022-02-27 15:51,73195779,"32,736.8460","32,727.0460",10.00 AED,10.00,9.8000,0.2000,566489075,1613138,Success,United Arab Emirates,DU UAE,Transguard Group LLC,API User,E6AEAE22430
2022-02-27 15:59,73196089,"32,727.0460","32,722.1460",05.00 AED,5.00,4.9000,0.1000,566489936,1613145,Success,United Arab Emirates,DU UAE,Transguard Group LLC,API User,E6AEAE17361
2022-02-27 16:02,73196254,"32,722.1460","32,712.3460",10.00 AED,10.00,9.8000,0.2000,566490360,1613148,Success,United Arab Emirates,DU UAE,Transguard Group LLC,API User,E6AEAE22430
2022-02-27 16:05,73196351,"32,712.3460","32,707.4460",05.00 AED,5.00,4.9000,0.1000,566490615,1613151,Success,United Arab Emirates,DU UAE,Transguard Group LLC,API User,E6AEAE17361
2022-02-27 16:07,73196467,"32,707.4460","32,702.5460",05.00 AED,5.00,4.9000,0.1000,566490905,1613154,Success,United Arab Emirates,DU UAE,Transguard Group LLC,API User,E6AEAE17361
2022-02-27 16:09,73196546,"32,702.5460","32,697.6460",05.00 AED,5.00,4.9000,0.1000,566491140,1613159,Success,United Arab Emirates,DU UAE,Transguard Group LLC,API User,E6AEAE17361
2022-02-27 16:12,73196687,"32,697.6460","32,692.7460",05.00 AED,5.00,4.9000,0.1000,566491506,1613164,Success,United Arab Emirates,DU UAE,Transguard Group LLC,API User,E6AEAE17361
2022-02-27 16:13,73196700,"32,692.7460","32,682.9460",10.00 AED,10.00,9.8000,0.2000,566491523,1613165,Success,United Arab Emirates,DU UAE,Transguard Group LLC,API User,E6AEAE22430
2022-02-27 16:15,73196792,"32,682.9460","32,678.0460",05.00 AED,5.00,4.9000,0.1000,566491786,1613173,Success,United Arab Emirates,DU UAE,Transguard Group LLC,API User,E6AEAE17361
2022-02-27 16:16,73196836,"32,678.0460","32,668.2460",10.00 AED,10.00,9.8000,0.2000,566491890,1613179,Success,United Arab Emirates,DU UAE,Transguard Group LLC,API User,E6AEAE22430
2022-02-27 16:25,73197287,"32,668.2460","32,665.1660",125.00 PKR,3.50,3.0800,0.4200,566493109,1613194,Success,Pakistan,Zong Pakistan,Transguard Group LLC,API User,ZNPKPK66738
2022-02-27 16:39,73198019,"32,665.1660","32,660.2660",05.00 AED,5.00,4.9000,0.1000,566494947,1613207,Success,United Arab Emirates,DU UAE,Transguard Group LLC,API User,E6AEAE17361
2022-02-27 16:41,73198086,"32,660.2660","32,655.3660",05.00 AED,5.00,4.9000,0.1000,566495148,1613210,Success,United Arab Emirates,DU UAE,Transguard Group LLC,API User,E6AEAE17361
2022-02-27 16:42,73198155,"32,655.3660","32,650.7460",127.00 NPR,5.25,4.6200,0.6300,566495351,1613214,Success,Nepal,Ncell Nepal,Transguard Group LLC,API User,NCNPNP69719
2022-02-27 16:43,73198191,"32,650.7460","32,645.8460",05.00 AED,5.00,4.9000,0.1000,566495463,1613218,Success,United Arab Emirates,DU UAE,Transguard Group LLC,API User,E6AEAE17361
2022-02-27 16:49,73198488,"32,645.8460","32,629.7860",575.00 PKR,18.25,16.0600,2.1900,566496214,1613223,Success,Pakistan,Jazz Pakistan,Transguard Group LLC,API User,MBPKPK68304
2022-02-27 16:51,73198619,"32,629.7860","32,620.9860","7,335.00 UGX",10.00,8.8000,1.2000,566496579,1613228,Success,Uganda,Airtel Uganda,Transguard Group LLC,API User,UG_WA_TopUp
2022-02-27 16:52,73198676,"32,620.9860","32,616.0860",05.00 AED,5.00,4.9000,0.1000,566496704,1613231,Success,United Arab Emirates,DU UAE,Transguard Group LLC,API User,E6AEAE17361
2022-02-27 16:53,73198733,"32,616.0860","32,611.1860",05.00 AED,5.00,4.9000,0.1000,566496850,1613235,Success,United Arab Emirates,DU UAE,Transguard Group LLC,API User,E6AEAE17361
2022-02-27 16:55,73198847,"32,611.1860","32,606.2860",05.00 AED,5.00,4.9000,0.1000,566497128,1613243,Success,United Arab Emirates,DU UAE,Transguard Group LLC,API User,E6AEAE17361
2022-02-27 16:55,73198859,"32,606.2860","32,596.4860",10.00 AED,10.00,9.8000,0.2000,566497146,1613245,Success,United Arab Emirates,DU UAE,Transguard Group LLC,API User,E6AEAE22430
2022-02-27 17:01,73199195,"32,596.4860","32,591.5860",05.00 AED,5.00,4.9000,0.1000,566498009,1613261,Success,United Arab Emirates,DU UAE,Transguard Group LLC,API User,E6AEAE17361
2022-02-27 17:03,73199257,"32,591.5860","32,581.7860",10.00 AED,10.00,9.8000,0.2000,566498176,1613267,Success,United Arab Emirates,DU UAE,Transguard Group LLC,API User,E6AEAE22430
2022-02-27 17:04,73199330,"32,581.7860","32,571.9860",10.00 AED,10.00,9.8000,0.2000,566498338,1613276,Success,United Arab Emirates,DU UAE,Transguard Group LLC,API User,E6AEAE22430
2022-02-27 17:16,73200036,"32,571.9860","32,567.0860",05.00 AED,5.00,4.9000,0.1000,566500264,1613304,Success,United Arab Emirates,DU UAE,Transguard Group LLC,API User,E6AEAE17361
2022-02-27 17:19,73200143,"32,567.0860","32,562.1860",05.00 AED,5.00,4.9000,0.1000,566500534,1613313,Success,United Arab Emirates,DU UAE,Transguard Group LLC,API User,E6AEAE17361
2022-02-27 17:21,73200311,"32,562.1860","32,518.0860",45.00 AED,45.00,44.1000,0.9000,566500983,1613316,Success,United Arab Emirates,DU UAE,Transguard Group LLC,API User,E6AEAE35243
2022-02-27 17:22,73200373,"32,518.0860","32,513.1860",05.00 AED,5.00,4.9000,0.1000,566501123,1613319,Success,United Arab Emirates,DU UAE,Transguard Group LLC,API User,E6AEAE17361
2022-02-27 17:23,73200421,"32,513.1860","32,503.3860",10.00 AED,10.00,9.8000,0.2000,566501237,1613322,Success,United Arab Emirates,DU UAE,Transguard Group LLC,API User,E6AEAE22430
2022-02-27 17:23,73200430,"32,503.3860","32,493.5860",10.00 AED,10.00,9.8000,0.2000,566501268,1613326,Success,United Arab Emirates,DU UAE,Transguard Group LLC,API User,E6AEAE22430
2022-02-27 17:23,73200460,"32,493.5860","32,488.6860",05.00 AED,5.00,4.9000,0.1000,566501335,1613330,Success,United Arab Emirates,DU UAE,Transguard Group LLC,API User,E6AEAE17361
2022-02-27 17:24,73200472,"32,488.6860","32,478.8860",10.00 AED,10.00,9.8000,0.2000,566501377,1613332,Success,United Arab Emirates,DU UAE,Transguard Group LLC,API User,E6AEAE22430
2022-02-27 17:24,73200494,"32,478.8860","32,469.0860",10.00 AED,10.00,9.8000,0.2000,566501445,1613335,Success,United Arab Emirates,DU UAE,Transguard Group LLC,API User,E6AEAE22430
2022-02-27 17:27,73200623,"32,469.0860","32,464.1860",05.00 AED,5.00,4.9000,0.1000,566501822,1613340,Success,United Arab Emirates,DU UAE,Transguard Group LLC,API User,E6AEAE17361
2022-02-27 17:30,73200803,"32,464.1860","32,460.0060",150.00 PKR,4.75,4.1800,0.5700,566502301,1613343,Success,Pakistan,Jazz Pakistan,Transguard Group LLC,API User,MBPKPK20699
2022-02-27 17:34,73201044,"32,460.0060","32,455.1060",05.00 AED,5.00,4.9000,0.1000,566502907,1613346,Success,United Arab Emirates,DU UAE,Transguard Group LLC,API User,E6AEAE17361
2022-02-27 17:36,73201155,"32,455.1060","32,445.3060",10.00 AED,10.00,9.8000,0.2000,566503263,1613351,Success,United Arab Emirates,DU UAE,Transguard Group LLC,API User,E6AEAE22430
2022-02-27 17:38,73201294,"32,445.3060","32,440.4060",05.00 AED,5.00,4.9000,0.1000,566503621,1613355,Success,United Arab Emirates,DU UAE,Transguard Group LLC,API User,E6AEAE17361
2022-02-27 17:39,73201377,"32,440.4060","32,435.5060",05.00 AED,5.00,4.9000,0.1000,566503845,1613359,Success,United Arab Emirates,DU UAE,Transguard Group LLC,API User,E6AEAE17361
2022-02-27 17:41,73201478,"32,435.5060","32,430.6060",05.00 AED,5.00,4.9000,0.1000,566504159,1613367,Success,United Arab Emirates,DU UAE,Transguard Group LLC,API User,E6AEAE17361
2022-02-27 17:45,73201736,"32,430.6060","32,391.4060",40.00 AED,40.00,39.2000,0.8000,566504928,1613371,Success,United Arab Emirates,DU UAE,Transguard Group LLC,API User,E6AEAE64011
2022-02-27 17:47,73201820,"32,391.4060","32,386.5060",05.00 AED,5.00,4.9000,0.1000,566505138,1613376,Success,United Arab Emirates,DU UAE,Transguard Group LLC,API User,E6AEAE17361
2022-02-27 17:48,73201872,"32,386.5060","32,377.9260",315.00 PKR,9.75,8.5800,1.1700,566505290,1613381,Success,Pakistan,Zong Pakistan,Transguard Group LLC,API User,ZNPKPK29953
2022-02-27 17:49,73201942,"32,377.9260","32,358.3260",20.00 AED,20.00,19.6000,0.4000,566505451,1613386,Success,United Arab Emirates,DU UAE,Transguard Group LLC,API User,E6AEAE12938
2022-02-27 17:50,73201999,"32,358.3260","32,353.4260",05.00 AED,5.00,4.9000,0.1000,566505621,1613389,Success,United Arab Emirates,DU UAE,Transguard Group LLC,API User,E6AEAE17361
2022-02-27 17:51,73202058,"32,353.4260","32,348.5260",05.00 AED,5.00,4.9000,0.1000,566505795,1613392,Success,United Arab Emirates,DU UAE,Transguard Group LLC,API User,E6AEAE17361
2022-02-27 17:52,73202168,"32,348.5260","32,343.6260",05.00 AED,5.00,4.9000,0.1000,566506103,1613399,Success,United Arab Emirates,DU UAE,Transguard Group LLC,API User,E6AEAE17361
2022-02-27 17:54,73202292,"32,343.6260","32,338.7260",05.00 AED,5.00,4.9000,0.1000,566506408,1613407,Success,United Arab Emirates,DU UAE,Transguard Group LLC,API User,E6AEAE17361
2022-02-27 17:58,73202521,"32,338.7260","32,328.9260",10.00 AED,10.00,9.8000,0.2000,566507029,1613417,Success,United Arab Emirates,DU UAE,Transguard Group LLC,API User,E6AEAE22430
2022-02-27 17:58,73202534,"32,328.9260","32,319.1260",10.00 AED,10.00,9.8000,0.2000,566507051,1613419,Success,United Arab Emirates,DU UAE,Transguard Group LLC,API User,E6AEAE22430
2022-02-27 18:02,73202788,"32,319.1260","32,315.3860",100.00 NPR,4.25,3.7400,0.5100,566507796,1613422,Success,Nepal,Ncell Nepal,Transguard Group LLC,API User,NP_NC_TopUp_100.00
2022-02-27 18:04,73202917,"32,315.3860","32,310.4860",05.00 AED,5.00,4.9000,0.1000,566508117,1613428,Success,United Arab Emirates,DU UAE,Transguard Group LLC,API User,E6AEAE17361
2022-02-27 18:05,73202954,"32,310.4860","32,305.5860",05.00 AED,5.00,4.9000,0.1000,566508249,1613431,Success,United Arab Emirates,DU UAE,Transguard Group LLC,API User,E6AEAE17361
2022-02-27 18:07,73203087,"32,305.5860","32,295.7860",10.00 AED,10.00,9.8000,0.2000,566508604,1613435,Success,United Arab Emirates,DU UAE,Transguard Group LLC,API User,E6AEAE22430
2022-02-27 18:08,73203176,"32,295.7860","32,290.8860",05.00 AED,5.00,4.9000,0.1000,566508827,1613441,Success,United Arab Emirates,DU UAE,Transguard Group LLC,API User,E6AEAE17361
2022-02-27 18:08,73203187,"32,290.8860","32,285.9860",05.00 AED,5.00,4.9000,0.1000,566508859,1613443,Success,United Arab Emirates,DU UAE,Transguard Group LLC,API User,E6AEAE17361
2022-02-27 18:22,73204092,"32,285.9860","32,281.0860",05.00 AED,5.00,4.9000,0.1000,566511341,1613453,Success,United Arab Emirates,DU UAE,Transguard Group LLC,API User,E6AEAE17361
2022-02-27 18:25,73204357,"32,281.0860","32,271.2860",10.00 AED,10.00,9.8000,0.2000,566512081,1613459,Success,United Arab Emirates,DU UAE,Transguard Group LLC,API User,E6AEAE22430
2022-02-27 18:30,73204655,"32,271.2860","32,266.3860",05.00 AED,5.00,4.9000,0.1000,566512915,1613468,Success,United Arab Emirates,DU UAE,Transguard Group LLC,API User,E6AEAE17361
2022-02-27 18:35,73205000,"32,266.3860","32,261.4860",05.00 AED,5.00,4.9000,0.1000,566513857,1613477,Success,United Arab Emirates,DU UAE,Transguard Group LLC,API User,E6AEAE17361
2022-02-27 18:35,73205013,"32,261.4860","32,256.5860",05.00 AED,5.00,4.9000,0.1000,566513881,1613479,Success,United Arab Emirates,DU UAE,Transguard Group LLC,API User,E6AEAE17361
2022-02-27 18:36,73205079,"32,256.5860","32,246.7860",10.00 AED,10.00,9.8000,0.2000,566514105,1613482,Success,United Arab Emirates,DU UAE,Transguard Group LLC,API User,E6AEAE22430
2022-02-27 18:42,73205379,"32,246.7860","32,241.8860",05.00 AED,5.00,4.9000,0.1000,566515040,1613491,Success,United Arab Emirates,DU UAE,Transguard Group LLC,API User,E6AEAE17361
2022-02-27 18:43,73205458,"32,241.8860","32,236.9860",05.00 AED,5.00,4.9000,0.1000,566515234,1613494,Success,United Arab Emirates,DU UAE,Transguard Group LLC,API User,E6AEAE17361
2022-02-27 18:52,73206152,"32,236.9860","32,232.0860",05.00 AED,5.00,4.9000,0.1000,566517112,1613501,Success,United Arab Emirates,DU UAE,Transguard Group LLC,API User,E6AEAE17361
2022-02-27 18:53,73206192,"32,232.0860","32,227.1860",05.00 AED,5.00,4.9000,0.1000,566517205,1613506,Success,United Arab Emirates,DU UAE,Transguard Group LLC,API User,E6AEAE17361
2022-02-27 18:55,73206376,"32,227.1860","32,217.3860",10.00 AED,10.00,9.8000,0.2000,566517699,1613513,Success,United Arab Emirates,DU UAE,Transguard Group LLC,API User,E6AEAE22430
2022-02-27 18:56,73206439,"32,217.3860","32,212.4860",05.00 AED,5.00,4.9000,0.1000,566517864,1613519,Success,United Arab Emirates,DU UAE,Transguard Group LLC,API User,E6AEAE17361
2022-02-27 18:59,73206626,"32,212.4860","32,207.5860",05.00 AED,5.00,4.9000,0.1000,566518331,1613525,Success,United Arab Emirates,DU UAE,Transguard Group LLC,API User,E6AEAE17361
2022-02-27 19:03,73207000,"32,207.5860","32,198.7860",315.00 PKR,10.00,8.8000,1.2000,566519319,1613533,Success,Pakistan,Telenor Pakistan,Transguard Group LLC,API User,TPPKPK75105
2022-02-27 19:04,73207056,"32,198.7860","32,193.8860",05.00 AED,5.00,4.9000,0.1000,566519462,1613538,Failure,United Arab Emirates,DU UAE,Transguard Group LLC,API User,E6AEAE17361
2022-02-27 19:04,73207056,"32,193.8860","32,188.9860",05.00 AED,5.00,4.9000,0.1000,566519462,1613538,Failure,United Arab Emirates,DU UAE,Transguard Group LLC,API User,E6AEAE17361
2022-02-27 19:06,73207191,"32,198.7860","32,193.8860",05.00 AED,5.00,4.9000,0.1000,566519874,1613541,Success,United Arab Emirates,DU UAE,Transguard Group LLC,API User,E6AEAE17361
2022-02-27 19:06,73207244,"32,193.8860","32,188.9860",05.00 AED,5.00,4.9000,0.1000,566520031,1613544,Success,United Arab Emirates,DU UAE,Transguard Group LLC,API User,E6AEAE17361
2022-02-27 19:07,73207301,"32,188.9860","32,185.2460",151.00 PKR,4.25,3.7400,0.5100,566520180,1613547,Success,Pakistan,Telenor Pakistan,Transguard Group LLC,API User,TPPKPK94108
2022-02-27 19:10,73207485,"32,185.2460","32,180.3460",05.00 AED,5.00,4.9000,0.1000,566520702,1613551,Success,United Arab Emirates,DU UAE,Transguard Group LLC,API User,E6AEAE17361
2022-02-27 19:16,73207944,"32,180.3460","32,175.4460",05.00 AED,5.00,4.9000,0.1000,566521992,1613561,Success,United Arab Emirates,DU UAE,Transguard Group LLC,API User,E6AEAE17361
2022-02-27 19:17,73207965,"32,175.4460","32,165.6460",10.00 AED,10.00,9.8000,0.2000,566522044,1613562,Success,United Arab Emirates,DU UAE,Transguard Group LLC,API User,E6AEAE22430
2022-02-27 19:19,73208149,"32,165.6460","32,160.7460",05.00 AED,5.00,4.9000,0.1000,566522465,1613570,Success,United Arab Emirates,DU UAE,Transguard Group LLC,API User,E6AEAE17361
2022-02-27 19:20,73208264,"32,160.7460","32,150.9460",10.00 AED,10.00,9.8000,0.2000,566522782,1613576,Success,United Arab Emirates,DU UAE,Transguard Group LLC,API User,E6AEAE22430
2022-02-27 19:31,73209101,"32,150.9460","32,146.0460",05.00 AED,5.00,4.9000,0.1000,566525058,1613589,Success,United Arab Emirates,DU UAE,Transguard Group LLC,API User,E6AEAE17361
2022-02-27 19:32,73209179,"32,146.0460","32,141.1460",05.00 AED,5.00,4.9000,0.1000,566525276,1613593,Success,United Arab Emirates,DU UAE,Transguard Group LLC,API User,E6AEAE17361
2022-02-27 19:34,73209286,"32,141.1460","32,131.3460",10.00 AED,10.00,9.8000,0.2000,566525571,1613596,Success,United Arab Emirates,DU UAE,Transguard Group LLC,API User,E6AEAE22430
2022-02-27 19:39,73209633,"32,131.3460","32,121.5460",10.00 AED,10.00,9.8000,0.2000,566526498,1613607,Success,United Arab Emirates,DU UAE,Transguard Group LLC,API User,E6AEAE22430
2022-02-27 19:39,73209659,"32,121.5460","32,111.7460",10.00 AED,10.00,9.8000,0.2000,566526573,1613612,Success,United Arab Emirates,DU UAE,Transguard Group LLC,API User,E6AEAE22430
2022-02-27 19:43,73209993,"32,111.7460","32,108.0060",100.00 NPR,4.25,3.7400,0.5100,566527527,1613625,Success,Nepal,Ncell Nepal,Transguard Group LLC,API User,NP_NC_TopUp_100.00
2022-02-27 19:46,73210201,"32,108.0060","32,083.8060","1,000.00 PKR",27.50,24.2000,3.3000,566528089,1613635,Success,Pakistan,Telenor Pakistan,Transguard Group LLC,API User,TPPKPK14509
2022-02-27 19:52,73210668,"32,083.8060","32,078.9060",05.00 AED,5.00,4.9000,0.1000,566529326,1613642,Success,United Arab Emirates,DU UAE,Transguard Group LLC,API User,E6AEAE17361
2022-02-27 19:58,73211091,"32,078.9060","32,074.0060",05.00 AED,5.00,4.9000,0.1000,566530521,1613659,Success,United Arab Emirates,DU UAE,Transguard Group LLC,API User,E6AEAE17361
2022-02-27 20:00,73211175,"32,074.0060","32,070.2660",100.00 NPR,4.25,3.7400,0.5100,566530804,1613662,Success,Nepal,Ncell Nepal,Transguard Group LLC,API User,NP_NC_TopUp_100.00
2022-02-27 20:01,73211234,"32,070.2660","32,065.3660",05.00 AED,5.00,4.9000,0.1000,566530977,1613669,Success,United Arab Emirates,DU UAE,Transguard Group LLC,API User,E6AEAE17361
2022-02-27 20:05,73211493,"32,065.3660","32,060.4660",05.00 AED,5.00,4.9000,0.1000,566531766,1613679,Success,United Arab Emirates,DU UAE,Transguard Group LLC,API User,E6AEAE17361
2022-02-27 20:09,73211777,"32,060.4660","32,055.5660",05.00 AED,5.00,4.9000,0.1000,566532641,1613686,Success,United Arab Emirates,DU UAE,Transguard Group LLC,API User,E6AEAE17361
2022-02-27 20:10,73211830,"32,055.5660","32,050.6660",05.00 AED,5.00,4.9000,0.1000,566532850,1613694,Success,United Arab Emirates,DU UAE,Transguard Group LLC,API User,E6AEAE17361
2022-02-27 20:12,73211960,"32,050.6660","32,040.8660",10.00 AED,10.00,9.8000,0.2000,566533309,1613700,Success,United Arab Emirates,DU UAE,Transguard Group LLC,API User,E6AEAE22430
2022-02-27 20:19,73212364,"32,040.8660","32,035.9660",05.00 AED,5.00,4.9000,0.1000,566534538,1613711,Success,United Arab Emirates,DU UAE,Transguard Group LLC,API User,E6AEAE17361
2022-02-27 20:21,73212525,"32,035.9660","32,031.0660",05.00 AED,5.00,4.9000,0.1000,566535074,1613718,Success,United Arab Emirates,DU UAE,Transguard Group LLC,API User,E6AEAE17361
2022-02-27 20:25,73212760,"32,031.0660","32,021.2660",10.00 AED,10.00,9.8000,0.2000,566535733,1613727,Success,United Arab Emirates,DU UAE,Transguard Group LLC,API User,E6AEAE22430
2022-02-27 20:29,73213083,"32,021.2660","32,012.4660",100.00 PHP,10.00,8.8000,1.2000,566536640,1613730,Success,Philippines,BS_Globe Philippines,Transguard Group LLC,API User,PH_GB_TopUp_100.00
2022-02-27 20:30,73213176,"32,012.4660","32,007.5660",05.00 AED,5.00,4.9000,0.1000,566536901,1613737,Success,United Arab Emirates,DU UAE,Transguard Group LLC,API User,E6AEAE17361
2022-02-27 20:31,73213186,"32,007.5660","32,002.6660",05.00 AED,5.00,4.9000,0.1000,566536929,1613738,Success,United Arab Emirates,DU UAE,Transguard Group LLC,API User,E6AEAE17361
2022-02-27 20:32,73213302,"32,002.6660","31,992.8660",10.00 AED,10.00,9.8000,0.2000,566537251,1613741,Success,United Arab Emirates,DU UAE,Transguard Group LLC,API User,E6AEAE22430
2022-02-27 20:34,73213433,"31,992.8660","31,983.0660",10.00 AED,10.00,9.8000,0.2000,566537605,1613746,Success,United Arab Emirates,DU UAE,Transguard Group LLC,API User,E6AEAE22430
2022-02-27 20:37,73213553,"31,983.0660","31,973.2660",10.00 AED,10.00,9.8000,0.2000,566538016,1613749,Success,United Arab Emirates,DU UAE,Transguard Group LLC,API User,E6AEAE22430
2022-02-27 20:42,73213909,"31,973.2660","31,963.4660",10.00 AED,10.00,9.8000,0.2000,566539126,1613755,Success,United Arab Emirates,DU UAE,Transguard Group LLC,API User,E6AEAE22430
2022-02-27 20:43,73213973,"31,963.4660","31,953.6660",10.00 AED,10.00,9.8000,0.2000,566539304,1613758,Success,United Arab Emirates,DU UAE,Transguard Group LLC,API User,E6AEAE22430
2022-02-27 20:44,73214077,"31,953.6660","31,948.7660",05.00 AED,5.00,4.9000,0.1000,566539577,1613763,Success,United Arab Emirates,DU UAE,Transguard Group LLC,API User,E6AEAE17361
2022-02-27 20:46,73214206,"31,948.7660","31,938.9660",10.00 AED,10.00,9.8000,0.2000,566540001,1613772,Success,United Arab Emirates,DU UAE,Transguard Group LLC,API User,E6AEAE22430
2022-02-27 20:48,73214333,"31,938.9660","31,934.0660",05.00 AED,5.00,4.9000,0.1000,566540341,1613775,Success,United Arab Emirates,DU UAE,Transguard Group LLC,API User,E6AEAE17361
2022-02-27 20:49,73214389,"31,934.0660","31,929.1660",05.00 AED,5.00,4.9000,0.1000,566540485,1613778,Success,United Arab Emirates,DU UAE,Transguard Group LLC,API User,E6AEAE17361
2022-02-27 20:59,73215108,"31,929.1660","31,924.2660",05.00 AED,5.00,4.9000,0.1000,566542557,1613798,Success,United Arab Emirates,DU UAE,Transguard Group LLC,API User,E6AEAE17361
2022-02-27 21:00,73215178,"31,924.2660","31,914.4660",10.00 AED,10.00,9.8000,0.2000,566542744,1613800,Success,United Arab Emirates,DU UAE,Transguard Group LLC,API User,E6AEAE22430
2022-02-27 21:07,73215625,"31,914.4660","31,909.5660",05.00 AED,5.00,4.9000,0.1000,566544067,1613808,Success,United Arab Emirates,DU UAE,Transguard Group LLC,API User,E6AEAE17361
2022-02-27 21:10,73215851,"31,909.5660","31,904.6660",05.00 AED,5.00,4.9000,0.1000,566544691,1613817,Success,United Arab Emirates,DU UAE,Transguard Group LLC,API User,E6AEAE17361
2022-02-27 21:17,73216302,"31,904.6660","31,894.8660",10.00 AED,10.00,9.8000,0.2000,566545962,1613824,Success,United Arab Emirates,DU UAE,Transguard Group LLC,API User,E6AEAE22430
2022-02-27 21:34,73217339,"31,894.8660","31,885.0660",10.00 AED,10.00,9.8000,0.2000,566549227,1613845,Success,United Arab Emirates,DU UAE,Transguard Group LLC,API User,E6AEAE22430
2022-02-27 21:34,73217351,"31,885.0660","31,876.2660","7,350.82 UGX",10.00,8.8000,1.2000,566549274,1613848,Success,Uganda,MTN Uganda,Transguard Group LLC,API User,UG_MT_TopUp
2022-02-27 21:35,73217376,"31,876.2660","31,871.3660",05.00 AED,5.00,4.9000,0.1000,566549339,1613850,Success,United Arab Emirates,DU UAE,Transguard Group LLC,API User,E6AEAE17361
2022-02-27 21:37,73217528,"31,871.3660","31,866.4660",05.00 AED,5.00,4.9000,0.1000,566549810,1613857,Success,United Arab Emirates,DU UAE,Transguard Group LLC,API User,E6AEAE17361
2022-02-27 21:37,73217531,"31,866.4660","31,861.5660",05.00 AED,5.00,4.9000,0.1000,566549821,1613858,Success,United Arab Emirates,DU UAE,Transguard Group LLC,API User,E6AEAE17361
2022-02-27 21:40,73217700,"31,861.5660","31,856.6660",05.00 AED,5.00,4.9000,0.1000,566550356,1613863,Success,United Arab Emirates,DU UAE,Transguard Group LLC,API User,E6AEAE17361
2022-02-27 21:43,73217887,"31,856.6660","31,846.8660",10.00 AED,10.00,9.8000,0.2000,566550896,1613870,Success,United Arab Emirates,DU UAE,Transguard Group LLC,API User,E6AEAE22430
2022-02-27 21:44,73217939,"31,846.8660","31,841.9660",05.00 AED,5.00,4.9000,0.1000,566551034,1613873,Success,United Arab Emirates,DU UAE,Transguard Group LLC,API User,E6AEAE17361
2022-02-27 21:45,73217989,"31,841.9660","31,822.3660",20.00 AED,20.00,19.6000,0.4000,566551209,1613877,Success,United Arab Emirates,DU UAE,Transguard Group LLC,API User,E6AEAE12938
2022-02-27 21:46,73218047,"31,822.3660","31,818.1860",150.00 PKR,4.75,4.1800,0.5700,566551382,1613879,Success,Pakistan,Jazz Pakistan,Transguard Group LLC,API User,MBPKPK20699
2022-02-27 21:48,73218176,"31,818.1860","31,813.2860",05.00 AED,5.00,4.9000,0.1000,566551713,1613882,Success,United Arab Emirates,DU UAE,Transguard Group LLC,API User,E6AEAE17361
2022-02-27 21:53,73218448,"31,813.2860","31,808.3860",05.00 AED,5.00,4.9000,0.1000,566552660,1613890,Success,United Arab Emirates,DU UAE,Transguard Group LLC,API User,E6AEAE17361
2022-02-27 22:06,73219183,"31,808.3860","31,803.4860",05.00 AED,5.00,4.9000,0.1000,566554960,1613903,Success,United Arab Emirates,DU UAE,Transguard Group LLC,API User,E6AEAE17361
2022-02-27 22:09,73219380,"31,803.4860","31,798.5860",05.00 AED,5.00,4.9000,0.1000,566555459,1613912,Success,United Arab Emirates,DU UAE,Transguard Group LLC,API User,E6AEAE17361
2022-02-27 22:10,73219445,"31,798.5860","31,793.6860",05.00 AED,5.00,4.9000,0.1000,566555699,1613915,Success,United Arab Emirates,DU UAE,Transguard Group LLC,API User,E6AEAE17361
2022-02-27 22:12,73219537,"31,793.6860","31,783.8860",10.00 AED,10.00,9.8000,0.2000,566556001,1613918,Success,United Arab Emirates,DU UAE,Transguard Group LLC,API User,E6AEAE22430
2022-02-27 22:16,73219696,"31,783.8860","31,778.9860",05.00 AED,5.00,4.9000,0.1000,566556558,1613921,Success,United Arab Emirates,DU UAE,Transguard Group LLC,API User,E6AEAE17361
2022-02-27 22:21,73219995,"31,778.9860","31,774.0860",05.00 AED,5.00,4.9000,0.1000,566557483,1613930,Success,United Arab Emirates,DU UAE,Transguard Group LLC,API User,E6AEAE17361
2022-02-27 22:40,73220909,"31,774.0860","31,769.1860",05.00 AED,5.00,4.9000,0.1000,566560597,1613947,Success,United Arab Emirates,DU UAE,Transguard Group LLC,API User,E6AEAE17361
2022-02-27 22:42,73220966,"31,769.1860","31,764.2860",05.00 AED,5.00,4.9000,0.1000,566560759,1613950,Success,United Arab Emirates,DU UAE,Transguard Group LLC,API User,E6AEAE17361
2022-02-27 22:45,73221130,"31,764.2860","31,744.6860",20.00 AED,20.00,19.6000,0.4000,566561380,1613955,Success,United Arab Emirates,DU UAE,Transguard Group LLC,API User,E6AEAE12938
2022-02-27 22:54,73221531,"31,744.6860","31,736.1060",315.00 PKR,9.75,8.5800,1.1700,566562721,1613961,Success,Pakistan,Zong Pakistan,Transguard Group LLC,API User,ZNPKPK29953
2022-02-27 22:55,73221551,"31,736.1060","31,716.5060",20.00 AED,20.00,19.6000,0.4000,566562805,1613964,Success,United Arab Emirates,DU UAE,Transguard Group LLC,API User,E6AEAE12938
2022-02-27 22:55,73221595,"31,716.5060","31,707.7060","7,350.82 UGX",10.00,8.8000,1.2000,566562970,1613967,Success,Uganda,MTN Uganda,Transguard Group LLC,API User,UG_MT_TopUp
2022-02-27 22:58,73221715,"31,707.7060","31,697.9060",10.00 AED,10.00,9.8000,0.2000,566563390,1613971,Success,United Arab Emirates,DU UAE,Transguard Group LLC,API User,E6AEAE22430
2022-02-27 23:23,73222637,"31,697.9060","31,689.5460",300.00 PKR,9.50,8.3600,1.1400,566566933,1613980,Success,Pakistan,Jazz Pakistan,Transguard Group LLC,API User,PK_MB_TopUp_300.00
2022-02-27 23:28,73222842,"31,689.5460","31,684.6460",05.00 AED,5.00,4.9000,0.1000,566567687,1613988,Success,United Arab Emirates,DU UAE,Transguard Group LLC,API User,E6AEAE17361
2022-02-27 23:36,73223101,"31,684.6460","31,675.8460",13.20 GHS,10.00,8.8000,1.2000,566568677,1613996,Success,Ghana,MTN Ghana,Transguard Group LLC,API User,GH_MT_TopUp
2022-02-27 23:36,73223120,"31,675.8460","31,670.9460",05.00 AED,5.00,4.9000,0.1000,566568770,1613999,Success,United Arab Emirates,DU UAE,Transguard Group LLC,API User,E6AEAE17361
2022-02-27 23:51,73223606,"31,670.9460","31,661.1460",10.00 AED,10.00,9.8000,0.2000,566570741,1614006,Success,United Arab Emirates,DU UAE,Transguard Group LLC,API User,E6AEAE22430
2022-02-27 23:52,73223636,"31,661.1460","31,651.3460",10.00 AED,10.00,9.8000,0.2000,566570904,1614009,Success,United Arab Emirates,DU UAE,Transguard Group LLC,API User,E6AEAE22430
2022-02-27 23:59,73223838,"31,651.3460","31,641.5460",10.00 AED,10.00,9.8000,0.2000,566571691,1614015,Success,United Arab Emirates,DU UAE,Transguard Group LLC,API User,E6AEAE22430
2022-02-28 00:10,73224204,"31,641.5460","31,636.6460",05.00 AED,5.00,4.9000,0.1000,566573219,1614019,Success,United Arab Emirates,DU UAE,Transguard Group LLC,API User,E6AEAE17361
2022-02-28 00:19,73224480,"31,636.6460","31,631.7460",05.00 AED,5.00,4.9000,0.1000,566574258,1614022,Success,United Arab Emirates,DU UAE,Transguard Group LLC,API User,E6AEAE17361
2022-02-28 00:22,73224584,"31,631.7460","31,621.9460",10.00 AED,10.00,9.8000,0.2000,566574671,1614025,Success,United Arab Emirates,DU UAE,Transguard Group LLC,API User,E6AEAE22430
2022-02-28 00:30,73224858,"31,621.9460","31,617.0460",05.00 AED,5.00,4.9000,0.1000,566575734,1614032,Success,United Arab Emirates,DU UAE,Transguard Group LLC,API User,E6AEAE17361
2022-02-28 00:48,73225341,"31,617.0460","31,607.2460",10.00 AED,10.00,9.8000,0.2000,566577778,1614037,Success,United Arab Emirates,DU UAE,Transguard Group LLC,API User,E6AEAE22430
2022-02-28 01:26,73226278,"31,607.2460","31,602.3460",05.00 AED,5.00,4.9000,0.1000,566582046,1614044,Success,United Arab Emirates,DU UAE,Transguard Group LLC,API User,E6AEAE17361
2022-02-28 01:27,73226303,"31,602.3460","31,597.4460",05.00 AED,5.00,4.9000,0.1000,566582165,1614048,Success,United Arab Emirates,DU UAE,Transguard Group LLC,API User,E6AEAE17361
2022-02-28 01:34,73226438,"31,597.4460","31,587.6460",10.00 AED,10.00,9.8000,0.2000,566582787,1614054,Success,United Arab Emirates,DU UAE,Transguard Group LLC,API User,E6AEAE22430
2022-02-28 02:05,73227067,"31,587.6460","31,577.8460",10.00 AED,10.00,9.8000,0.2000,566585997,1614057,Success,United Arab Emirates,DU UAE,Transguard Group LLC,API User,E6AEAE22430
2022-02-28 02:31,73227553,"31,577.8460","31,572.9460",05.00 AED,5.00,4.9000,0.1000,566588493,1614062,Success,United Arab Emirates,DU UAE,Transguard Group LLC,API User,E6AEAE17361
2022-02-28 02:51,73227917,"31,572.9460","31,568.0460",05.00 AED,5.00,4.9000,0.1000,566590281,1614070,Success,United Arab Emirates,DU UAE,Transguard Group LLC,API User,E6AEAE17361
2022-02-28 02:56,73228015,"31,568.0460","31,563.1460",05.00 AED,5.00,4.9000,0.1000,566590706,1614073,Success,United Arab Emirates,DU UAE,Transguard Group LLC,API User,E6AEAE17361
2022-02-28 03:02,73228134,"31,563.1460","31,553.3460",10.00 AED,10.00,9.8000,0.2000,566591286,1614079,Success,United Arab Emirates,DU UAE,Transguard Group LLC,API User,E6AEAE22430
2022-02-28 03:21,73228472,"31,553.3460","31,548.4460",05.00 AED,5.00,4.9000,0.1000,566593093,1614082,Success,United Arab Emirates,DU UAE,Transguard Group LLC,API User,E6AEAE17361
2022-02-28 03:23,73228519,"31,548.4460","31,543.5460",05.00 AED,5.00,4.9000,0.1000,566593278,1614086,Success,United Arab Emirates,DU UAE,Transguard Group LLC,API User,E6AEAE17361
2022-02-28 03:33,73228689,"31,543.5460","31,538.6460",05.00 AED,5.00,4.9000,0.1000,566594157,1614092,Success,United Arab Emirates,DU UAE,Transguard Group LLC,API User,E6AEAE17361
2022-02-28 03:35,73228722,"31,538.6460","31,533.7460",05.00 AED,5.00,4.9000,0.1000,566594355,1614095,Success,United Arab Emirates,DU UAE,Transguard Group LLC,API User,E6AEAE17361
2022-02-28 04:30,73229712,"31,533.7460","31,528.8460",05.00 AED,5.00,4.9000,0.1000,566599350,1614104,Success,United Arab Emirates,DU UAE,Transguard Group LLC,API User,E6AEAE17361
2022-02-28 04:47,73229974,"31,528.8460","31,523.9460",05.00 AED,5.00,4.9000,0.1000,566600757,1614109,Success,United Arab Emirates,DU UAE,Transguard Group LLC,API User,E6AEAE17361
2022-02-28 05:01,73230206,"31,523.9460","31,514.1460",10.00 AED,10.00,9.8000,0.2000,566601997,1614126,Success,United Arab Emirates,DU UAE,Transguard Group LLC,API User,E6AEAE22430
2022-02-28 05:22,73230591,"31,514.1460","31,504.3460",10.00 AED,10.00,9.8000,0.2000,566603681,1614148,Success,United Arab Emirates,DU UAE,Transguard Group LLC,API User,E6AEAE22430
2022-02-28 05:23,73230603,"31,504.3460","31,499.4460",05.00 AED,5.00,4.9000,0.1000,566603728,1614153,Success,United Arab Emirates,DU UAE,Transguard Group LLC,API User,E6AEAE17361
2022-02-28 05:24,73230616,"31,499.4460","31,494.5460",05.00 AED,5.00,4.9000,0.1000,566603797,1614157,Success,United Arab Emirates,DU UAE,Transguard Group LLC,API User,E6AEAE17361
2022-02-28 05:29,73230696,"31,494.5460","31,484.7460",10.00 AED,10.00,9.8000,0.2000,566604143,1614164,Success,United Arab Emirates,DU UAE,Transguard Group LLC,API User,E6AEAE22430
2022-02-28 05:46,73231002,"31,484.7460","31,474.9460",10.00 AED,10.00,9.8000,0.2000,566605421,1614175,Success,United Arab Emirates,DU UAE,Transguard Group LLC,API User,E6AEAE22430
2022-02-28 05:55,73231158,"31,474.9460","31,465.1460",10.00 AED,10.00,9.8000,0.2000,566606052,1614182,Success,United Arab Emirates,DU UAE,Transguard Group LLC,API User,E6AEAE22430
2022-02-28 05:57,73231198,"31,465.1460","31,455.3460",10.00 AED,10.00,9.8000,0.2000,566606195,1614192,Success,United Arab Emirates,DU UAE,Transguard Group LLC,API User,E6AEAE22430
2022-02-28 05:57,73231203,"31,455.3460","31,445.5460",10.00 AED,10.00,9.8000,0.2000,566606205,1614194,Success,United Arab Emirates,DU UAE,Transguard Group LLC,API User,E6AEAE22430
2022-02-28 05:59,73231271,"31,445.5460","31,440.6460",05.00 AED,5.00,4.9000,0.1000,566606429,1614197,Success,United Arab Emirates,DU UAE,Transguard Group LLC,API User,E6AEAE17361
2022-02-28 06:01,73231328,"31,440.6460","31,435.7460",05.00 AED,5.00,4.9000,0.1000,566606581,1614200,Success,United Arab Emirates,DU UAE,Transguard Group LLC,API User,E6AEAE17361
2022-02-28 06:10,73231505,"31,435.7460","31,430.8460",05.00 AED,5.00,4.9000,0.1000,566607185,1614212,Success,United Arab Emirates,DU UAE,Transguard Group LLC,API User,E6AEAE17361
2022-02-28 06:13,73231576,"31,430.8460","31,425.9460",05.00 AED,5.00,4.9000,0.1000,566607430,1614218,Success,United Arab Emirates,DU UAE,Transguard Group LLC,API User,E6AEAE17361
2022-02-28 06:16,73231645,"31,425.9460","31,416.1460",10.00 AED,10.00,9.8000,0.2000,566607657,1614223,Success,United Arab Emirates,DU UAE,Transguard Group LLC,API User,E6AEAE22430
2022-02-28 06:18,73231698,"31,416.1460","31,406.3460",10.00 AED,10.00,9.8000,0.2000,566607810,1614226,Success,United Arab Emirates,DU UAE,Transguard Group LLC,API User,E6AEAE22430
2022-02-28 06:26,73231885,"31,406.3460","31,396.5460",10.00 AED,10.00,9.8000,0.2000,566608397,1614237,Success,United Arab Emirates,DU UAE,Transguard Group LLC,API User,E6AEAE22430
2022-02-28 06:28,73231929,"31,396.5460","31,386.7460",10.00 AED,10.00,9.8000,0.2000,566608563,1614240,Success,United Arab Emirates,DU UAE,Transguard Group LLC,API User,E6AEAE22430
2022-02-28 06:43,73232282,"31,386.7460","31,376.9460",10.00 AED,10.00,9.8000,0.2000,566609710,1614245,Success,United Arab Emirates,DU UAE,Transguard Group LLC,API User,E6AEAE22430
2022-02-28 06:48,73232410,"31,376.9460","31,342.6460",35.00 AED,35.00,34.3000,0.7000,566610061,1614248,Success,United Arab Emirates,DU UAE,Transguard Group LLC,API User,E6AEAE73954
2022-02-28 06:48,73232424,"31,342.6460","31,337.7460",05.00 AED,5.00,4.9000,0.1000,566610100,1614251,Success,United Arab Emirates,DU UAE,Transguard Group LLC,API User,E6AEAE17361
2022-02-28 06:52,73232526,"31,337.7460","31,332.8460",05.00 AED,5.00,4.9000,0.1000,566610417,1614255,Success,United Arab Emirates,DU UAE,Transguard Group LLC,API User,E6AEAE17361
2022-02-28 06:54,73232566,"31,332.8460","31,327.9460",05.00 AED,5.00,4.9000,0.1000,566610524,1614261,Success,United Arab Emirates,DU UAE,Transguard Group LLC,API User,E6AEAE17361
2022-02-28 06:54,73232571,"31,327.9460","31,323.0460",05.00 AED,5.00,4.9000,0.1000,566610552,1614263,Success,United Arab Emirates,DU UAE,Transguard Group LLC,API User,E6AEAE17361
2022-02-28 07:07,73232860,"31,323.0460","31,313.2460",10.00 AED,10.00,9.8000,0.2000,566611489,1614280,Failure,United Arab Emirates,DU UAE,Transguard Group LLC,API User,E6AEAE22430
2022-02-28 07:07,73232860,"31,313.2460","31,303.4460",10.00 AED,10.00,9.8000,0.2000,566611489,1614280,Failure,United Arab Emirates,DU UAE,Transguard Group LLC,API User,E6AEAE22430
2022-02-28 07:10,73232943,"31,323.0460","31,318.1460",05.00 AED,5.00,4.9000,0.1000,566611795,1614287,Success,United Arab Emirates,DU UAE,Transguard Group LLC,API User,E6AEAE17361
2022-02-28 07:12,73232986,"31,318.1460","31,298.5460",20.00 AED,20.00,19.6000,0.4000,566611938,1614290,Success,United Arab Emirates,DU UAE,Transguard Group LLC,API User,E6AEAE12938
2022-02-28 07:17,73233084,"31,298.5460","31,293.6460",05.00 AED,5.00,4.9000,0.1000,566612260,1614297,Success,United Arab Emirates,DU UAE,Transguard Group LLC,API User,E6AEAE17361
2022-02-28 07:22,73233203,"31,293.6460","31,276.2660",299.00 INR,19.75,17.3800,2.3700,566612653,1614302,Success,India,Airtel India,Transguard Group LLC,API User,AIININ55294
2022-02-28 07:24,73233264,"31,276.2660","31,271.3660",05.00 AED,5.00,4.9000,0.1000,566612806,1614305,Success,United Arab Emirates,DU UAE,Transguard Group LLC,API User,E6AEAE17361
2022-02-28 07:25,73233300,"31,271.3660","31,261.5660",10.00 AED,10.00,9.8000,0.2000,566612893,1614310,Success,United Arab Emirates,DU UAE,Transguard Group LLC,API User,E6AEAE22430
2022-02-28 07:25,73233304,"31,261.5660","31,256.6660",05.00 AED,5.00,4.9000,0.1000,566612899,1614311,Success,United Arab Emirates,DU UAE,Transguard Group LLC,API User,E6AEAE17361
2022-02-28 07:28,73233395,"31,256.6660","31,251.7660",05.00 AED,5.00,4.9000,0.1000,566613121,1614320,Success,United Arab Emirates,DU UAE,Transguard Group LLC,API User,E6AEAE17361
2022-02-28 07:29,73233428,"31,251.7660","31,246.8660",05.00 AED,5.00,4.9000,0.1000,566613221,1614323,Success,United Arab Emirates,DU UAE,Transguard Group LLC,API User,E6AEAE17361
2022-02-28 07:33,73233496,"31,246.8660","31,237.0660",10.00 AED,10.00,9.8000,0.2000,566613492,1614326,Success,United Arab Emirates,DU UAE,Transguard Group LLC,API User,E6AEAE22430
2022-02-28 07:38,73233623,"31,237.0660","31,232.1660",05.00 AED,5.00,4.9000,0.1000,566613897,1614335,Success,United Arab Emirates,DU UAE,Transguard Group LLC,API User,E6AEAE17361
2022-02-28 07:38,73233627,"31,232.1660","31,227.2660",05.00 AED,5.00,4.9000,0.1000,566613925,1614338,Success,United Arab Emirates,DU UAE,Transguard Group LLC,API User,E6AEAE17361
2022-02-28 07:40,73233655,"31,227.2660","31,217.4660",10.00 AED,10.00,9.8000,0.2000,566614019,1614341,Success,United Arab Emirates,DU UAE,Transguard Group LLC,API User,E6AEAE22430
2022-02-28 07:41,73233680,"31,217.4660","31,212.5660",05.00 AED,5.00,4.9000,0.1000,566614100,1614344,Success,United Arab Emirates,DU UAE,Transguard Group LLC,API User,E6AEAE17361
2022-02-28 07:41,73233694,"31,212.5660","31,207.6660",05.00 AED,5.00,4.9000,0.1000,566614149,1614347,Success,United Arab Emirates,DU UAE,Transguard Group LLC,API User,E6AEAE17361
2022-02-28 07:48,73233856,"31,207.6660","31,202.7660",05.00 AED,5.00,4.9000,0.1000,566614620,1614355,Success,United Arab Emirates,DU UAE,Transguard Group LLC,API User,E6AEAE17361
2022-02-28 07:50,73233916,"31,202.7660","31,197.8660",05.00 AED,5.00,4.9000,0.1000,566614818,1614363,Success,United Arab Emirates,DU UAE,Transguard Group LLC,API User,E6AEAE17361
2022-02-28 07:54,73234018,"31,197.8660","31,192.9660",05.00 AED,5.00,4.9000,0.1000,566615097,1614368,Success,United Arab Emirates,DU UAE,Transguard Group LLC,API User,E6AEAE17361
2022-02-28 07:56,73234075,"31,192.9660","31,183.1660",10.00 AED,10.00,9.8000,0.2000,566615286,1614374,Success,United Arab Emirates,DU UAE,Transguard Group LLC,API User,E6AEAE22430
2022-02-28 07:56,73234078,"31,183.1660","31,178.2660",05.00 AED,5.00,4.9000,0.1000,566615295,1614375,Success,United Arab Emirates,DU UAE,Transguard Group LLC,API User,E6AEAE17361
2022-02-28 07:59,73234151,"31,178.2660","31,158.6660",20.00 AED,20.00,19.6000,0.4000,566615466,1614382,Success,United Arab Emirates,DU UAE,Transguard Group LLC,API User,E6AEAE12938
2022-02-28 08:02,73234229,"31,158.6660","31,119.4660",40.00 AED,40.00,39.2000,0.8000,566615669,1614387,Success,United Arab Emirates,DU UAE,Transguard Group LLC,API User,E6AEAE64011
2022-02-28 08:05,73234317,"31,119.4660","31,109.6660",10.00 AED,10.00,9.8000,0.2000,566615890,1614394,Success,United Arab Emirates,DU UAE,Transguard Group LLC,API User,E6AEAE22430
2022-02-28 08:06,73234336,"31,109.6660","31,104.7660",05.00 AED,5.00,4.9000,0.1000,566615965,1614397,Success,United Arab Emirates,DU UAE,Transguard Group LLC,API User,E6AEAE17361
2022-02-28 08:08,73234376,"31,104.7660","31,099.8660",05.00 AED,5.00,4.9000,0.1000,566616114,1614402,Success,United Arab Emirates,DU UAE,Transguard Group LLC,API User,E6AEAE17361
2022-02-28 08:12,73234473,"31,099.8660","31,094.9660",05.00 AED,5.00,4.9000,0.1000,566616384,1614405,Success,United Arab Emirates,DU UAE,Transguard Group LLC,API User,E6AEAE17361
2022-02-28 08:14,73234557,"31,094.9660","31,085.1660",10.00 AED,10.00,9.8000,0.2000,566616588,1614408,Success,United Arab Emirates,DU UAE,Transguard Group LLC,API User,E6AEAE22430
2022-02-28 08:17,73234632,"31,085.1660","31,075.3660",10.00 AED,10.00,9.8000,0.2000,566616765,1614413,Success,United Arab Emirates,DU UAE,Transguard Group LLC,API User,E6AEAE22430
2022-02-28 08:17,73234648,"31,075.3660","31,070.4660",05.00 AED,5.00,4.9000,0.1000,566616804,1614416,Success,United Arab Emirates,DU UAE,Transguard Group LLC,API User,E6AEAE17361
2022-02-28 08:19,73234694,"31,070.4660","31,065.5660",05.00 AED,5.00,4.9000,0.1000,566616923,1614423,Success,United Arab Emirates,DU UAE,Transguard Group LLC,API User,E6AEAE17361
2022-02-28 08:23,73234826,"31,065.5660","31,060.6660",05.00 AED,5.00,4.9000,0.1000,566617276,1614436,Success,United Arab Emirates,DU UAE,Transguard Group LLC,API User,E6AEAE17361
2022-02-28 08:27,73234943,"31,060.6660","31,055.7660",05.00 AED,5.00,4.9000,0.1000,566617582,1614441,Success,United Arab Emirates,DU UAE,Transguard Group LLC,API User,E6AEAE17361
2022-02-28 08:27,73234968,"31,055.7660","31,050.8660",05.00 AED,5.00,4.9000,0.1000,566617648,1614444,Success,United Arab Emirates,DU UAE,Transguard Group LLC,API User,E6AEAE17361
2022-02-28 08:29,73235009,"31,050.8660","31,045.9660",05.00 AED,5.00,4.9000,0.1000,566617788,1614451,Success,United Arab Emirates,DU UAE,Transguard Group LLC,API User,E6AEAE17361
2022-02-28 08:31,73235050,"31,045.9660","31,041.0660",05.00 AED,5.00,4.9000,0.1000,566617908,1614456,Success,United Arab Emirates,DU UAE,Transguard Group LLC,API User,E6AEAE17361
2022-02-28 08:33,73235118,"31,041.0660","31,036.1660",05.00 AED,5.00,4.9000,0.1000,566618097,1614459,Success,United Arab Emirates,DU UAE,Transguard Group LLC,API User,E6AEAE17361
2022-02-28 08:34,73235165,"31,036.1660","31,031.2660",05.00 AED,5.00,4.9000,0.1000,566618202,1614464,Success,United Arab Emirates,DU UAE,Transguard Group LLC,API User,E6AEAE17361
2022-02-28 08:35,73235192,"31,031.2660","31,021.4660",10.00 AED,10.00,9.8000,0.2000,566618251,1614468,Success,United Arab Emirates,DU UAE,Transguard Group LLC,API User,E6AEAE22430
2022-02-28 08:46,73235518,"31,021.4660","31,016.5660",05.00 AED,5.00,4.9000,0.1000,566619095,1614483,Success,United Arab Emirates,DU UAE,Transguard Group LLC,API User,E6AEAE17361
2022-02-28 08:48,73235580,"31,016.5660","31,006.7660",10.00 AED,10.00,9.8000,0.2000,566619266,1614486,Success,United Arab Emirates,DU UAE,Transguard Group LLC,API User,E6AEAE22430
2022-02-28 08:50,73235639,"31,006.7660","31,001.8660",05.00 AED,5.00,4.9000,0.1000,566619396,1614490,Success,United Arab Emirates,DU UAE,Transguard Group LLC,API User,E6AEAE17361
2022-02-28 08:51,73235693,"31,001.8660","30,992.0660",10.00 AED,10.00,9.8000,0.2000,566619532,1614494,Success,United Arab Emirates,DU UAE,Transguard Group LLC,API User,E6AEAE22430
2022-02-28 08:55,73235806,"30,992.0660","30,987.1660",05.00 AED,5.00,4.9000,0.1000,566619845,1614503,Success,United Arab Emirates,DU UAE,Transguard Group LLC,API User,E6AEAE17361
2022-02-28 08:57,73235856,"30,987.1660","30,977.3660",10.00 AED,10.00,9.8000,0.2000,566619995,1614506,Success,United Arab Emirates,DU UAE,Transguard Group LLC,API User,E6AEAE22430
2022-02-28 09:03,73236061,"30,977.3660","30,968.7860",315.00 PKR,9.75,8.5800,1.1700,566620488,1614514,Success,Pakistan,Zong Pakistan,Transguard Group LLC,API User,ZNPKPK29953
2022-02-28 09:05,73236107,"30,968.7860","30,963.8860",05.00 AED,5.00,4.9000,0.1000,566620621,1614520,Success,United Arab Emirates,DU UAE,Transguard Group LLC,API User,E6AEAE17361
2022-02-28 09:07,73236144,"30,963.8860","30,958.9860",05.00 AED,5.00,4.9000,0.1000,566620726,1614524,Success,United Arab Emirates,DU UAE,Transguard Group LLC,API User,E6AEAE17361
2022-02-28 09:08,73236195,"30,958.9860","30,954.0860",05.00 AED,5.00,4.9000,0.1000,566620836,1614530,Success,United Arab Emirates,DU UAE,Transguard Group LLC,API User,E6AEAE17361
2022-02-28 09:08,73236205,"30,954.0860","30,949.1860",05.00 AED,5.00,4.9000,0.1000,566620861,1614532,Success,United Arab Emirates,DU UAE,Transguard Group LLC,API User,E6AEAE17361
2022-02-28 09:09,73236239,"30,949.1860","30,944.2860",05.00 AED,5.00,4.9000,0.1000,566620958,1614537,Success,United Arab Emirates,DU UAE,Transguard Group LLC,API User,E6AEAE17361
2022-02-28 09:11,73236279,"30,944.2860","30,934.4860",10.00 AED,10.00,9.8000,0.2000,566621072,1614542,Success,United Arab Emirates,DU UAE,Transguard Group LLC,API User,E6AEAE22430
2022-02-28 09:11,73236288,"30,934.4860","30,929.5860",05.00 AED,5.00,4.9000,0.1000,566621090,1614543,Success,United Arab Emirates,DU UAE,Transguard Group LLC,API User,E6AEAE17361
2022-02-28 09:12,73236333,"30,929.5860","30,919.7860",10.00 AED,10.00,9.8000,0.2000,566621213,1614546,Success,United Arab Emirates,DU UAE,Transguard Group LLC,API User,E6AEAE22430
2022-02-28 09:13,73236350,"30,919.7860","30,914.8860",05.00 AED,5.00,4.9000,0.1000,566621259,1614549,Success,United Arab Emirates,DU UAE,Transguard Group LLC,API User,E6AEAE17361
2022-02-28 09:17,73236479,"30,914.8860","30,909.9860",05.00 AED,5.00,4.9000,0.1000,566621538,1614560,Success,United Arab Emirates,DU UAE,Transguard Group LLC,API User,E6AEAE17361
2022-02-28 09:19,73236566,"30,909.9860","30,905.0860",05.00 AED,5.00,4.9000,0.1000,566621759,1614565,Success,United Arab Emirates,DU UAE,Transguard Group LLC,API User,E6AEAE17361
2022-02-28 09:20,73236596,"30,905.0860","30,900.1860",05.00 AED,5.00,4.9000,0.1000,566621836,1614569,Success,United Arab Emirates,DU UAE,Transguard Group LLC,API User,E6AEAE17361
2022-02-28 09:21,73236613,"30,900.1860","30,895.2860",05.00 AED,5.00,4.9000,0.1000,566621884,1614572,Success,United Arab Emirates,DU UAE,Transguard Group LLC,API User,E6AEAE17361
2022-02-28 09:21,73236619,"30,895.2860","30,885.4860",10.00 AED,10.00,9.8000,0.2000,566621895,1614574,Success,United Arab Emirates,DU UAE,Transguard Group LLC,API User,E6AEAE22430
2022-02-28 09:29,73236892,"30,885.4860","30,880.5860",05.00 AED,5.00,4.9000,0.1000,566622622,1614584,Success,United Arab Emirates,DU UAE,Transguard Group LLC,API User,E6AEAE17361
2022-02-28 09:30,73236893,"30,880.5860","30,875.6860",05.00 AED,5.00,4.9000,0.1000,566622625,1614585,Success,United Arab Emirates,DU UAE,Transguard Group LLC,API User,E6AEAE17361
2022-02-28 09:30,73236895,"30,875.6860","30,865.8860",10.00 AED,10.00,9.8000,0.2000,566622649,73236895,Success,United Arab Emirates,DU UAE,Transguard Group LLC,mohammed.arafath@transguardgroup.com,E6AEAE22430
2022-02-28 09:30,73236905,"30,865.8860","30,856.0860",10.00 AED,10.00,9.8000,0.2000,566622658,1614587,Success,United Arab Emirates,DU UAE,Transguard Group LLC,API User,E6AEAE22430
2022-02-28 09:33,73237024,"30,856.0860","30,851.1860",05.00 AED,5.00,4.9000,0.1000,566622963,1614593,Success,United Arab Emirates,DU UAE,Transguard Group LLC,API User,E6AEAE17361
2022-02-28 09:34,73237068,"30,851.1860","30,841.3860",10.00 AED,10.00,9.8000,0.2000,566623064,73237068,Success,United Arab Emirates,DU UAE,Transguard Group LLC,mohammed.arafath@transguardgroup.com,E6AEAE22430
2022-02-28 09:39,73237235,"30,841.3860","30,831.5860",10.00 AED,10.00,9.8000,0.2000,566623476,1614599,Success,United Arab Emirates,DU UAE,Transguard Group LLC,API User,E6AEAE22430
2022-02-28 09:39,73237241,"30,831.5860","30,826.6860",05.00 AED,5.00,4.9000,0.1000,566623495,1614602,Success,United Arab Emirates,DU UAE,Transguard Group LLC,API User,E6AEAE17361
2022-02-28 09:41,73237314,"30,826.6860","30,816.8860",10.00 AED,10.00,9.8000,0.2000,566623659,1614606,Success,United Arab Emirates,DU UAE,Transguard Group LLC,API User,E6AEAE22430
2022-02-28 09:44,73237423,"30,816.8860","30,811.9860",05.00 AED,5.00,4.9000,0.1000,566623913,1614611,Success,United Arab Emirates,DU UAE,Transguard Group LLC,API User,E6AEAE17361
2022-02-28 09:48,73237544,"30,811.9860","30,802.1860",10.00 AED,10.00,9.8000,0.2000,566624202,1614617,Success,United Arab Emirates,DU UAE,Transguard Group LLC,API User,E6AEAE22430
2022-02-28 09:54,73237720,"30,802.1860","30,792.3860",10.00 AED,10.00,9.8000,0.2000,566624670,73237720,Failure,United Arab Emirates,DU UAE,Transguard Group LLC,mohammed.arafath@transguardgroup.com,E6AEAE22430
2022-02-28 09:54,73237720,"30,792.3860","30,782.5860",10.00 AED,10.00,9.8000,0.2000,566624670,73237720,Failure,United Arab Emirates,DU UAE,Transguard Group LLC,mohammed.arafath@transguardgroup.com,E6AEAE22430
2022-02-28 09:57,73237832,"30,802.1860","30,797.2860",05.00 AED,5.00,4.9000,0.1000,566624955,1614631,Success,United Arab Emirates,DU UAE,Transguard Group LLC,API User,E6AEAE17361
2022-02-28 09:58,73237869,"30,797.2860","30,787.4860",10.00 AED,10.00,9.8000,0.2000,566625039,1614636,Success,United Arab Emirates,DU UAE,Transguard Group LLC,API User,E6AEAE22430
2022-02-28 10:00,73237912,"30,787.4860","30,777.6860",10.00 AED,10.00,9.8000,0.2000,566625156,1614640,Success,United Arab Emirates,DU UAE,Transguard Group LLC,API User,E6AEAE22430
2022-02-28 10:01,73237973,"30,777.6860","30,758.0860",20.00 AED,20.00,19.6000,0.4000,566625320,1614643,Success,United Arab Emirates,DU UAE,Transguard Group LLC,API User,E6AEAE12938
2022-02-28 10:04,73238084,"30,758.0860","30,753.1860",05.00 AED,5.00,4.9000,0.1000,566625579,1614655,Success,United Arab Emirates,DU UAE,Transguard Group LLC,API User,E6AEAE17361
2022-02-28 10:05,73238099,"30,753.1860","30,748.2860",05.00 AED,5.00,4.9000,0.1000,566625615,1614657,Success,United Arab Emirates,DU UAE,Transguard Group LLC,API User,E6AEAE17361
2022-02-28 10:10,73238265,"30,748.2860","30,738.4860",10.00 AED,10.00,9.8000,0.2000,566626037,1614661,Success,United Arab Emirates,DU UAE,Transguard Group LLC,API User,E6AEAE22430
2022-02-28 10:12,73238331,"30,738.4860","30,730.1260",300.00 PKR,9.50,8.3600,1.1400,566626181,1614667,Success,Pakistan,Ufone Pakistan,Transguard Group LLC,API User,PK_UF_TopUp_300.00
2022-02-28 10:12,73238334,"30,730.1260","30,715.4260",15.00 AED,15.00,14.7000,0.3000,566626182,1614668,Success,United Arab Emirates,DU UAE,Transguard Group LLC,API User,E6AEAE8527
2022-02-28 10:13,73238386,"30,715.4260","30,710.5260",05.00 AED,5.00,4.9000,0.1000,566626313,1614672,Success,United Arab Emirates,DU UAE,Transguard Group LLC,API User,E6AEAE17361
2022-02-28 10:15,73238454,"30,710.5260","30,705.6260",05.00 AED,5.00,4.9000,0.1000,566626479,1614678,Success,United Arab Emirates,DU UAE,Transguard Group LLC,API User,E6AEAE17361
2022-02-28 10:16,73238494,"30,705.6260","30,700.7260",05.00 AED,5.00,4.9000,0.1000,566626575,1614681,Success,United Arab Emirates,DU UAE,Transguard Group LLC,API User,E6AEAE17361
2022-02-28 10:18,73238563,"30,700.7260","30,690.9260",10.00 AED,10.00,9.8000,0.2000,566626768,73238563,Success,United Arab Emirates,DU UAE,Transguard Group LLC,mohammed.arafath@transguardgroup.com,E6AEAE22430
2022-02-28 10:30,73238995,"30,690.9260","30,686.0260",05.00 AED,5.00,4.9000,0.1000,566627826,1614703,Success,United Arab Emirates,DU UAE,Transguard Group LLC,API User,E6AEAE17361
2022-02-28 10:30,73239001,"30,686.0260","30,681.1260",05.00 AED,5.00,4.9000,0.1000,566627842,1614706,Success,United Arab Emirates,DU UAE,Transguard Group LLC,API User,E6AEAE17361
2022-02-28 10:32,73239069,"30,681.1260","30,671.3260",10.00 AED,10.00,9.8000,0.2000,566628006,1614710,Success,United Arab Emirates,DU UAE,Transguard Group LLC,API User,E6AEAE22430
2022-02-28 10:33,73239095,"30,671.3260","30,666.4260",05.00 AED,5.00,4.9000,0.1000,566628093,1614717,Success,United Arab Emirates,DU UAE,Transguard Group LLC,API User,E6AEAE17361
2022-02-28 10:44,73239486,"30,666.4260","30,627.2260",40.00 AED,40.00,39.2000,0.8000,566629049,1614726,Success,United Arab Emirates,DU UAE,Transguard Group LLC,API User,E6AEAE64011
2022-02-28 10:45,73239544,"30,627.2260","30,612.5260",15.00 AED,15.00,14.7000,0.3000,566629179,1614734,Success,United Arab Emirates,DU UAE,Transguard Group LLC,API User,E6AEAE8527
2022-02-28 10:47,73239646,"30,612.5260","30,607.6260",05.00 AED,5.00,4.9000,0.1000,566629396,1614737,Success,United Arab Emirates,DU UAE,Transguard Group LLC,API User,E6AEAE17361
2022-02-28 10:52,73239823,"30,607.6260","30,602.7260",05.00 AED,5.00,4.9000,0.1000,566629846,1614750,Success,United Arab Emirates,DU UAE,Transguard Group LLC,API User,E6AEAE17361
2022-02-28 10:56,73239950,"30,602.7260","30,597.8260",05.00 AED,5.00,4.9000,0.1000,566630156,1614755,Success,United Arab Emirates,DU UAE,Transguard Group LLC,API User,E6AEAE17361
2022-02-28 10:57,73239981,"30,597.8260","30,592.9260",05.00 AED,5.00,4.9000,0.1000,566630247,1614758,Success,United Arab Emirates,DU UAE,Transguard Group LLC,API User,E6AEAE17361
2022-02-28 11:06,73240263,"30,592.9260","30,583.1260",10.00 AED,10.00,9.8000,0.2000,566630998,1614767,Success,United Arab Emirates,DU UAE,Transguard Group LLC,API User,E6AEAE22430
2022-02-28 11:06,73240287,"30,583.1260","30,578.2260",05.00 AED,5.00,4.9000,0.1000,566631054,73240287,Failure,United Arab Emirates,DU UAE,Transguard Group LLC,mohammed.arafath@transguardgroup.com,E6AEAE17361
2022-02-28 11:06,73240287,"30,578.2260","30,573.3260",05.00 AED,5.00,4.9000,0.1000,566631054,73240287,Failure,United Arab Emirates,DU UAE,Transguard Group LLC,mohammed.arafath@transguardgroup.com,E6AEAE17361
2022-02-28 11:07,73240326,"30,583.1260","30,578.2010",05.00 AED,5.00,4.9250,0.0750,566631155,73240326,Success,United Arab Emirates,Etisalat UAE,Transguard Group LLC,mohammed.arafath@transguardgroup.com,ETAEAE54031
2022-02-28 11:13,73240594,"30,578.2010","30,573.3010",05.00 AED,5.00,4.9000,0.1000,566631734,1614776,Success,United Arab Emirates,DU UAE,Transguard Group LLC,API User,E6AEAE17361
2022-02-28 11:14,73240631,"30,573.3010","30,569.5610",100.00 NPR,4.25,3.7400,0.5100,566631807,1614779,Success,Nepal,Ncell Nepal,Transguard Group LLC,API User,NP_NC_TopUp_100.00
2022-02-28 11:18,73240812,"30,569.5610","30,559.7610",10.00 AED,10.00,9.8000,0.2000,566632188,1614785,Success,United Arab Emirates,DU UAE,Transguard Group LLC,API User,E6AEAE22430
2022-02-28 11:22,73240942,"30,559.7610","30,549.9610",10.00 AED,10.00,9.8000,0.2000,566632532,1614788,Success,United Arab Emirates,DU UAE,Transguard Group LLC,API User,E6AEAE22430
2022-02-28 11:27,73241142,"30,549.9610","30,540.1610",10.00 AED,10.00,9.8000,0.2000,566632957,1614795,Success,United Arab Emirates,DU UAE,Transguard Group LLC,API User,E6AEAE22430
2022-02-28 11:28,73241216,"30,540.1610","30,535.2610",05.00 AED,5.00,4.9000,0.1000,566633093,1614801,Success,United Arab Emirates,DU UAE,Transguard Group LLC,API User,E6AEAE17361
2022-02-28 11:28,73241235,"30,535.2610","30,530.3610",05.00 AED,5.00,4.9000,0.1000,566633125,1614803,Success,United Arab Emirates,DU UAE,Transguard Group LLC,API User,E6AEAE17361
2022-02-28 11:33,73241422,"30,530.3610","30,525.4610",05.00 AED,5.00,4.9000,0.1000,566633551,1614810,Success,United Arab Emirates,DU UAE,Transguard Group LLC,API User,E6AEAE17361
2022-02-28 11:38,73241590,"30,525.4610","30,520.5610",05.00 AED,5.00,4.9000,0.1000,566633959,1614815,Success,United Arab Emirates,DU UAE,Transguard Group LLC,API User,E6AEAE17361
2022-02-28 11:43,73241760,"30,520.5610","30,515.6610",05.00 AED,5.00,4.9000,0.1000,566634407,1614828,Success,United Arab Emirates,DU UAE,Transguard Group LLC,API User,E6AEAE17361
2022-02-28 11:43,73241763,"30,515.6610","30,505.8610",10.00 AED,10.00,9.8000,0.2000,566634415,1614829,Success,United Arab Emirates,DU UAE,Transguard Group LLC,API User,E6AEAE22430
2022-02-28 11:47,73241889,"30,505.8610","30,500.9610",05.00 AED,5.00,4.9000,0.1000,566634723,1614837,Success,United Arab Emirates,DU UAE,Transguard Group LLC,API User,E6AEAE17361
2022-02-28 11:47,73241901,"30,500.9610","30,496.0610",05.00 AED,5.00,4.9000,0.1000,566634756,1614839,Success,United Arab Emirates,DU UAE,Transguard Group LLC,API User,E6AEAE17361
2022-02-28 11:57,73242281,"30,496.0610","30,491.1610",05.00 AED,5.00,4.9000,0.1000,566635628,1614850,Success,United Arab Emirates,DU UAE,Transguard Group LLC,API User,E6AEAE17361
2022-02-28 11:58,73242316,"30,491.1610","30,486.2610",05.00 AED,5.00,4.9000,0.1000,566635716,1614856,Success,United Arab Emirates,DU UAE,Transguard Group LLC,API User,E6AEAE17361
2022-02-28 12:04,73242533,"30,486.2610","30,481.3610",05.00 AED,5.00,4.9000,0.1000,566636222,1614867,Success,United Arab Emirates,DU UAE,Transguard Group LLC,API User,E6AEAE17361
2022-02-28 12:09,73242729,"30,481.3610","30,476.4610",05.00 AED,5.00,4.9000,0.1000,566636661,1614876,Success,United Arab Emirates,DU UAE,Transguard Group LLC,API User,E6AEAE17361
2022-02-28 12:09,73242730,"30,476.4610","30,471.5610",05.00 AED,5.00,4.9000,0.1000,566636666,1614877,Success,United Arab Emirates,DU UAE,Transguard Group LLC,API User,E6AEAE17361
2022-02-28 12:10,73242761,"30,471.5610","30,466.6610",05.00 AED,5.00,4.9000,0.1000,566636744,1614882,Success,United Arab Emirates,DU UAE,Transguard Group LLC,API User,E6AEAE17361
2022-02-28 12:10,73242766,"30,466.6610","30,461.7610",05.00 AED,5.00,4.9000,0.1000,566636755,1614883,Success,United Arab Emirates,DU UAE,Transguard Group LLC,API User,E6AEAE17361
2022-02-28 12:11,73242834,"30,461.7610","30,451.9610",10.00 AED,10.00,9.8000,0.2000,566636903,1614888,Success,United Arab Emirates,DU UAE,Transguard Group LLC,API User,E6AEAE22430
2022-02-28 12:12,73242862,"30,451.9610","30,447.0610",05.00 AED,5.00,4.9000,0.1000,566636962,1614891,Success,United Arab Emirates,DU UAE,Transguard Group LLC,API User,E6AEAE17361
2022-02-28 12:13,73242900,"30,447.0610","30,442.1610",05.00 AED,5.00,4.9000,0.1000,566637055,1614898,Success,United Arab Emirates,DU UAE,Transguard Group LLC,API User,E6AEAE17361
2022-02-28 12:14,73242913,"30,442.1610","30,438.4210",151.00 PKR,4.25,3.7400,0.5100,566637094,1614904,Success,Pakistan,Telenor Pakistan,Transguard Group LLC,API User,TPPKPK94108
2022-02-28 12:20,73243169,"30,438.4210","30,418.8210",20.00 AED,20.00,19.6000,0.4000,566637725,1614917,Success,United Arab Emirates,DU UAE,Transguard Group LLC,API User,E6AEAE12938
2022-02-28 12:23,73243271,"30,418.8210","30,413.9210",05.00 AED,5.00,4.9000,0.1000,566637979,1614924,Success,United Arab Emirates,DU UAE,Transguard Group LLC,API User,E6AEAE17361
2022-02-28 12:25,73243339,"30,413.9210","30,409.0210",05.00 AED,5.00,4.9000,0.1000,566638145,1614927,Success,United Arab Emirates,DU UAE,Transguard Group LLC,API User,E6AEAE17361
2022-02-28 12:26,73243387,"30,409.0210","30,399.2210",10.00 AED,10.00,9.8000,0.2000,566638260,1614933,Success,United Arab Emirates,DU UAE,Transguard Group LLC,API User,E6AEAE22430
2022-02-28 12:27,73243414,"30,399.2210","30,394.3210",05.00 AED,5.00,4.9000,0.1000,566638311,1614935,Success,United Arab Emirates,DU UAE,Transguard Group LLC,API User,E6AEAE17361
2022-02-28 12:31,73243574,"30,394.3210","30,384.5210",10.00 AED,10.00,9.8000,0.2000,566638723,1614938,Success,United Arab Emirates,DU UAE,Transguard Group LLC,API User,E6AEAE22430
2022-02-28 12:41,73243983,"30,384.5210","30,379.6210",05.00 AED,5.00,4.9000,0.1000,566639706,1614943,Success,United Arab Emirates,DU UAE,Transguard Group LLC,API User,E6AEAE17361
2022-02-28 12:54,73244458,"30,379.6210","30,369.8210",10.00 AED,10.00,9.8000,0.2000,566640911,1614953,Success,United Arab Emirates,DU UAE,Transguard Group LLC,API User,E6AEAE22430
2022-02-28 13:00,73244676,"30,369.8210","30,364.9210",05.00 AED,5.00,4.9000,0.1000,566641459,1614961,Success,United Arab Emirates,DU UAE,Transguard Group LLC,API User,E6AEAE17361
2022-02-28 13:01,73244713,"30,364.9210","30,360.0210",05.00 AED,5.00,4.9000,0.1000,566641539,1614965,Success,United Arab Emirates,DU UAE,Transguard Group LLC,API User,E6AEAE17361
2022-02-28 13:03,73244805,"30,360.0210","30,355.1210",05.00 AED,5.00,4.9000,0.1000,566641743,1614972,Success,United Arab Emirates,DU UAE,Transguard Group LLC,API User,E6AEAE17361
2022-02-28 13:10,73245087,"30,355.1210","30,325.7210",30.00 AED,30.00,29.4000,0.6000,566642447,1614977,Success,United Arab Emirates,DU UAE,Transguard Group LLC,API User,E6AEAE46146
2022-02-28 13:13,73245212,"30,325.7210","30,320.8210",05.00 AED,5.00,4.9000,0.1000,566642761,1614982,Success,United Arab Emirates,DU UAE,Transguard Group LLC,API User,E6AEAE17361
2022-02-28 13:17,73245369,"30,320.8210","30,311.0210",10.00 AED,10.00,9.8000,0.2000,566643132,1614985,Success,United Arab Emirates,DU UAE,Transguard Group LLC,API User,E6AEAE22430
2022-02-28 13:24,73245646,"30,311.0210","30,306.1210",05.00 AED,5.00,4.9000,0.1000,566643826,1615001,Success,United Arab Emirates,DU UAE,Transguard Group LLC,API User,E6AEAE17361
2022-02-28 13:31,73245945,"30,306.1210","30,296.3210",10.00 AED,10.00,9.8000,0.2000,566644560,1615010,Success,United Arab Emirates,DU UAE,Transguard Group LLC,API User,E6AEAE22430
2022-02-28 13:31,73245969,"30,296.3210","30,292.5810",100.00 NPR,4.25,3.7400,0.5100,566644606,1615013,Success,Nepal,Ncell Nepal,Transguard Group LLC,API User,NP_NC_TopUp_100.00
2022-02-28 13:33,73246041,"30,292.5810","30,287.6810",05.00 AED,5.00,4.9000,0.1000,566644784,1615016,Success,United Arab Emirates,DU UAE,Transguard Group LLC,API User,E6AEAE17361
2022-02-28 13:34,73246080,"30,287.6810","30,282.7810",05.00 AED,5.00,4.9000,0.1000,566644881,1615019,Success,United Arab Emirates,DU UAE,Transguard Group LLC,API User,E6AEAE17361
2022-02-28 13:35,73246110,"30,282.7810","30,277.8810",05.00 AED,5.00,4.9000,0.1000,566644967,1615022,Success,United Arab Emirates,DU UAE,Transguard Group LLC,API User,E6AEAE17361
2022-02-28 13:39,73246265,"30,277.8810","30,272.9810",05.00 AED,5.00,4.9000,0.1000,566645350,1615027,Success,United Arab Emirates,DU UAE,Transguard Group LLC,API User,E6AEAE17361
2022-02-28 13:39,73246292,"30,272.9810","30,263.1810",10.00 AED,10.00,9.8000,0.2000,566645414,1615030,Success,United Arab Emirates,DU UAE,Transguard Group LLC,API User,E6AEAE22430
2022-02-28 13:53,73246887,"30,263.1810","30,253.3810",10.00 AED,10.00,9.8000,0.2000,566646754,1615039,Success,United Arab Emirates,DU UAE,Transguard Group LLC,API User,E6AEAE22430
2022-02-28 13:56,73247027,"30,253.3810","30,248.4810",05.00 AED,5.00,4.9000,0.1000,566647102,1615048,Success,United Arab Emirates,DU UAE,Transguard Group LLC,API User,E6AEAE17361
2022-02-28 13:56,73247028,"30,248.4810","30,240.1210",300.00 PKR,9.50,8.3600,1.1400,566647113,1615049,Failure,Pakistan,Ufone Pakistan,Transguard Group LLC,API User,PK_UF_TopUp_300.00
2022-02-28 13:56,73247028,"30,240.1210","30,231.7610",300.00 PKR,9.50,8.3600,1.1400,566647113,1615049,Failure,Pakistan,Ufone Pakistan,Transguard Group LLC,API User,PK_UF_TopUp_300.00
2022-02-28 14:02,73247251,"30,248.4810","30,243.5810",05.00 AED,5.00,4.9000,0.1000,566647666,1615058,Success,United Arab Emirates,DU UAE,Transguard Group LLC,API User,E6AEAE17361
2022-02-28 14:07,73247453,"30,243.5810","30,238.6810",05.00 AED,5.00,4.9000,0.1000,566648171,1615066,Success,United Arab Emirates,DU UAE,Transguard Group LLC,API User,E6AEAE17361
2022-02-28 14:09,73247548,"30,238.6810","30,219.0810",20.00 AED,20.00,19.6000,0.4000,566648421,1615070,Success,United Arab Emirates,DU UAE,Transguard Group LLC,API User,E6AEAE12938
2022-02-28 14:09,73247566,"30,219.0810","30,214.1810",05.00 AED,5.00,4.9000,0.1000,566648459,1615072,Success,United Arab Emirates,DU UAE,Transguard Group LLC,API User,E6AEAE17361
2022-02-28 14:10,73247601,"30,214.1810","30,209.2810",05.00 AED,5.00,4.9000,0.1000,566648546,1615075,Success,United Arab Emirates,DU UAE,Transguard Group LLC,API User,E6AEAE17361
2022-02-28 14:12,73247694,"30,209.2810","30,189.6810",20.00 AED,20.00,19.6000,0.4000,566648760,1615078,Success,United Arab Emirates,DU UAE,Transguard Group LLC,API User,E6AEAE12938
2022-02-28 14:20,73247995,"30,189.6810","30,179.8810",10.00 AED,10.00,9.8000,0.2000,566649552,1615083,Success,United Arab Emirates,DU UAE,Transguard Group LLC,API User,E6AEAE22430
2022-02-28 14:26,73248255,"30,179.8810","30,174.9810",05.00 AED,5.00,4.9000,0.1000,566650338,1615090,Success,United Arab Emirates,DU UAE,Transguard Group LLC,API User,E6AEAE17361
2022-02-28 14:41,73248818,"30,174.9810","30,155.3810",20.00 AED,20.00,19.6000,0.4000,566651833,1615100,Success,United Arab Emirates,DU UAE,Transguard Group LLC,API User,E6AEAE12938
2022-02-28 14:43,73248918,"30,155.3810","30,145.5810",10.00 AED,10.00,9.8000,0.2000,566652071,1615104,Success,United Arab Emirates,DU UAE,Transguard Group LLC,API User,E6AEAE22430
2022-02-28 15:07,73249800,"30,145.5810","30,140.6810",05.00 AED,5.00,4.9000,0.1000,566654596,1615118,Success,United Arab Emirates,DU UAE,Transguard Group LLC,API User,E6AEAE17361
2022-02-28 15:07,73249819,"30,140.6810","30,135.7810",05.00 AED,5.00,4.9000,0.1000,566654645,1615119,Success,United Arab Emirates,DU UAE,Transguard Group LLC,API User,E6AEAE17361
2022-02-28 15:10,73249924,"30,135.7810","30,125.9810",10.00 AED,10.00,9.8000,0.2000,566654971,1615124,Success,United Arab Emirates,DU UAE,Transguard Group LLC,API User,E6AEAE22430
2022-02-28 15:13,73250088,"30,125.9810","30,116.1810",10.00 AED,10.00,9.8000,0.2000,566655385,1615131,Success,United Arab Emirates,DU UAE,Transguard Group LLC,API User,E6AEAE22430
2022-02-28 15:19,73250310,"30,116.1810","30,106.3810",10.00 AED,10.00,9.8000,0.2000,566656037,1615140,Success,United Arab Emirates,DU UAE,Transguard Group LLC,API User,E6AEAE22430
2022-02-28 15:29,73250734,"30,106.3810","30,096.5810",10.00 AED,10.00,9.8000,0.2000,566657234,1615150,Success,United Arab Emirates,DU UAE,Transguard Group LLC,API User,E6AEAE22430
2022-02-28 15:30,73250762,"30,096.5810","30,091.6810",05.00 AED,5.00,4.9000,0.1000,566657345,1615155,Success,United Arab Emirates,DU UAE,Transguard Group LLC,API User,E6AEAE17361
2022-02-28 15:38,73251069,"30,091.6810","30,081.8810",10.00 AED,10.00,9.8000,0.2000,566658251,1615168,Success,United Arab Emirates,DU UAE,Transguard Group LLC,API User,E6AEAE22430
2022-02-28 15:42,73251216,"30,081.8810","30,072.0810",10.00 AED,10.00,9.8000,0.2000,566658674,1615172,Success,United Arab Emirates,DU UAE,Transguard Group LLC,API User,E6AEAE22430
2022-02-28 15:55,73251727,"30,072.0810","30,067.1810",05.00 AED,5.00,4.9000,0.1000,566660234,1615185,Success,United Arab Emirates,DU UAE,Transguard Group LLC,API User,E6AEAE17361
2022-02-28 16:09,73252327,"30,067.1810","30,062.2810",05.00 AED,5.00,4.9000,0.1000,566662029,73252327,Success,United Arab Emirates,DU UAE,Transguard Group LLC,mohammed.arafath@transguardgroup.com,E6AEAE17361
2022-02-28 16:13,73252492,"30,062.2810","30,052.4810",10.00 AED,10.00,9.8000,0.2000,566662541,1615200,Success,United Arab Emirates,DU UAE,Transguard Group LLC,API User,E6AEAE22430
2022-02-28 16:20,73252760,"30,052.4810","30,047.5810",05.00 AED,5.00,4.9000,0.1000,566663416,1615203,Success,United Arab Emirates,DU UAE,Transguard Group LLC,API User,E6AEAE17361
2022-02-28 16:23,73252924,"30,047.5810","30,037.7810",10.00 AED,10.00,9.8000,0.2000,566663933,1615212,Success,United Arab Emirates,DU UAE,Transguard Group LLC,API User,E6AEAE22430
2022-02-28 16:24,73252960,"30,037.7810","30,027.9810",10.00 AED,10.00,9.8000,0.2000,566664043,1615214,Success,United Arab Emirates,DU UAE,Transguard Group LLC,API User,E6AEAE22430
2022-02-28 16:37,73253520,"30,027.9810","30,010.3810",301.00 INR,20.00,17.6000,2.4000,566665753,1615229,Success,India,Jio India,Transguard Group LLC,API User,RJININ16042
2022-02-28 16:42,73253783,"30,010.3810","30,005.4810",05.00 AED,5.00,4.9000,0.1000,566666473,1615236,Success,United Arab Emirates,DU UAE,Transguard Group LLC,API User,E6AEAE17361
2022-02-28 16:44,73253878,"30,005.4810","29,995.6810",10.00 AED,10.00,9.8000,0.2000,566666780,1615242,Success,United Arab Emirates,DU UAE,Transguard Group LLC,API User,E6AEAE22430
2022-02-28 16:46,73253954,"29,995.6810","29,990.7810",05.00 AED,5.00,4.9000,0.1000,566667003,1615246,Success,United Arab Emirates,DU UAE,Transguard Group LLC,API User,E6AEAE17361
2022-02-28 16:47,73254025,"29,990.7810","29,986.6010",50.00 PHP,4.75,4.1800,0.5700,566667258,1615249,Success,Philippines,Smart (SunCellular) Philippines,Transguard Group LLC,API User,PH_SM_TopUp_50.00
2022-02-28 16:49,73254109,"29,978.2410","29,973.3410",05.00 AED,5.00,4.9000,0.1000,566667503,1615255,Success,United Arab Emirates,DU UAE,Transguard Group LLC,API User,E6AEAE17361
2022-02-28 16:49,73254132,"29,986.6010","29,978.2410",300.00 PKR,9.50,8.3600,1.1400,566667321,1615252,Failure,Pakistan,Jazz Pakistan,Transguard Group LLC,API User,PK_MB_TopUp_300.00
2022-02-28 16:49,73254132,"29,973.3410","29,964.9810",300.00 PKR,9.50,8.3600,1.1400,566667321,1615252,Failure,Pakistan,Jazz Pakistan,Transguard Group LLC,API User,PK_MB_TopUp_300.00
2022-02-28 16:52,73254271,"29,981.7010","29,976.8010",05.00 AED,5.00,4.9000,0.1000,566667989,1615259,Success,United Arab Emirates,DU UAE,Transguard Group LLC,API User,E6AEAE17361
2022-02-28 16:55,73254384,"29,976.8010","29,971.9010",05.00 AED,5.00,4.9000,0.1000,566668345,1615265,Success,United Arab Emirates,DU UAE,Transguard Group LLC,API User,E6AEAE17361
2022-02-28 16:55,73254389,"29,971.9010","29,962.1010",10.00 AED,10.00,9.8000,0.2000,566668367,1615266,Success,United Arab Emirates,DU UAE,Transguard Group LLC,API User,E6AEAE22430
2022-02-28 17:00,73254712,"29,962.1010","29,952.3010",10.00 AED,10.00,9.8000,0.2000,566669230,1615271,Success,United Arab Emirates,DU UAE,Transguard Group LLC,API User,E6AEAE22430
2022-02-28 17:02,73254788,"29,952.3010","29,947.4010",05.00 AED,5.00,4.9000,0.1000,566669465,1615275,Success,United Arab Emirates,DU UAE,Transguard Group LLC,API User,E6AEAE17361
2022-02-28 17:05,73254918,"29,947.4010","29,942.5010",05.00 AED,5.00,4.9000,0.1000,566669856,1615281,Success,United Arab Emirates,DU UAE,Transguard Group LLC,API User,E6AEAE17361
2022-02-28 17:05,73254955,"29,942.5010","29,937.6010",05.00 AED,5.00,4.9000,0.1000,566669965,1615284,Success,United Arab Emirates,DU UAE,Transguard Group LLC,API User,E6AEAE17361
2022-02-28 17:06,73254986,"29,937.6010","29,927.8010",10.00 AED,10.00,9.8000,0.2000,566670082,1615287,Success,United Arab Emirates,DU UAE,Transguard Group LLC,API User,E6AEAE22430
2022-02-28 17:07,73255053,"29,927.8010","29,922.9010",05.00 AED,5.00,4.9000,0.1000,566670280,1615290,Success,United Arab Emirates,DU UAE,Transguard Group LLC,API User,E6AEAE17361
2022-02-28 17:09,73255145,"29,922.9010","29,918.0010",05.00 AED,5.00,4.9000,0.1000,566670523,1615297,Success,United Arab Emirates,DU UAE,Transguard Group LLC,API User,E6AEAE17361
2022-02-28 17:12,73255302,"29,918.0010","29,913.1010",05.00 AED,5.00,4.9000,0.1000,566671009,1615302,Success,United Arab Emirates,DU UAE,Transguard Group LLC,API User,E6AEAE17361
2022-02-28 17:25,73256020,"29,913.1010","29,908.2010",05.00 AED,5.00,4.9000,0.1000,566673126,1615311,Success,United Arab Emirates,DU UAE,Transguard Group LLC,API User,E6AEAE17361
2022-02-28 17:28,73256122,"29,908.2010","29,898.4010",10.00 AED,10.00,9.8000,0.2000,566673491,1615318,Success,United Arab Emirates,DU UAE,Transguard Group LLC,API User,E6AEAE22430
2022-02-28 17:36,73256652,"29,898.4010","29,888.6010",10.00 AED,10.00,9.8000,0.2000,566674914,1615323,Success,United Arab Emirates,DU UAE,Transguard Group LLC,API User,E6AEAE22430
2022-02-28 17:37,73256728,"29,888.6010","29,878.8010",10.00 AED,10.00,9.8000,0.2000,566675146,1615327,Success,United Arab Emirates,DU UAE,Transguard Group LLC,API User,E6AEAE22430
2022-02-28 17:46,73257221,"29,878.8010","29,875.0610",100.00 NPR,4.25,3.7400,0.5100,566676724,1615343,Success,Nepal,Ncell Nepal,Transguard Group LLC,API User,NP_NC_TopUp_100.00
2022-02-28 17:50,73257398,"29,875.0610","29,870.1610",05.00 AED,5.00,4.9000,0.1000,566677227,1615346,Success,United Arab Emirates,DU UAE,Transguard Group LLC,API User,E6AEAE17361
2022-02-28 17:51,73257462,"29,870.1610","29,853.2210",470.00 NPR,19.25,16.9400,2.3100,566677417,1615349,Success,Nepal,Ncell Nepal,Transguard Group LLC,API User,NCNPNP37643
2022-02-28 17:52,73257505,"29,853.2210","29,848.3210",05.00 AED,5.00,4.9000,0.1000,566677562,1615352,Success,United Arab Emirates,DU UAE,Transguard Group LLC,API User,E6AEAE17361
2022-02-28 17:53,73257588,"29,848.3210","29,839.5210",315.00 PKR,10.00,8.8000,1.2000,566677833,1615357,Success,Pakistan,Telenor Pakistan,Transguard Group LLC,API User,TPPKPK75105
2022-02-28 17:55,73257664,"29,839.5210","29,834.6210",05.00 AED,5.00,4.9000,0.1000,566678048,1615360,Success,United Arab Emirates,DU UAE,Transguard Group LLC,API User,E6AEAE17361
2022-02-28 17:57,73257770,"29,834.6210","29,829.7210",05.00 AED,5.00,4.9000,0.1000,566678362,1615363,Success,United Arab Emirates,DU UAE,Transguard Group LLC,API User,E6AEAE17361
2022-02-28 17:58,73257861,"29,829.7210","29,810.1210",20.00 AED,20.00,19.6000,0.4000,566678625,1615366,Success,United Arab Emirates,DU UAE,Transguard Group LLC,API User,E6AEAE12938
2022-02-28 17:59,73257930,"29,810.1210","29,780.7210",30.00 AED,30.00,29.4000,0.6000,566678800,1615371,Success,United Arab Emirates,DU UAE,Transguard Group LLC,API User,E6AEAE46146
2022-02-28 17:59,73257932,"29,780.7210","29,775.8210",05.00 AED,5.00,4.9000,0.1000,566678804,1615372,Success,United Arab Emirates,DU UAE,Transguard Group LLC,API User,E6AEAE17361
2022-02-28 18:00,73257986,"29,775.8210","29,770.9210",05.00 AED,5.00,4.9000,0.1000,566678964,1615375,Success,United Arab Emirates,DU UAE,Transguard Group LLC,API User,E6AEAE17361
2022-02-28 18:03,73258184,"29,770.9210","29,766.0210",05.00 AED,5.00,4.9000,0.1000,566679536,1615382,Success,United Arab Emirates,DU UAE,Transguard Group LLC,API User,E6AEAE17361
2022-02-28 18:03,73258198,"29,766.0210","29,761.1210",05.00 AED,5.00,4.9000,0.1000,566679571,1615384,Success,United Arab Emirates,DU UAE,Transguard Group LLC,API User,E6AEAE17361
2022-02-28 18:04,73258248,"29,761.1210","29,751.3210",10.00 AED,10.00,9.8000,0.2000,566679724,1615389,Success,United Arab Emirates,DU UAE,Transguard Group LLC,API User,E6AEAE22430
2022-02-28 18:06,73258339,"29,751.3210","29,741.5210",10.00 AED,10.00,9.8000,0.2000,566680013,1615394,Success,United Arab Emirates,DU UAE,Transguard Group LLC,API User,E6AEAE22430
2022-02-28 18:15,73258887,"29,741.5210","29,721.9210",20.00 AED,20.00,19.6000,0.4000,566681636,1615405,Success,United Arab Emirates,DU UAE,Transguard Group LLC,API User,E6AEAE12938
2022-02-28 18:19,73259146,"29,721.9210","29,712.1210",10.00 AED,10.00,9.8000,0.2000,566682386,1615415,Success,United Arab Emirates,DU UAE,Transguard Group LLC,API User,E6AEAE22430
2022-02-28 18:21,73259325,"29,712.1210","29,707.2210",05.00 AED,5.00,4.9000,0.1000,566682891,1615420,Success,United Arab Emirates,DU UAE,Transguard Group LLC,API User,E6AEAE17361
2022-02-28 18:24,73259447,"29,707.2210","29,697.4210",10.00 AED,10.00,9.8000,0.2000,566683305,1615426,Success,United Arab Emirates,DU UAE,Transguard Group LLC,API User,E6AEAE22430
2022-02-28 18:25,73259490,"29,697.4210","29,692.5210",05.00 AED,5.00,4.9000,0.1000,566683445,1615428,Success,United Arab Emirates,DU UAE,Transguard Group LLC,API User,E6AEAE17361
2022-02-28 18:28,73259704,"29,692.5210","29,682.7210",10.00 AED,10.00,9.8000,0.2000,566684050,1615435,Success,United Arab Emirates,DU UAE,Transguard Group LLC,API User,E6AEAE22430
2022-02-28 18:35,73260141,"29,682.7210","29,677.8210",05.00 AED,5.00,4.9000,0.1000,566685415,1615444,Success,United Arab Emirates,DU UAE,Transguard Group LLC,API User,E6AEAE17361
2022-02-28 18:41,73260469,"29,677.8210","29,672.9210",05.00 AED,5.00,4.9000,0.1000,566686376,1615447,Success,United Arab Emirates,DU UAE,Transguard Group LLC,API User,E6AEAE17361
2022-02-28 18:42,73260548,"29,672.9210","29,665.6610",330.00 LKR,8.25,7.2600,0.9900,566686643,1615451,Success,Sri Lanka,Mobitel Sri Lanka,Transguard Group LLC,API User,LK_MS_TopUp_330
2022-02-28 18:43,73260621,"29,665.6610","29,646.0610",20.00 AED,20.00,19.6000,0.4000,566686888,1615454,Success,United Arab Emirates,DU UAE,Transguard Group LLC,API User,E6AEAE12938
2022-02-28 18:44,73260664,"29,646.0610","29,641.1610",05.00 AED,5.00,4.9000,0.1000,566686982,1615458,Success,United Arab Emirates,DU UAE,Transguard Group LLC,API User,E6AEAE17361
2022-02-28 18:46,73260828,"29,641.1610","29,631.3610",10.00 AED,10.00,9.8000,0.2000,566687464,1615467,Success,United Arab Emirates,DU UAE,Transguard Group LLC,API User,E6AEAE22430
2022-02-28 18:47,73260848,"29,631.3610","29,626.4610",05.00 AED,5.00,4.9000,0.1000,566687547,1615471,Success,United Arab Emirates,DU UAE,Transguard Group LLC,API User,E6AEAE17361
2022-02-28 18:47,73260909,"29,626.4610","29,616.6610",10.00 AED,10.00,9.8000,0.2000,566687713,1615474,Success,United Arab Emirates,DU UAE,Transguard Group LLC,API User,E6AEAE22430
2022-02-28 18:49,73261008,"29,616.6610","29,611.7610",05.00 AED,5.00,4.9000,0.1000,566687986,1615480,Success,United Arab Emirates,DU UAE,Transguard Group LLC,API User,E6AEAE17361
2022-02-28 18:50,73261052,"29,611.7610","29,606.8610",05.00 AED,5.00,4.9000,0.1000,566688131,1615484,Success,United Arab Emirates,DU UAE,Transguard Group LLC,API User,E6AEAE17361
2022-02-28 18:51,73261153,"29,606.8610","29,597.0610",10.00 AED,10.00,9.8000,0.2000,566688400,1615489,Success,United Arab Emirates,DU UAE,Transguard Group LLC,API User,E6AEAE22430
2022-02-28 18:54,73261431,"29,597.0610","29,592.1610",05.00 AED,5.00,4.9000,0.1000,566689065,1615499,Success,United Arab Emirates,DU UAE,Transguard Group LLC,API User,E6AEAE17361
2022-02-28 18:55,73261455,"29,592.1610","29,587.2610",05.00 AED,5.00,4.9000,0.1000,566689136,1615501,Success,United Arab Emirates,DU UAE,Transguard Group LLC,API User,E6AEAE17361
2022-02-28 18:56,73261569,"29,587.2610","29,582.3610",05.00 AED,5.00,4.9000,0.1000,566689432,1615506,Success,United Arab Emirates,DU UAE,Transguard Group LLC,API User,E6AEAE17361
2022-02-28 19:04,73262189,"29,582.3610","29,577.4610",05.00 AED,5.00,4.9000,0.1000,566691124,1615514,Success,United Arab Emirates,DU UAE,Transguard Group LLC,API User,E6AEAE17361
2022-02-28 19:05,73262246,"29,577.4610","29,567.6610",10.00 AED,10.00,9.8000,0.2000,566691300,1615518,Success,United Arab Emirates,DU UAE,Transguard Group LLC,API User,E6AEAE22430
2022-02-28 19:06,73262366,"29,567.6610","29,562.7610",05.00 AED,5.00,4.9000,0.1000,566691579,1615522,Success,United Arab Emirates,DU UAE,Transguard Group LLC,API User,E6AEAE17361
2022-02-28 19:08,73262493,"29,562.7610","29,549.7810",460.00 PKR,14.75,12.9800,1.7700,566691899,1615527,Success,Pakistan,Telenor Pakistan,Transguard Group LLC,API User,TPPKPK34330
2022-02-28 19:09,73262574,"29,549.7810","29,539.9810",10.00 AED,10.00,9.8000,0.2000,566692105,1615535,Success,United Arab Emirates,DU UAE,Transguard Group LLC,API User,E6AEAE22430
2022-02-28 19:09,73262580,"29,539.9810","29,535.0810",05.00 AED,5.00,4.9000,0.1000,566692121,1615536,Success,United Arab Emirates,DU UAE,Transguard Group LLC,API User,E6AEAE17361
2022-02-28 19:12,73262836,"29,535.0810","29,495.8810",40.00 AED,40.00,39.2000,0.8000,566692885,1615543,Success,United Arab Emirates,DU UAE,Transguard Group LLC,API User,E6AEAE64011
2022-02-28 19:15,73263011,"29,495.8810","29,490.9810",05.00 AED,5.00,4.9000,0.1000,566693363,1615552,Success,United Arab Emirates,DU UAE,Transguard Group LLC,API User,E6AEAE17361
2022-02-28 19:21,73263483,"29,490.9810","29,471.3810",20.00 AED,20.00,19.6000,0.4000,566694717,1615560,Success,United Arab Emirates,DU UAE,Transguard Group LLC,API User,E6AEAE12938
2022-02-28 19:24,73263686,"29,471.3810","29,466.4810",05.00 AED,5.00,4.9000,0.1000,566695267,1615563,Success,United Arab Emirates,DU UAE,Transguard Group LLC,API User,E6AEAE17361
2022-02-28 19:26,73263922,"29,466.4810","29,461.5810",05.00 AED,5.00,4.9000,0.1000,566695913,1615567,Success,United Arab Emirates,DU UAE,Transguard Group LLC,API User,E6AEAE17361
2022-02-28 19:30,73264194,"29,461.5810","29,441.9810",20.00 AED,20.00,19.6000,0.4000,566696734,1615576,Success,United Arab Emirates,DU UAE,Transguard Group LLC,API User,E6AEAE12938
2022-02-28 19:35,73264493,"29,441.9810","29,432.1810",10.00 AED,10.00,9.8000,0.2000,566697578,1615581,Success,United Arab Emirates,DU UAE,Transguard Group LLC,API User,E6AEAE22430
2022-02-28 19:36,73264558,"29,432.1810","29,427.2810",05.00 AED,5.00,4.9000,0.1000,566697798,1615584,Success,United Arab Emirates,DU UAE,Transguard Group LLC,API User,E6AEAE17361
2022-02-28 19:37,73264693,"29,427.2810","29,422.3810",05.00 AED,5.00,4.9000,0.1000,566698161,1615589,Success,United Arab Emirates,DU UAE,Transguard Group LLC,API User,E6AEAE17361
2022-02-28 19:39,73264847,"29,422.3810","29,417.4810",05.00 AED,5.00,4.9000,0.1000,566698553,1615599,Success,United Arab Emirates,DU UAE,Transguard Group LLC,API User,E6AEAE17361
2022-02-28 19:40,73264871,"29,417.4810","29,413.7410",100.00 NPR,4.25,3.7400,0.5100,566698666,1615603,Success,Nepal,Nepal Telecom Nepal,Transguard Group LLC,API User,NP_NE_TopUp_100.00
2022-02-28 19:41,73264939,"29,413.7410","29,408.8410",05.00 AED,5.00,4.9000,0.1000,566698861,1615611,Success,United Arab Emirates,DU UAE,Transguard Group LLC,API User,E6AEAE17361
2022-02-28 19:46,73265336,"29,408.8410","29,404.6610",50.00 PHP,4.75,4.1800,0.5700,566699930,1615618,Success,Philippines,Smart (SunCellular) Philippines,Transguard Group LLC,API User,PH_SM_TopUp_50.00
2022-02-28 19:47,73265438,"29,404.6610","29,400.4810",50.00 PHP,4.75,4.1800,0.5700,566700238,1615625,Success,Philippines,Smart (SunCellular) Philippines,Transguard Group LLC,API User,PH_SM_TopUp_50.00
2022-02-28 19:51,73265727,"29,400.4810","29,395.5810",05.00 AED,5.00,4.9000,0.1000,566701024,1615631,Success,United Arab Emirates,DU UAE,Transguard Group LLC,API User,E6AEAE17361
2022-02-28 19:51,73265758,"29,395.5810","29,391.8410",151.00 PKR,4.25,3.7400,0.5100,566701070,1615633,Success,Pakistan,Telenor Pakistan,Transguard Group LLC,API User,TPPKPK94108
2022-02-28 19:55,73266011,"29,391.8410","29,386.9410",05.00 AED,5.00,4.9000,0.1000,566701880,1615640,Success,United Arab Emirates,DU UAE,Transguard Group LLC,API User,E6AEAE17361
2022-02-28 19:56,73266074,"29,386.9410","29,382.0410",05.00 AED,5.00,4.9000,0.1000,566702051,1615643,Success,United Arab Emirates,DU UAE,Transguard Group LLC,API User,E6AEAE17361
2022-02-28 19:57,73266174,"29,382.0410","29,372.2410",10.00 AED,10.00,9.8000,0.2000,566702349,1615646,Success,United Arab Emirates,DU UAE,Transguard Group LLC,API User,E6AEAE22430
2022-02-28 20:01,73266441,"29,372.2410","29,367.3410",05.00 AED,5.00,4.9000,0.1000,566703147,1615652,Success,United Arab Emirates,DU UAE,Transguard Group LLC,API User,E6AEAE17361
2022-02-28 20:03,73266558,"29,367.3410","29,362.4410",05.00 AED,5.00,4.9000,0.1000,566703573,1615660,Success,United Arab Emirates,DU UAE,Transguard Group LLC,API User,E6AEAE17361
2022-02-28 20:04,73266565,"29,362.4410","29,357.5410",05.00 AED,5.00,4.9000,0.1000,566703592,1615661,Success,United Arab Emirates,DU UAE,Transguard Group LLC,API User,E6AEAE17361
2022-02-28 20:04,73266614,"29,357.5410","29,353.3610",150.00 PKR,4.75,4.1800,0.5700,566703790,1615664,Success,Pakistan,Zong Pakistan,Transguard Group LLC,API User,ZNPKPK65621
2022-02-28 20:07,73266853,"29,353.3610","29,348.4610",05.00 AED,5.00,4.9000,0.1000,566704417,1615673,Success,United Arab Emirates,DU UAE,Transguard Group LLC,API User,E6AEAE17361
2022-02-28 20:08,73266911,"29,348.4610","29,343.5610",05.00 AED,5.00,4.9000,0.1000,566704574,1615679,Success,United Arab Emirates,DU UAE,Transguard Group LLC,API User,E6AEAE17361
2022-02-28 20:11,73267134,"29,343.5610","29,338.6610",05.00 AED,5.00,4.9000,0.1000,566705284,1615687,Success,United Arab Emirates,DU UAE,Transguard Group LLC,API User,E6AEAE17361
2022-02-28 20:16,73267473,"29,338.6610","29,333.7610",05.00 AED,5.00,4.9000,0.1000,566706313,1615695,Success,United Arab Emirates,DU UAE,Transguard Group LLC,API User,E6AEAE17361
2022-02-28 20:16,73267512,"29,333.7610","29,328.8610",05.00 AED,5.00,4.9000,0.1000,566706416,1615698,Success,United Arab Emirates,DU UAE,Transguard Group LLC,API User,E6AEAE17361
2022-02-28 20:19,73267694,"29,328.8610","29,323.9610",05.00 AED,5.00,4.9000,0.1000,566706951,1615705,Success,United Arab Emirates,DU UAE,Transguard Group LLC,API User,E6AEAE17361
2022-02-28 20:19,73267705,"29,323.9610","29,314.1610",10.00 AED,10.00,9.8000,0.2000,566707001,1615707,Success,United Arab Emirates,DU UAE,Transguard Group LLC,API User,E6AEAE22430
2022-02-28 20:20,73267796,"29,314.1610","29,309.2610",05.00 AED,5.00,4.9000,0.1000,566707338,1615713,Success,United Arab Emirates,DU UAE,Transguard Group LLC,API User,E6AEAE17361
2022-02-28 20:24,73268085,"29,309.2610","29,304.3610",05.00 AED,5.00,4.9000,0.1000,566708194,1615718,Success,United Arab Emirates,DU UAE,Transguard Group LLC,API User,E6AEAE17361
2022-02-28 20:26,73268236,"29,304.3610","29,299.4610",05.00 AED,5.00,4.9000,0.1000,566708706,1615725,Success,United Arab Emirates,DU UAE,Transguard Group LLC,API User,E6AEAE17361
2022-02-28 20:29,73268434,"29,299.4610","29,294.5610",05.00 AED,5.00,4.9000,0.1000,566709300,1615730,Success,United Arab Emirates,DU UAE,Transguard Group LLC,API User,E6AEAE17361
2022-02-28 20:30,73268484,"29,294.5610","29,284.7610",10.00 AED,10.00,9.8000,0.2000,566709471,1615733,Success,United Arab Emirates,DU UAE,Transguard Group LLC,API User,E6AEAE22430
2022-02-28 20:39,73269098,"29,284.7610","29,279.8610",05.00 AED,5.00,4.9000,0.1000,566711326,1615742,Success,United Arab Emirates,DU UAE,Transguard Group LLC,API User,E6AEAE17361
2022-02-28 20:39,73269127,"29,279.8610","29,270.0610",10.00 AED,10.00,9.8000,0.2000,566711444,1615744,Success,United Arab Emirates,DU UAE,Transguard Group LLC,API User,E6AEAE22430
2022-02-28 20:42,73269279,"29,270.0610","29,260.2610",10.00 AED,10.00,9.8000,0.2000,566711894,1615748,Success,United Arab Emirates,DU UAE,Transguard Group LLC,API User,E6AEAE22430
2022-02-28 20:42,73269323,"29,260.2610","29,250.4610",10.00 AED,10.00,9.8000,0.2000,566712040,1615753,Success,United Arab Emirates,DU UAE,Transguard Group LLC,API User,E6AEAE22430
2022-02-28 20:49,73269697,"29,250.4610","29,245.5610",05.00 AED,5.00,4.9000,0.1000,566713237,1615763,Success,United Arab Emirates,DU UAE,Transguard Group LLC,API User,E6AEAE17361
2022-02-28 20:54,73270091,"29,245.5610","29,240.6610",05.00 AED,5.00,4.9000,0.1000,566714381,1615770,Success,United Arab Emirates,DU UAE,Transguard Group LLC,API User,E6AEAE17361
2022-02-28 20:58,73270343,"29,240.6610","29,235.7610",05.00 AED,5.00,4.9000,0.1000,566715174,1615780,Success,United Arab Emirates,DU UAE,Transguard Group LLC,API User,E6AEAE17361
2022-02-28 21:03,73270645,"29,235.7610","29,230.8610",05.00 AED,5.00,4.9000,0.1000,566716229,1615788,Success,United Arab Emirates,DU UAE,Transguard Group LLC,API User,E6AEAE17361
2022-02-28 21:04,73270689,"29,230.8610","29,225.9610",05.00 AED,5.00,4.9000,0.1000,566716403,1615792,Success,United Arab Emirates,DU UAE,Transguard Group LLC,API User,E6AEAE17361
2022-02-28 21:08,73270907,"29,225.9610","29,216.1610",10.00 AED,10.00,9.8000,0.2000,566717089,1615804,Success,United Arab Emirates,DU UAE,Transguard Group LLC,API User,E6AEAE22430
2022-02-28 21:10,73271084,"29,216.1610","29,211.2610",05.00 AED,5.00,4.9000,0.1000,566717652,1615808,Success,United Arab Emirates,DU UAE,Transguard Group LLC,API User,E6AEAE17361
2022-02-28 21:11,73271133,"29,211.2610","29,206.3610",05.00 AED,5.00,4.9000,0.1000,566717798,1615813,Success,United Arab Emirates,DU UAE,Transguard Group LLC,API User,E6AEAE17361
2022-02-28 21:14,73271301,"29,206.3610","29,186.7610",20.00 AED,20.00,19.6000,0.4000,566718345,1615816,Success,United Arab Emirates,DU UAE,Transguard Group LLC,API User,E6AEAE12938
2022-02-28 21:15,73271393,"29,186.7610","29,181.8610",05.00 AED,5.00,4.9000,0.1000,566718601,1615822,Success,United Arab Emirates,DU UAE,Transguard Group LLC,API User,E6AEAE17361
2022-02-28 21:19,73271661,"29,177.4610","29,169.1010",300.00 PKR,9.50,8.3600,1.1400,566719395,1615836,Success,Pakistan,Jazz Pakistan,Transguard Group LLC,API User,PK_MB_TopUp_300.00
2022-02-28 21:19,73271666,"29,181.8610","29,177.4610",06.60 GHS,5.00,4.4000,0.6000,566719380,1615835,Success,Ghana,MTN Ghana,Transguard Group LLC,API User,GH_MT_TopUp
2022-02-28 21:22,73271833,"29,169.1010","29,159.3010",10.00 AED,10.00,9.8000,0.2000,566719928,1615841,Success,United Arab Emirates,DU UAE,Transguard Group LLC,API User,E6AEAE22430
2022-02-28 21:25,73272059,"29,159.3010","29,154.4010",05.00 AED,5.00,4.9000,0.1000,566720563,1615847,Success,United Arab Emirates,DU UAE,Transguard Group LLC,API User,E6AEAE17361
2022-02-28 21:26,73272099,"29,154.4010","29,144.6010",10.00 AED,10.00,9.8000,0.2000,566720688,1615850,Success,United Arab Emirates,DU UAE,Transguard Group LLC,API User,E6AEAE22430
2022-02-28 21:28,73272199,"29,144.6010","29,139.7010",05.00 AED,5.00,4.9000,0.1000,566721025,1615854,Success,United Arab Emirates,DU UAE,Transguard Group LLC,API User,E6AEAE17361
2022-02-28 21:28,73272213,"29,139.7010","29,120.1010",20.00 AED,20.00,19.6000,0.4000,566721077,1615858,Success,United Arab Emirates,DU UAE,Transguard Group LLC,API User,E6AEAE12938
2022-02-28 21:33,73272498,"29,120.1010","29,110.3010",10.00 AED,10.00,9.8000,0.2000,566721977,1615867,Success,United Arab Emirates,DU UAE,Transguard Group LLC,API User,E6AEAE22430
2022-02-28 21:48,73273341,"29,110.3010","29,101.7210",315.00 PKR,9.75,8.5800,1.1700,566724755,1615886,Success,Pakistan,Zong Pakistan,Transguard Group LLC,API User,ZNPKPK29953
2022-02-28 21:49,73273388,"29,101.7210","29,082.1210",20.00 AED,20.00,19.6000,0.4000,566724906,1615889,Success,United Arab Emirates,DU UAE,Transguard Group LLC,API User,E6AEAE12938
2022-02-28 21:51,73273493,"29,082.1210","29,077.2210",05.00 AED,5.00,4.9000,0.1000,566725276,1615892,Success,United Arab Emirates,DU UAE,Transguard Group LLC,API User,E6AEAE17361
2022-02-28 21:52,73273537,"29,077.2210","29,067.4210",10.00 AED,10.00,9.8000,0.2000,566725417,1615896,Success,United Arab Emirates,DU UAE,Transguard Group LLC,API User,E6AEAE22430
2022-02-28 21:55,73273681,"29,067.4210","29,062.5210",05.00 AED,5.00,4.9000,0.1000,566725909,1615906,Success,United Arab Emirates,DU UAE,Transguard Group LLC,API User,E6AEAE17361
2022-02-28 21:56,73273741,"29,062.5210","29,057.6210",05.00 AED,5.00,4.9000,0.1000,566726091,1615911,Success,United Arab Emirates,DU UAE,Transguard Group LLC,API User,E6AEAE17361
2022-02-28 22:00,73273950,"29,057.6210","29,052.7210",05.00 AED,5.00,4.9000,0.1000,566726753,1615918,Success,United Arab Emirates,DU UAE,Transguard Group LLC,API User,E6AEAE17361
2022-02-28 22:03,73274155,"29,052.7210","29,047.8210",05.00 AED,5.00,4.9000,0.1000,566727403,1615925,Success,United Arab Emirates,DU UAE,Transguard Group LLC,API User,E6AEAE17361
2022-02-28 22:04,73274174,"29,047.8210","29,028.2210",20.00 AED,20.00,19.6000,0.4000,566727467,1615928,Success,United Arab Emirates,DU UAE,Transguard Group LLC,API User,E6AEAE12938
2022-02-28 22:05,73274239,"29,028.2210","29,024.0410",150.00 PKR,4.75,4.1800,0.5700,566727680,1615931,Success,Pakistan,Zong Pakistan,Transguard Group LLC,API User,ZNPKPK65621
2022-02-28 22:07,73274360,"29,024.0410","29,019.1410",05.00 AED,5.00,4.9000,0.1000,566728150,1615935,Failure,United Arab Emirates,DU UAE,Transguard Group LLC,API User,E6AEAE17361
2022-02-28 22:07,73274360,"29,019.1410","29,014.2410",05.00 AED,5.00,4.9000,0.1000,566728150,1615935,Failure,United Arab Emirates,DU UAE,Transguard Group LLC,API User,E6AEAE17361
2022-02-28 22:10,73274507,"29,024.0410","29,014.2410",10.00 AED,10.00,9.8000,0.2000,566728616,1615941,Success,United Arab Emirates,DU UAE,Transguard Group LLC,API User,E6AEAE22430
2022-02-28 22:16,73274776,"29,014.2410","29,009.3410",05.00 AED,5.00,4.9000,0.1000,566729565,1615946,Success,United Arab Emirates,DU UAE,Transguard Group LLC,API User,E6AEAE17361
2022-02-28 22:26,73275262,"29,009.3410","28,999.5410",10.00 AED,10.00,9.8000,0.2000,566731316,1615963,Success,United Arab Emirates,DU UAE,Transguard Group LLC,API User,E6AEAE22430
2022-02-28 22:31,73275507,"28,999.5410","28,994.6410",05.00 AED,5.00,4.9000,0.1000,566732163,1615975,Success,United Arab Emirates,DU UAE,Transguard Group LLC,API User,E6AEAE17361
2022-02-28 22:32,73275577,"28,994.6410","28,989.7410",05.00 AED,5.00,4.9000,0.1000,566732381,1615986,Success,United Arab Emirates,DU UAE,Transguard Group LLC,API User,E6AEAE17361
2022-02-28 22:33,73275581,"28,989.7410","28,984.8410",05.00 AED,5.00,4.9000,0.1000,566732399,1615987,Success,United Arab Emirates,DU UAE,Transguard Group LLC,API User,E6AEAE17361
2022-02-28 22:35,73275682,"28,984.8410","28,976.9210","1,000.00 XAF",9.00,7.9200,1.0800,566732764,1615990,Success,Cameroon,MTN Cameroon,Transguard Group LLC,API User,CM_MT_TopUp_1000.00
2022-02-28 22:37,73275782,"28,976.9210","28,972.0210",05.00 AED,5.00,4.9000,0.1000,566733060,1615993,Success,United Arab Emirates,DU UAE,Transguard Group LLC,API User,E6AEAE17361
2022-02-28 22:50,73276337,"28,972.0210","28,967.1210",05.00 AED,5.00,4.9000,0.1000,566735167,1616009,Success,United Arab Emirates,DU UAE,Transguard Group LLC,API User,E6AEAE17361
2022-02-28 22:51,73276350,"28,967.1210","28,962.2210",05.00 AED,5.00,4.9000,0.1000,566735213,1616011,Success,United Arab Emirates,DU UAE,Transguard Group LLC,API User,E6AEAE17361
2022-02-28 22:52,73276395,"28,962.2210","28,957.3210",05.00 AED,5.00,4.9000,0.1000,566735363,1616014,Success,United Arab Emirates,DU UAE,Transguard Group LLC,API User,E6AEAE17361
2022-02-28 22:53,73276419,"28,957.3210","28,947.5210",10.00 AED,10.00,9.8000,0.2000,566735452,1616017,Success,United Arab Emirates,DU UAE,Transguard Group LLC,API User,E6AEAE22430
2022-02-28 22:54,73276461,"28,947.5210","28,942.6210",05.00 AED,5.00,4.9000,0.1000,566735584,1616020,Success,United Arab Emirates,DU UAE,Transguard Group LLC,API User,E6AEAE17361
2022-02-28 23:06,73276965,"28,942.6210","28,938.2210",222.40 LKR,5.00,4.4000,0.6000,566737463,1616029,Success,Sri Lanka,Dialog Sri Lanka,Transguard Group LLC,API User,LK_DG_TopUp
2022-02-28 23:08,73277041,"28,938.2210","28,933.3210",05.00 AED,5.00,4.9000,0.1000,566737732,1616033,Success,United Arab Emirates,DU UAE,Transguard Group LLC,API User,E6AEAE17361
2022-02-28 23:09,73277085,"28,933.3210","28,913.7210",20.00 AED,20.00,19.6000,0.4000,566737931,1616036,Success,United Arab Emirates,DU UAE,Transguard Group LLC,API User,E6AEAE12938
2022-02-28 23:24,73277611,"28,913.7210","28,897.6610",575.00 PKR,18.25,16.0600,2.1900,566739906,1616047,Success,Pakistan,Jazz Pakistan,Transguard Group LLC,API User,MBPKPK68304
2022-02-28 23:32,73277882,"28,897.6610","28,887.8610",10.00 AED,10.00,9.8000,0.2000,566740952,1616050,Success,United Arab Emirates,DU UAE,Transguard Group LLC,API User,E6AEAE22430
2022-02-28 23:34,73277951,"28,887.8610","28,858.4610",30.00 AED,30.00,29.4000,0.6000,566741301,1616057,Success,United Arab Emirates,DU UAE,Transguard Group LLC,API User,E6AEAE46146
2022-02-28 23:35,73277992,"28,858.4610","28,848.6610",10.00 AED,10.00,9.8000,0.2000,566741444,1616061,Success,United Arab Emirates,DU UAE,Transguard Group LLC,API User,E6AEAE22430
2022-02-28 23:44,73278232,"28,848.6610","28,838.8610",10.00 AED,10.00,9.8000,0.2000,566742459,1616069,Success,United Arab Emirates,DU UAE,Transguard Group LLC,API User,E6AEAE22430
2022-02-28 23:46,73278311,"28,838.8610","28,833.9610",05.00 AED,5.00,4.9000,0.1000,566742775,1616072,Success,United Arab Emirates,DU UAE,Transguard Group LLC,API User,E6AEAE17361
2022-02-28 23:55,73278574,"28,833.9610","28,829.0610",05.00 AED,5.00,4.9000,0.1000,566743829,1616077,Success,United Arab Emirates,DU UAE,Transguard Group LLC,API User,E6AEAE17361

